Date,Open,High,Low,Close,Adj_Close,Volume,Accumulation_Distribution_Line,On_Balance_Volume,Average_Directional_Index,Aroon_Oscillator,MACD,RSI,Stochastic_Oscillator,Simple_Moving_Average,Exponential_Moving_Average,Williams_%R
2014-04-03,17.091,17.125,16.423,16.681,16.681,127986000,-33910820.512819774,127986000,0.0,0.0,0.0,100.0,36.75213675213704,16.681,16.681,-63.24786324786296
2014-04-04,16.7575,16.771999,15.7805,16.15,16.15,250692000,-97753022.37888408,-122706000,0.0,-4.0,-0.04235897435897229,0.0,27.482335440684164,16.4155,16.641666666666666,-72.51766455931583
2014-04-07,16.0495,16.247,15.6565,15.888,15.888,141548000,-128315884.36025566,-264254000,0.0,-8.0,-0.09596376652786631,0.0,15.764385427306802,16.23966666666667,16.58583950617284,-84.23561457269321
2014-04-08,16.094,16.4,15.922,16.3535,16.3535,131552000,-22358729.54853931,-132702000,0.0,-8.0,-0.09973431575959069,39.90098880001399,47.46339802519583,16.268124999999998,16.56862917238226,-52.53660197480418
2014-04-09,16.4235,16.608999,16.125,16.5905,16.5905,101132000,71042507.09037852,-31570000,0.0,-8.0,-0.08264589346809714,50.688988250088734,63.602315287708464,16.3326,16.570249233687278,-36.39768471229153
2014-04-10,16.530001,16.549999,15.825,15.8555,15.8555,122534000,-41181721.44786775,-154104000,0.0,-8.0,-0.12694817351358623,31.690300014735726,13.551242764725895,16.253083333333333,16.517304846006738,-86.4487572352741
2014-04-11,15.7,15.825,15.475,15.5865,15.5865,145750000,-94068150.01929666,-299854000,0.0,-24.0,-0.1816699237086148,27.611359203050597,6.757575757575725,16.157857142857143,16.448356338895127,-93.24242424242426
2014-04-14,15.8835,16.024,15.564,15.7955,15.7955,85870000,-93508128.28016621,-213984000,0.0,-24.0,-0.20580041262256898,34.64936403288101,19.424242424242475,16.1125625,16.39999661008808,-80.57575757575752
2014-04-15,15.835,15.914,15.275,15.804,15.804,107972000,-22709586.80911754,-106012000,0.0,-32.0,-0.22168269980447164,34.92646679130044,28.594594594594597,16.078277777777778,16.35584871304452,-71.4054054054054
2014-04-16,16.0585,16.200001,15.7355,16.184,16.184,85698000,57084211.91682735,-20314000,0.0,-32.0,-0.20128639831103712,45.95875778026626,49.13513513513518,16.08885,16.343119178744924,-50.86486486486482
2014-04-17,15.988,16.433001,15.988,16.245501,16.245501,85984000,70609947.77809529,65670000,0.0,-32.0,-0.17810646525138552,47.509797199855576,52.45951351351355,16.103091000000003,16.335888202541597,-47.54048648648645
2014-04-21,16.1985,16.557501,16.115499,16.543501,16.543501,59988000,126797820.17686288,125658000,0.0,-32.0,-0.13414376595676814,54.347097793002845,68.56762162162157,16.139791833333334,16.351266928279255,-31.43237837837843
2014-04-22,16.6,16.875,16.447001,16.466,16.466,74232000,59156180.285181195,51426000,0.0,-32.0,-0.10435376775207672,52.43417863066934,64.37837837837843,16.16488476923077,16.359765674332643,-35.62162162162157
2014-04-23,16.653,16.6565,16.1695,16.229,16.229,72092000,4680089.936105117,-20666000,0.0,-32.0,-0.09873079174837684,46.98753853833743,51.56756756756752,16.169464428571427,16.35007932808578,-48.432432432432485
2014-04-24,16.4835,16.870001,16.147499,16.8575,16.8575,185874000,184121966.91360992,165208000,0.0,-32.0,-0.0430634368537568,59.116075289224824,98.90625000000011,16.215333466666667,16.38766604452387,-1.0937499999998936
2014-04-25,15.8125,15.8245,15.1355,15.1915,15.1915,323604000,-86878770.38682628,-158396000,0.0,-60.0,-0.1318589458468189,35.76056992943644,3.219315895372186,16.151343875,16.299061152336915,-96.78068410462782
2014-04-28,15.2,15.2195,14.4,14.829,14.829,289596000,-73273589.17877227,-447992000,0.0,-64.0,-0.22884278969213057,32.730491310289196,17.333333333333346,16.07355894117647,16.19016773364529,-82.66666666666666
2014-04-29,14.822,15.092,14.5225,15.019,15.019,130186000,23537246.642123044,-317806000,0.0,-64.0,-0.28706269253740935,35.80098428664644,25.010101010101003,16.014972333333333,16.103414568190082,-74.989898989899
2014-04-30,14.905,15.228,14.905,15.2065,15.2065,81772000,94423190.91456906,-236034000,0.0,-64.0,-0.31444794186020886,38.771134535897815,32.58585858585858,15.972421157894736,16.036976452027854,-67.41414141414143
2014-05-01,15.2065,15.524,15.2,15.3945,15.3945,86572000,111791030.42074272,-149462000,0.0,-64.0,-0.31732301820302666,41.68437443294895,40.18181818181821,15.943525099999999,15.989385603729495,-59.8181818181818
2014-05-02,15.521,15.6645,15.2155,15.4005,15.4005,79902000,97732549.35169998,-69560000,0.0,-64.0,-0.31548072168297736,41.77958243185339,40.42424242424238,15.917666761904762,15.94576444789768,-59.57575757575761
2014-05-05,15.3185,15.5115,15.25,15.5025,15.5025,50398000,144661470.9578184,-19162000,0.0,-64.0,-0.3023053529372639,43.46927108826502,44.54545454545452,15.898795545454545,15.912930044349704,-55.45454545454549
2014-05-06,15.4765,15.4905,14.852,14.869,14.869,93646000,56002102.124615416,-112808000,0.0,-64.0,-0.33907330787509693,36.4028721285015,18.94949494949493,15.854021826086955,15.835601892916392,-81.05050505050507
2014-05-07,14.778,14.82,14.334,14.6355,14.6355,140304000,89778991.0135045,-253112000,0.0,-92.0,-0.38264280752297175,34.19629171943362,11.865407319952803,15.803250083333333,15.746705456404067,-88.13459268004719
2014-05-08,14.541,14.794,14.3615,14.416,14.416,76964000,32211698.527955644,-330076000,0.0,-92.0,-0.42992782511007555,32.21918127118201,3.2270759543487104,15.74776008,15.648134681855618,-96.7729240456513
2014-05-09,14.5285,14.684,14.219,14.612,14.612,81260000,88307311.43118173,-248816000,0.0,-100.0,-0.4464397012810526,35.78916678247474,14.796686746987975,15.704077,15.571383964681127,-85.20331325301203
2014-05-12,14.715,15.167,14.708,15.143,15.143,74592000,155098840.8429467,-174224000,0.0,-52.0,-0.41192975011836097,44.34200630637092,34.85475863645474,15.644923153846154,15.539651819149192,-65.14524136354527
2014-05-13,15.13,15.28,15.0375,15.232,15.232,70198000,197507117.13160646,-104026000,28.535931125288574,-52.0,-0.3730979678670394,45.64875385132996,38.211981059230084,15.60961546153846,15.516862795508512,-61.788018940769916
2014-05-14,15.125,15.232,14.833,14.881,14.881,66466000,147032936.6804787,-170492000,28.194628106885197,-52.0,-0.36642237815028267,41.50957471206445,41.23326066645907,15.570884692307693,15.469761847693068,-58.766739333540926
2014-05-15,14.901,14.96,14.519,14.7595,14.7595,85902000,154824501.3063285,-256394000,28.327815760249546,-52.0,-0.36670876936193864,40.15235498535599,37.3919059149083,15.509577,15.417149858975064,-62.6080940850917
2014-05-16,14.64,14.944,14.5775,14.885,14.885,72736000,204142089.30087107,-183658000,28.45149000980216,-52.0,-0.35274273661481104,42.2526769191665,46.07402282947077,15.443980846153845,15.377731350902838,-53.92597717052923
2014-05-19,14.788,14.95,14.6905,14.838,14.838,45684000,210391730.91936803,-229342000,28.549345526796106,-52.0,-0.341530115669169,41.66298121985814,42.822552749913484,15.40484623076923,15.33775125083596,-57.17744725008652
2014-05-20,14.855,15.223,14.8375,15.0595,15.0595,81914000,222822260.10224712,-147428000,27.87777895923229,-52.0,-0.3111837019292025,45.521822019999455,58.14597025250777,15.384576999999998,15.317140047070334,-41.85402974749222
2014-05-21,15.1105,15.298,15.076,15.2505,15.2505,68176000,261823845.687833,-79252000,27.052072892876577,-52.0,-0.26862530139869634,48.67457198893109,71.3593912141128,15.363615461538462,15.312203747287347,-28.6406087858872
2014-05-22,15.2525,15.427,15.1505,15.2455,15.2455,51536000,245701371.90844804,-130788000,25.935268569352065,-52.0,-0.23261942860244567,48.59528855690605,79.41972920696325,15.342134692307694,15.307262728969766,-20.580270793036746
2014-05-23,15.273,15.6175,15.245,15.612,15.612,61058000,304956316.8748911,-69730000,24.398443370288728,-52.0,-0.17252229830791954,54.45181411260749,99.60672148730785,15.320134692307692,15.329835860157191,-0.39327851269214265
2014-05-27,15.7205,15.7315,15.369,15.541,15.541,97242000,299993621.70247746,-166972000,22.681266171992824,-52.00000000000001,-0.12913540365200404,53.18761157226096,87.40495867768595,15.293038499999998,15.345477648293695,-12.595041322314048
2014-05-28,15.475,15.691,15.371,15.508,15.508,54520000,292156371.702477,-221492000,21.08674448786091,-52.0,-0.09630367246971083,52.576617186253145,85.2231404958677,15.253211538461539,15.35751634101268,-14.776859504132311
2014-05-29,15.521,15.7435,15.51,15.689,15.689,47310000,317381617.95515394,-174182000,19.700877359553886,-44.0,-0.055044581971108286,55.59001634751647,96.42505739586755,15.223326923076922,15.382070686122852,-3.574942604132444
2014-05-30,15.7215,15.7325,15.3785,15.6275,15.6275,85204000,352040872.19244176,-259386000,18.55134255520423,-44.0,-0.026997777939769207,54.32685189082542,90.52674561045326,15.200192307692307,15.400250635298937,-9.473254389546733
2014-06-02,15.6295,15.63,15.35,15.442,15.442,44068000,336931843.6210132,-303454000,17.56654782971038,-40.0,-0.019513839989974358,50.59260027339546,75.37770518579019,15.14575,15.403343180832348,-24.62229481420982
2014-06-03,15.2875,15.396,15.2535,15.3595,15.3595,47584000,360139478.7087324,-351038000,16.93730406088567,52.0,-0.02000917247956835,48.980086963064835,68.64026133115566,15.15221153846154,15.40009553780773,-31.359738668844333
2014-06-04,15.3425,15.475,15.192,15.339,15.339,42142000,361777506.97728384,-393180000,16.076094796643453,52.0,-0.02180455636765899,48.56586603206368,66.96610861576161,15.171826923076924,15.395569942414564,-33.03389138423839
2014-06-05,15.405,16.396999,15.345,16.178499,16.178499,155934000,452936580.3851476,-237246000,16.897080845566435,72.0,0.04400587000341005,62.537805803645526,87.99119977532264,15.216423038461539,15.453564687420894,-12.00880022467736
2014-06-06,16.25,16.544001,16.2465,16.4835,16.4835,104880000,515158943.06628,-132366000,17.920408268202078,76.0,0.11939581807187416,66.13693398319367,96.73585285359964,15.265538423076922,15.529856192056384,-3.2641471464003575
2014-06-09,16.578501,16.65,16.282499,16.375,16.375,64244000,483255721.69817466,-196610000,19.05582680344208,80.0,0.16844610994235865,63.78911902282642,84.82758620689663,15.303249961538462,15.592459437089243,-15.172413793103384
2014-06-10,16.3825,16.775,16.375,16.620501,16.620501,73268000,499924558.0381753,-123342000,20.326119529739,84.0,0.224540337362912,66.67206451007272,90.90647439670406,15.350173076923076,15.66861066397152,-9.093525603295932
2014-06-11,16.799999,17.035999,16.694,16.76,16.76,88736000,445437640.6378332,-34606000,21.92595873752041,88.0,0.2770580672523728,68.2203429223885,85.36201822435342,15.398538461538461,15.749454318492148,-14.637981775646585
2014-06-12,16.7775,16.7775,16.233,16.2955,16.2955,85526000,379545708.590083,-120132000,21.87694348616197,88.0,0.27799294887799064,58.4785950769971,59.84276564141305,15.453403846153845,15.789902146751988,-40.15723435858695
2014-06-13,16.352501,16.465,16.1765,16.313499,16.313499,55296000,376766150.2122667,-64836000,21.662724980806697,88.0,0.2769932128424699,58.72455372977225,60.818850769441845,15.517942269230769,15.828687098844433,-39.181149230558155
2014-06-16,16.243,16.4345,16.176001,16.381001,16.381001,48996000,405481708.0906343,-15840000,21.46223476135702,88.0,0.2784381009873762,59.688975159944256,64.47948182184486,15.59351923076923,15.869599239670773,-35.52051817815514
2014-06-17,16.377001,16.566999,16.261499,16.281,16.281,58482000,354465878.18556,-74322000,21.567656081434105,72.0,0.26841976433751924,57.543879814545924,59.05643115858515,15.65771153846154,15.900073370065531,-40.94356884141485
2014-06-18,16.4,16.7875,16.25,16.719,16.719,128030000,449863115.3948623,53708000,22.120794729586525,72.0,0.2924518964285152,63.69765479136516,82.80915553641846,15.718326923076923,15.96073460191253,-17.19084446358155
2014-06-19,16.763,16.945,16.299,16.35,16.35,106412000,360253010.13170505,-52704000,22.936435683907494,72.0,0.2785118073667192,56.29469008223332,62.79829869755901,15.761326923076924,15.989569075844933,-37.20170130244099
2014-06-20,16.388,16.410999,16.021,16.209999,16.209999,121080000,356527151.6551444,-173784000,22.720019679637954,72.0,0.2532479904964582,53.74263161436198,55.20604946098125,15.812442269230768,16.00589721837494,-44.79395053901875
2014-06-23,16.1665,16.377501,16.070499,16.362,16.362,52096000,403362338.39659864,-121688000,22.51906196138767,68.0,0.24269382069216405,56.07111609347724,63.44905826955427,15.874076884615384,16.032275202199017,-36.55094173044573
2014-06-24,16.377001,16.4865,16.136999,16.208,16.208,52532000,372174051.47324187,-174220000,22.58625990674879,64.0,0.21937424240455883,53.15187493480618,51.034920777599396,15.924961499999998,16.045291853887978,-48.96507922240061
2014-06-25,16.216499,16.407499,16.087,16.372,16.372,46556000,408416812.15580213,-127664000,22.459540452877143,60.0,0.21168654725153857,55.79151215456229,34.58131485843821,15.9839615,16.069492457303685,-65.4186851415618
2014-06-26,16.4245,16.432501,16.106501,16.2845,16.2845,53990000,413384885.8367842,-181654000,22.40644908330837,56.00000000000001,0.19627098498348516,54.04194003802343,25.960616709967265,16.031076884615384,16.085418941947857,-74.03938329003273
2014-06-27,16.294001,16.326,16.1635,16.2285,16.2285,48324000,403720085.8367846,-229978000,22.357149954423083,52.0,0.17748932240898796,52.89860737107331,20.443369894945675,16.068692269230766,16.09601753884061,-79.55663010505432
2014-06-30,16.249001,16.349001,16.112,16.239,16.239,53426000,407552088.96757346,-176552000,22.08054782202796,19.999999999999996,0.16158928110522197,53.09896692001503,21.477853672762247,16.10690380769231,16.106608832259823,-78.52214632723775
2014-07-01,16.292999,16.66,16.254999,16.619499,16.619499,63472000,458329406.87049246,-113080000,22.681008386919977,20.0,0.177643707079703,59.77635509192165,64.77261904761912,16.14565376923077,16.144600696536873,-35.227380952380884
2014-07-02,16.66,16.837999,16.583,16.6425,16.6425,53626000,429728971.67662877,-59454000,23.6517014252843,20.0,0.19003236894484132,60.145738060339774,67.26190476190453,16.188019153846156,16.18148212642303,-32.73809523809547
2014-07-03,16.741501,16.915001,16.653999,16.8745,16.8745,38886000,456546697.21129936,-20568000,24.72292460099039,20.0,0.21608009697085961,63.7606808230489,92.37012987012996,16.240576846153846,16.23281678372503,-7.629870129870039
2014-07-07,16.875,16.877501,16.625999,16.6775,16.6775,42578000,431406408.068469,-63146000,25.57499808923658,20.0,0.21831031013118007,58.877124816562265,71.04978354978333,16.27859607692308,16.26575628122688,-28.950216450216665
2014-07-08,16.655001,16.687,16.07,16.1905,16.1905,85432000,379344119.5757623,-148578000,24.06784626886494,20.000000000000004,0.17872075850315738,48.905072419337465,18.34415584415578,16.300249923076926,16.260181741876742,-81.65584415584422
2014-07-09,16.2355,16.51,16.157499,16.498501,16.498501,63322000,438534842.342506,-85256000,22.66834814994842,20.0,0.17023648006520986,54.18964060384443,51.67759740259745,16.340884576923077,16.277835020256244,-48.32240259740255
2014-07-10,16.216999,16.499001,16.1325,16.396,16.396,53300000,461876106.622822,-138556000,21.278296682619242,20.0,0.15347251855325794,52.25276532450906,41.94626180507631,16.380749961538463,16.286587981718743,-58.05373819492369
2014-07-11,16.7355,17.35,16.7355,17.309999,17.309999,166016000,606278417.3925536,27460000,22.115593584698775,100.0,0.21150098724271515,64.45346966743053,96.87492187499998,16.456557615384614,16.36239620529513,-3.125078125000011
2014-07-14,17.3515,17.7885,17.268,17.766001,17.766001,112198000,708776733.2350128,139658000,23.591244832315972,60.0,0.2909308474724277,68.74456303459449,98.69077684026767,16.517615384615386,16.466366930828826,-1.3092231597323154
2014-07-15,17.686001,17.779499,17.469999,17.722,17.722,83418000,761199892.6405056,56240000,24.96149241938909,60.0,0.34633671691197776,67.8928849072658,96.13034623217935,16.56525,16.559376787804467,-3.8696537678206475
2014-07-16,17.781,17.966,17.65,17.795,17.795,70072000,755434474.9189874,126312000,26.508258869203072,68.0,0.3916223785308617,68.58818950883904,90.98101265822788,16.619865384615387,16.650904433152284,-9.018987341772116
2014-07-17,17.672001,17.848,17.569,17.622499,17.622499,72720000,710602985.8867304,53592000,27.625733140137108,68.0,0.4088789011264993,65.00574869841688,81.88285864978904,16.65840376923077,16.72287440106693,-18.117141350210954
2014-07-18,17.719999,17.983999,17.604,17.933001,17.933001,68148000,760459297.2033393,121740000,28.87896097301657,76.0,0.4425087703837498,68.22310131877865,97.33552629860309,16.703519192307695,16.812513408395308,-2.6644737013969113
2014-07-21,17.905001,18.085501,17.836,17.988001,17.988001,45568000,770413171.4082526,167308000,30.200291119575525,80.0,0.4682015879456003,68.77080506974949,95.16249309724977,16.768615384615387,16.899586563328988,-4.83750690275024
2014-07-22,17.762501,18.1465,17.762501,18.042,18.042,57778000,796744209.3067893,225086000,31.1069096569996,84.0,0.48730327021831954,69.32973762797452,94.96749337828085,16.83509619230769,16.984209780860176,-5.032506621719146
2014-07-23,17.952499,18.0315,17.830999,17.907,17.907,53746000,783743639.4642451,171340000,31.948769727464818,84.0,0.4859464313126942,66.1425173887564,88.46616903443297,16.893788461538463,17.05256461190757,-11.533830965567045
2014-07-24,17.999001,18.2425,17.926001,17.9305,17.9305,141774000,646000244.464576,313114000,33.10574345450589,92.0,0.48122017369361103,66.43181124040258,85.63866513233597,16.95723076923077,17.11759686287738,-14.36133486766404
2014-07-25,15.865,16.2435,15.738,16.2005,16.2005,356930000,942206248.421056,-43816000,32.66425586176069,-4.0,0.3340275767134919,39.60395309446699,18.46675983230194,16.93728846153846,17.0496637619235,-81.53324016769807
2014-07-28,16.2125,16.240999,15.825,16.0205,16.0205,118640000,935076708.7827393,-162456000,32.25430309706871,-4.0,0.2005401850428754,37.889446143768296,11.279696546216764,16.924615384615386,16.973429409188427,-88.72030345378323
2014-07-29,16.099001,16.145,15.975,16.0,16.0,57676000,894364238.1945043,-220132000,31.873632672711874,-4.0,0.09203536040016758,37.68932860495656,10.461169894190474,16.9165385,16.90132352702632,-89.53883010580952
2014-07-30,16.0725,16.136499,15.925,16.1255,16.1255,79380000,965487928.51928,-140752000,31.5945686859304,-4.0,0.015987017897757028,39.786039899398986,15.47215012976639,16.907442346153847,16.843855117616965,-84.52784987023361
2014-07-31,16.0005,16.034,15.593,15.6495,15.6495,103840000,888255456.8639511,-244592000,31.811452376375172,-20.0,-0.08174871503601722,34.978476659132085,2.132477826004898,16.885961576923076,16.755384368163856,-97.86752217399511
2014-08-01,15.6845,15.7915,15.2295,15.353,15.353,148830000,804836506.6860151,-393422000,32.47209042927797,-24.0,-0.18104310733414408,32.35577703316888,4.098904746100231,16.84676926923077,16.651504044596162,-95.90109525389977
2014-08-04,15.442,15.809,15.425,15.6825,15.6825,84018000,833498897.3110149,-309404000,33.03442043623894,-24.0,-0.23048978953542232,37.92600258352021,15.034848987719862,16.823615423076923,16.579725967218668,-84.96515101228015
2014-08-05,15.665,15.7275,15.503,15.616,15.616,57042000,833880024.25979,-366446000,33.55658401413127,-24.0,-0.27190824664998203,37.2591559081345,12.827746432127443,16.800057730769232,16.508338858535804,-87.17225356787254
2014-08-06,15.5415,15.789,15.51,15.6945,15.6945,45938000,848698733.9372092,-320508000,33.83835667902112,-24.0,-0.2949978270485687,38.63089465737975,15.43312313308994,16.779115423076924,16.448054498644264,-84.56687686691006
2014-08-07,15.7605,15.794,15.4825,15.5725,15.5725,58712000,823913411.3047854,-379220000,34.14313437965506,-24.0,-0.31945834927482863,37.26718324252083,11.384002655160968,16.73884623076923,16.3831986098558,-88.61599734483903
2014-08-08,15.597,15.866,15.533,15.84,15.84,54118000,869580552.4459265,-325102000,34.164536217416945,-23.999999999999993,-0.31364299376235394,42.093990796118334,20.26219714570196,16.70798084615385,16.342961675792406,-79.73780285429804
2014-08-11,15.924,16.018999,15.844,15.9165,15.9165,49372000,861117014.7799965,-275730000,33.63495968597464,-24.0,-0.2994099603122713,43.434407611493405,22.801194822436088,16.671134692307692,16.311371922030006,-77.19880517756391
2014-08-12,15.9445,16.0655,15.8475,15.966,15.966,38316000,864456482.6699045,-237414000,32.97677665874187,-24.0,-0.280897926010212,44.33234815661223,24.444075672087603,16.64376930769231,16.28578881669445,-75.5559243279124
2014-08-13,16.379999,16.586,16.306999,16.313999,16.313999,98782000,770631267.7710317,-138632000,30.75348442020714,-24.0,-0.2354324754771433,50.30497812108618,79.94832288978992,16.648519269230768,16.287878459902267,-20.051677110210083
2014-08-14,16.389999,16.7045,16.335501,16.6605,16.6605,68408000,822725120.5782207,-70224000,28.734396005556786,-24.0,-0.16948729941303498,55.43233733421358,97.01694915254234,16.65475,16.315480055465063,-2.9830508474576605
2014-08-15,16.700001,16.75,16.416,16.681499,16.681499,77934000,868691713.7878009,7710000,26.980046754018957,-24.0,-0.11421423783103535,55.73043932403966,95.49483722459709,16.66573073076923,16.34259256987506,-4.50516277540291
2014-08-18,16.774,16.889999,16.688499,16.7265,16.7265,49708000,837732633.9664617,57418000,25.722166803213817,-24.000000000000007,-0.0660177224852383,56.40342469844937,90.15362249540661,16.64328846153846,16.37103015729172,-9.846377504593384
2014-08-19,16.7435,16.790501,16.650499,16.7565,16.7565,34276000,855360039.2892426,91694000,24.432240777793446,-23.999999999999996,-0.02511141875294598,56.874101017791425,91.96030831695771,16.6044615,16.399583478973817,-8.039691683042296
2014-08-20,16.733999,16.858,16.701,16.789,16.789,36210000,859742141.2000711,127904000,23.42560819143709,-24.0,0.009816442219683807,57.4105382521276,93.91755129030501,16.568576884615386,16.428429147197978,-6.082448709694982
2014-08-21,16.823999,16.829,16.6115,16.6455,16.6455,39422000,832645180.2805305,88482000,22.177663250625177,-24.0,0.02562241372564955,54.20449567903692,83.31063707210713,16.524365346153846,16.444508469627756,-16.689362927892873
2014-08-22,16.6495,16.704,16.540001,16.5795,16.5795,44224000,809723795.2476945,44258000,20.768654715686584,-24.0,0.03244905905111395,52.745546445186626,77.93966461077414,16.48425,16.45450784224792,-22.060335389225866
2014-08-25,16.6605,16.838499,16.6355,16.701,16.701,39154000,795836786.7107068,83412000,19.897653821963672,-24.0,0.04712008819156566,55.13934451775025,86.57199756447434,16.436865346153844,16.472766520599926,-13.428002435525643
2014-08-26,16.85,17.218,16.727501,17.091499,17.091499,73094000,831228511.705049,156506000,20.134918779757815,-24.0,0.08922842055867974,61.831659546961696,92.71097666378559,16.4023845,16.518598556111044,-7.2890233362144095
2014-08-27,17.1045,17.3335,17.066999,17.159,17.159,59232000,812892442.5420812,215738000,20.628806765729305,-24.000000000000004,0.12658712631002444,62.86297802762158,90.30824770896963,16.368422961538464,16.56603570010282,-9.691752291030367
2014-08-28,17.0,17.0895,16.940001,17.000999,17.000999,45054000,804603957.9234554,170684000,20.581282269262772,-24.0,0.1418101108581169,58.854292584996095,77.67700570661293,16.333576769230767,16.598255203798907,-22.32299429338706
2014-08-29,17.087999,17.091,16.884001,16.952,16.952,38790000,791298923.6479276,131894000,20.316063956158768,72.0,0.14821212882761614,57.62700831965685,74.32705248990587,16.295942153846152,16.624458522036022,-25.67294751009414
2014-09-02,16.999001,17.125,16.858,17.118999,17.118999,46520000,835727788.6666538,178414000,20.168302934577785,72.0,0.16486078531280057,60.63958447359503,79.1036735473222,16.33126903846154,16.661091150033354,-20.896326452677798
2014-09-03,17.127001,17.1635,16.877501,16.950001,16.950001,39874000,816069698.5124928,138540000,20.146893048556425,72.0,0.16254452717085144,56.27897249091739,61.573207989186315,16.367019076923075,16.68249187966051,-38.426792010813685
2014-09-04,17.1845,17.469,17.179001,17.297501,17.297501,79312000,801574970.2961887,217852000,20.956383695823266,92.0,0.18659823344515303,62.284713092255956,83.71329534662863,16.41692296153846,16.72804811079677,-16.286704653371377
2014-09-05,17.315001,17.341499,17.125,17.319,17.319,42140000,834956427.6701258,259992000,21.45595923066873,92.0,0.2050322741621109,62.62675955181039,83.85358864756562,16.46282680769231,16.771822324811826,-16.14641135243439
2014-09-08,17.226999,17.290501,16.952,17.117001,17.117001,59106000,833472408.7336966,200886000,21.145193666765135,92.0,0.20102446818066966,57.36278750682488,62.10986233569655,16.519269153846153,16.797391115566505,-37.89013766430345
2014-09-09,17.0805,17.087999,16.459,16.487499,16.487499,92936000,748957989.8936031,107950000,20.139716644018485,88.0,0.14537688835839546,44.74165659111542,2.8216831683168326,16.56290373076923,16.77443614404306,-97.17831683168316
2014-09-10,16.715,16.749001,16.441,16.5665,16.5665,75948000,734902477.2556581,183898000,19.259503798574407,76.0,0.10642371455622879,46.3373887010567,12.208171206225886,16.59690373076923,16.75903346670654,-87.79182879377412
2014-09-11,16.497,16.650499,16.3195,16.525999,16.525999,54404000,748380081.7076348,129494000,18.806227412445697,76.0,0.07146119132597306,45.61020853962077,17.964245324053707,16.63190369230769,16.74177165435791,-82.0357546759463
2014-09-12,16.478001,16.644501,16.439501,16.5595,16.5595,68586000,760089217.4539756,198080000,18.385327911040466,76.0,0.04592697293957926,46.3600603675825,20.878642888212134,16.665172923076923,16.728270050331396,-79.12135711178786
2014-09-15,16.5455,16.5665,15.95,16.1945,16.1945,80008000,743542550.7873093,118072000,19.271586511419525,72.0,-0.003718662239950987,39.904938015901976,16.09611586570124,16.689096,16.688731528084624,-83.90388413429876
2014-09-16,16.053499,16.474001,16.004999,16.388,16.388,65198000,784829807.5580695,183270000,20.09454092605722,68.0,-0.027136539805230342,44.33033166020304,28.834759710335867,16.71017292307692,16.666455118596875,-71.16524028966413
2014-09-17,16.388,16.4,16.076,16.200001,16.200001,82720000,765426861.3852302,100550000,20.858712882506513,64.0,-0.06017170268622607,41.15903034058777,16.45826201448326,16.721076807692306,16.631902961663773,-83.54173798551675
2014-09-18,16.271999,16.355,16.185499,16.25,16.25,51538000,753112848.7127384,152088000,21.568301127780853,-28.0,-0.0813797111806096,42.3404341271493,19.749835418038206,16.731999884615384,16.603613853392382,-80.2501645819618
2014-09-19,16.379999,16.638,16.2785,16.566,16.566,137724000,835670628.9630841,289812000,20.941026222160705,-27.999999999999993,-0.07186029092771662,49.27263710943403,40.552995391705,16.74169223076923,16.600827642029984,-59.447004608295
2014-09-22,16.4245,16.474501,16.052999,16.225,16.225,62194000,824235250.2460203,227618000,21.016747601167886,-28.0,-0.0907854141947908,43.2323116387262,18.104015799868453,16.72494223076923,16.57298855743517,-81.89598420013155
2014-09-23,16.122999,16.379999,16.0625,16.181499,16.181499,47052000,812453540.5335482,180566000,21.087060310245985,-28.0,-0.10804836360124526,42.51626844791672,15.240223831468017,16.705711461538463,16.54398933095849,-84.759776168532
2014-09-24,16.2085,16.472,15.978,16.4105,16.4105,52844000,852140026.3635073,233410000,20.73743599500774,-28.0,-0.1020742599897666,47.4505274704277,33.09380746949871,16.693557615384613,16.534101232368972,-66.90619253050129
2014-09-25,16.3995,16.427,16.07,16.0965,16.0965,58576000,802260183.226252,174834000,20.412784845143655,-28.0,-0.12127888810054799,42.11267275006494,10.92874977340559,16.668173,16.501686326267567,-89.07125022659442
2014-09-26,16.030001,16.174999,15.882,16.1605,16.1605,72760000,867819153.5981641,247594000,20.71831270370813,-64.0,-0.1298377404596991,43.507597434286346,23.0928881367231,16.643999923076922,16.47641326506256,-76.9071118632769
2014-09-29,16.025,16.1875,15.95,16.091,16.091,38492000,875031338.8613224,209102000,20.937813561628996,-64.0,-0.14060792119168752,42.31511417059602,24.10608522942896,16.622673,16.447864134317186,-75.89391477057104
2014-09-30,16.068001,16.171499,15.9255,16.122,16.122,52724000,906537486.1383436,261826000,21.2232150142396,-64.0,-0.14497079303365368,43.06471534785062,31.229708822002387,16.605076846153846,16.42372605029369,-68.7702911779976
2014-10-01,16.101999,16.1085,15.7775,15.873,15.873,61782000,880406126.6217271,200044000,21.96455127057906,-76.0,-0.16660015652199078,38.7131179361441,11.014981528279582,16.573230692307693,16.382931528049713,-88.98501847172041
2014-10-02,15.846,15.9265,15.5655,15.9205,15.9205,71078000,949121423.020619,271122000,23.24175247491541,-80.0,-0.1778584879556213,39.959497706838484,33.10023310023309,16.528192269230768,16.34867734078677,-66.8997668997669
2014-10-03,16.018,16.257999,15.9765,16.136999,16.136999,60748000,957645379.5959526,331870000,22.742463756073963,-80.0,-0.16738166514202035,45.40893203385968,53.2866200466199,16.48888453846154,16.332997463691456,-46.7133799533801
2014-10-06,16.174999,16.206499,15.98,16.110001,16.110001,45806000,964420855.0638354,286064000,22.27883851714977,-80.0,-0.15941953142604248,44.862108534680615,50.76932400932397,16.454615384615384,16.31647920712172,-49.23067599067603
2014-10-07,15.9715,16.1,15.8335,15.849,15.849,47308000,922615849.4353173,238756000,22.324433126702086,-80.0,-0.1721852382704938,39.86424200344037,26.4335664335664,16.412192307692308,16.281851117705298,-73.5664335664336
2014-10-08,15.829,16.2055,15.707,16.135,16.135,69056000,972139460.267815,307812000,22.74618428105145,-80.0,-0.15740982068970055,46.85146800890669,53.100233100233154,16.37434619230769,16.270973257134536,-46.899766899766846
2014-10-09,16.074499,16.113501,15.726,15.7685,15.7685,71758000,916121884.1634948,236054000,23.13781035294728,-80.0,-0.17327626195044843,40.377069516856686,22.33220865543596,16.328903846153846,16.23375301586531,-77.66779134456404
2014-10-10,15.701,15.8885,15.569,15.5695,15.5695,73638000,842714363.0367337,162416000,23.964068300871283,-76.0,-0.19960722006698361,37.35831830877359,0.4412575841146778,16.262442269230768,16.184549088764175,-99.55874241588533
2014-10-13,15.4935,15.66,15.1735,15.3225,15.3225,87278000,808897501.7828795,75138000,25.64851702733019,-100.0,-0.23766586565610126,33.964089869910836,11.474778590681483,16.185653807692308,16.120693600707572,-88.52522140931852
2014-10-14,15.4,15.612,15.2875,15.4155,15.4155,67716000,794603061.1049134,142854000,27.21264798761346,-96.0,-0.25735664649479695,36.310439257613936,19.305943358595876,16.12021146153846,16.068457037692195,-80.69405664140412
2014-10-15,15.2175,15.395,14.955,15.2985,15.2985,106878000,854600483.8321866,35976000,29.267887735223074,-100.0,-0.27918439049668464,34.64275974787586,26.362261214321745,16.07448073076923,16.01142318304833,-73.63773878567825
2014-10-16,14.6915,15.341,14.6915,15.143,15.143,94626000,891533033.4857666,-58650000,31.555905255219933,-100.0,-0.3055088692389418,32.50591624338655,28.822233528396797,16.01973073076923,15.947095539859564,-71.1777664716032
2014-10-17,15.3575,15.46,15.136,15.182,15.182,88102000,828447650.7697178,29452000,33.04146844631873,-96.0,-0.319540767179582,33.61195165951976,31.311861673706794,15.968038461538463,15.890421796166262,-68.68813832629321
2014-10-20,15.1475,15.3265,15.101,15.3105,15.3105,64690000,883957695.1156157,94142000,34.479676163698954,-76.0,-0.31664221693729644,37.26008304701447,39.51486722940768,15.92,15.847464626079871,-60.48513277059232
2014-10-21,15.495,15.782,15.3535,15.7665,15.7665,71186000,949993716.1191165,165328000,33.68352608719941,-76.0,-0.2743867463265346,48.14898795962727,68.6243655438018,15.903538461538462,15.841467246370252,-31.375634456198206
2014-10-22,15.7715,15.949,15.632,15.6485,15.6485,62518000,893983899.0844165,102810000,32.31498566174504,-76.0,-0.24756679930868408,45.92764170621531,61.09164448876121,15.875096153846155,15.827173376268751,-38.90835551123879
2014-10-23,15.67,15.84,15.57,15.659,15.659,180764000,832390239.825158,283574000,31.213718873735598,-76.0,-0.22289513940229,46.16564370053349,63.86142829137183,15.854288423076923,15.814716089137733,-36.13857170862817
2014-10-24,14.22,14.6905,14.2,14.353,14.353,396022000,683427836.1554335,-112448000,32.55273373052013,-100.0,-0.30520771196107255,29.042640315063878,7.629020194465239,15.781326884615385,15.706440823275678,-92.37097980553476
2014-10-27,14.285,14.521,14.251,14.4985,14.4985,119012000,782604502.8220996,6564000,33.79610466896291,-96.0,-0.35461263106597585,32.06575284825642,14.884068810770403,15.701807653846155,15.616963725255257,-85.1159311892296
2014-10-28,14.488,14.9,14.488,14.7795,14.7795,111452000,828862493.113362,118016000,33.738155332269095,-88.0,-0.36686306476849495,37.595447494694106,30.284802568694825,15.6462115,15.554929375236348,-69.71519743130517
2014-10-29,14.9555,14.9805,14.6535,14.706,14.706,97638000,762576144.4895089,20378000,33.44459952458023,-88.0,-0.37814345510786396,36.75275716411186,28.930817610062896,15.589461538461538,15.492045717811433,-71.06918238993711
2014-10-30,14.699,14.987,14.618,14.9535,14.9535,81104000,828953943.9475034,101482000,33.231549242489855,-84.0,-0.36292845089958803,41.507281814273746,43.08176100628934,15.533423076923079,15.452153442417993,-56.918238993710666
2014-10-31,15.2575,15.286,15.075,15.273,15.273,91014000,908752948.68684,192496000,32.1296842731283,-60.0,-0.3213847473073539,47.0417912852689,61.349342481417956,15.50175,15.438882817053697,-38.65065751858205
2014-11-03,15.312,15.4005,15.162,15.286,15.286,64850000,911336072.3765674,257346000,30.78281998268934,-60.0,-0.28413672030708703,47.26045207245015,62.092624356775296,15.468115384615384,15.427558163938608,-37.907375643224704
2014-11-04,15.1995,15.2125,15.0085,15.1405,15.1405,68548000,931497248.8471551,188798000,29.858107555163834,-60.0,-0.2633226054743183,45.01994212175601,53.773584905660364,15.431557692307694,15.406294596239452,-46.226415094339636
2014-11-05,15.1505,15.2,14.708,14.826,14.826,93490000,882852045.5951228,95308000,29.585459435630334,-60.0,-0.26910274222386654,40.545545363699084,35.791881074900004,15.381711538461538,15.363309811332826,-64.2081189251
2014-11-06,14.8345,14.85,14.6145,14.832,14.832,75162000,946524313.111047,170470000,29.503319193375795,-60.0,-0.27008600899660173,40.666700921142706,36.13493424814187,15.341673076923076,15.323953529011876,-63.86506575185813
2014-11-07,14.891,14.9995,14.8145,14.993,14.993,52948000,995751642.8407773,223418000,28.94261941945766,-60.0,-0.25493516662200477,43.96634575105587,45.34019439679821,15.306,15.299438452788774,-54.65980560320178
2014-11-10,15.0,15.29,15.0,15.2555,15.2555,56182000,1038566201.461467,279600000,27.557322486352994,-56.00000000000001,-0.219219433518008,48.9510942464527,60.34877072612922,15.272096192307693,15.296183752582197,-39.65122927387078
2014-11-11,15.297,15.619,15.1825,15.6005,15.6005,76072000,1108189944.8749838,355672000,25.753765676102663,-48.0,-0.16121742685797535,54.6599698545877,85.39634146341466,15.252500000000001,15.318725696835367,-14.603658536585337
2014-11-12,15.5375,15.629,15.4395,15.5755,15.5755,43660000,1127197596.5900233,312012000,24.1036673670012,-48.0,-0.11593132560743413,54.187074071891615,96.25612316305111,15.241980769230768,15.337746015588303,-3.743876836948891
2014-11-13,15.6,15.8945,15.5755,15.824,15.824,73728000,1168337358.3455088,385740000,23.208918311191134,-44.0,-0.05930624541846363,58.070269043809056,95.7103742013994,15.230019230769232,15.37376482924843,-4.289625798600599
2014-11-14,15.856,16.643999,15.82,16.391001,16.391001,177556000,1236860913.1896281,563296000,23.754736924721605,60.0,0.030964837298462555,65.29794228115335,88.26539344405998,15.253961576923075,15.449115656711509,-11.734606555940028
2014-11-17,16.322001,16.4,15.9015,16.1525,16.1525,95698000,1237532814.8947437,467598000,24.26156849442847,60.0,0.08231144811886537,60.56845569891117,75.7822497079328,15.276384653846154,15.501218200658805,-24.21775029206719
2014-11-18,16.199499,16.478001,16.1625,16.2465,16.2465,70990000,1204344026.3013637,538588000,24.858808962242552,60.0,0.12910082755799657,61.744518483694954,80.41393467057637,15.311923115384614,15.556424259869264,-19.586065329423644
2014-11-19,16.362499,16.42,16.201,16.327,16.327,65632000,1214233779.7260215,604220000,25.413389396641342,60.0,0.17070959119198115,62.76863275106324,84.38043083539343,15.346980807692308,15.613503944323393,-15.619569164606583
2014-11-20,16.200001,16.633499,16.1665,16.527,16.527,68734000,1251618238.2237916,672954000,26.290503324690693,60.0,0.21731805738735943,65.25714106184367,94.23507969208165,15.394230807692308,15.681170318817957,-5.764920307918348
2014-11-21,16.771,16.9165,16.5735,16.6315,16.6315,89332000,1192497643.4716048,762286000,27.536658512885275,80.0,0.25969428523402627,66.51645083637084,87.61946133796697,15.451480807692308,15.751565110016628,-12.380538662033024
2014-11-24,16.739,16.869499,16.68,16.782,16.782,55084000,1196712827.1084576,817370000,28.693802616208814,80.0,0.3019412525186347,68.29862449590252,94.15725456125112,15.51301926923077,15.827893620385765,-5.842745438748879
2014-11-25,16.7635,16.8165,16.563999,16.752001,16.752001,51300000,1221804624.3686662,766070000,29.315739898416524,80.0,0.3292067197357067,67.52709670537088,92.85408340573417,15.568461615384617,15.89634601887571,-7.145916594265826
2014-11-26,16.688999,16.7325,16.5875,16.678499,16.678499,39672000,1231927277.1686652,726398000,29.893253089037966,80.0,0.3409535020882757,65.57258190760675,88.6774024738344,15.6035385,15.954283276736767,-11.322597526165591
2014-11-28,16.8015,17.063,16.8015,16.931999,16.931999,61036000,1231810106.721247,787434000,30.997972392961152,96.0,0.3664935338221902,68.91440572504197,93.6499757634514,15.652903846153844,16.026706663645154,-6.350024236548608
2014-12-01,16.906,17.032,16.296499,16.299999,16.299999,98898000,1133853350.8527977,688536000,30.2274798038826,96.0,0.3319110112909591,54.6671992421423,59.42563148098914,15.677557653846153,16.04695054041218,-40.57436851901087
2014-12-02,16.375,16.3965,16.1625,16.3155,16.3155,55806000,1151024427.7758746,744342000,29.107522338906005,92.0,0.3022705276976474,54.913402889712614,53.95749923005854,15.753038423076921,16.06684309297424,-46.042500769941455
2014-12-03,16.286501,16.338499,15.718,15.825,15.825,113620000,1076590115.4240415,630722000,27.167865044137073,88.0,0.23647504308525313,46.33752241881387,16.77310924369745,15.804057653846154,16.04892878979096,-83.22689075630255
2014-12-04,15.7765,15.9295,15.6735,15.8465,15.8465,65806000,1099725037.2990415,696528000,25.473856282463824,60.0,0.1839461016586128,46.73022643653578,12.450521770421034,15.845096115384617,16.03393406462126,-87.54947822957897
2014-12-05,15.84,15.8465,15.542,15.6315,15.6315,65304000,1072809923.9985492,631224000,24.22089659135429,60.0,0.12354369909747476,43.316471215544915,5.884286653517494,15.88069226923077,16.004124133908572,-94.11571334648251
2014-12-08,15.5785,15.828,15.241,15.332,15.332,72784000,1022592683.7941202,558440000,23.732525241179623,60.0,0.050920236132508734,39.03820875253803,4.9945115257958905,15.895249961538461,15.954337161026455,-95.0054884742041
2014-12-09,15.1495,15.682,15.057,15.625,15.625,80990000,1088810107.79412,639430000,23.652594636137714,60.0,0.016814443369270293,44.78381941787413,28.315054835493523,15.908788423076924,15.929941815765236,-71.68494516450649
2014-12-10,15.6,15.6595,15.234,15.292,15.292,64918000,1041590081.9421811,574512000,23.57837336002737,60.0,-0.03666233948932529,40.15204461067306,11.714855433698885,15.909019192307692,15.882686866449292,-88.28514456630111
2014-12-11,15.3945,15.632,15.3005,15.368,15.368,65258000,1002907738.0507787,639770000,23.509453603639198,60.0,-0.07207962133592538,41.63568198003343,15.503489531405792,15.917769192307691,15.844561913378975,-84.49651046859421
2014-12-12,15.1995,15.532,15.1505,15.366,15.366,63070000,1011091132.5461916,576700000,23.780157846268985,60.0,-0.09916632795265201,41.60645121331409,15.403788634097683,15.938538423076922,15.80911288275831,-84.59621136590232
2014-12-15,15.4435,15.543,15.1075,15.3035,15.3035,76832000,1003416753.6713351,499868000,24.126816441508822,56.00000000000001,-0.12424376102327628,40.64610427452127,12.288135593220312,15.95667303846154,15.771660076628065,-87.7118644067797
2014-12-16,15.2175,15.2245,14.7505,14.753,14.753,130026000,874762335.9498159,369842000,25.167189035556284,-48.0,-0.18638996914387285,33.34539109854292,0.10810810810808669,15.94744226923077,15.696203774655617,-99.89189189189192
2014-12-17,14.8185,14.9835,14.6515,14.944,14.944,88670000,942333149.2028286,458512000,26.31012955934161,-52.0,-0.21771944879227156,37.537444761363496,12.129380053908381,15.9354615,15.640484976532978,-87.87061994609162
2014-12-18,15.2005,15.225,14.6625,14.8865,14.8865,154762000,910830484.3139398,303750000,26.40411622649728,-52.0,-0.24437109867301388,36.78735307782589,9.871875656374689,15.90799996153846,15.584634237530535,-90.1281243436253
2014-12-19,14.8455,15.077,14.776,14.995,14.995,174182000,990109334.8122779,477932000,26.491389560284688,-52.0,-0.25381189446364516,39.254037760242184,19.6848137535816,15.885673038461537,15.540957627343087,-80.31518624641839
2014-12-22,15.097,15.368,15.097,15.327,15.327,80076000,1045955696.435894,558008000,25.494777753550682,-52.0,-0.23183175561626612,46.17528592343548,40.041517511272986,15.866557653846153,15.525108914206562,-59.958482488727014
2014-12-23,15.349,15.3745,15.1625,15.3145,15.3145,54274000,1069508564.360423,503734000,24.54655887349218,-52.0,-0.21296604278009745,45.962946088221784,51.87793427230047,15.82515376923077,15.509508253894964,-48.12206572769953
2014-12-24,15.319,15.35,15.144,15.1515,15.1515,30276000,1041437127.4672191,473458000,23.720094684449126,-52.0,-0.208761099187317,43.174806232661325,41.841004184100406,15.78665376923077,15.482989123976818,-58.158995815899594
2014-12-26,15.25,15.539,15.1905,15.4545,15.4545,57876000,1071247004.0812793,531334000,22.253911484401808,-52.0,-0.17891664367516924,49.32817509407667,68.25329366765828,15.756192230769232,15.480878818497054,-31.746706332341713
2014-12-29,15.3925,15.7135,15.329,15.602,15.602,60180000,1096524169.2308242,591514000,21.02054169097081,-52.0,-0.14172891763374196,52.05020477358215,89.50094161958572,15.728307615384617,15.489850757867643,-10.49905838041427
2014-12-30,15.4955,15.697,15.467,15.515,15.515,41860000,1072136169.2308244,549654000,19.875269739927734,-52.0,-0.11791826141742412,50.3327363233375,81.30885122410552,15.689384538461537,15.491713664692263,-18.691148775894476
2014-12-31,15.5775,15.649,15.5005,15.5175,15.5175,40960000,1040554216.3688713,590614000,18.81180292824488,-52.0,-0.09771996083293111,50.38340024032949,81.54425612052732,15.646538384615384,15.493623763603948,-18.455743879472678
2015-01-02,15.629,15.7375,15.348,15.426,15.426,55664000,1007184398.6538519,534950000,17.70909373768439,-52.0,-0.08808060896949144,48.43596831812965,71.31675874769793,15.594384538461536,15.488614595929581,-28.683241252302068
2015-01-05,15.3505,15.419,15.0425,15.1095,15.1095,55484000,971447692.1465478,479466000,17.697058879676366,-52.00000000000001,-0.10477250584036213,42.33975131834104,42.1731123388582,15.531211423076922,15.46053203326813,-57.8268876611418
2015-01-06,15.112,15.15,14.619,14.7645,14.7645,70380000,939637522.6550224,409086000,18.74356262290245,-100.0,-0.144177581669787,36.88940448345339,13.00849351810461,15.457596076923076,15.408974104877899,-86.99150648189539
2015-01-07,14.875,15.064,14.7665,14.921,14.921,52806000,941678762.9911565,461892000,19.71531609875524,-96.0,-0.16092312448007995,40.62337816242552,27.000447027268606,15.380249961538462,15.372827874886944,-72.9995529727314
2015-01-08,15.016,15.157,14.8055,15.023,15.023,61768000,956351957.8702459,523660000,20.204221856454886,-92.0,-0.16407221785589066,42.9908459778059,36.11980330800175,15.331134615384617,15.346914698969393,-63.88019669199825
2015-01-09,15.074,15.1435,14.834,14.8465,14.8465,51848000,908692003.104495,471812000,20.658205774318844,-88.0,-0.17874945947106013,40.01748517161781,20.339740724184242,15.274634615384617,15.309846943490179,-79.66025927581575
2015-01-12,14.878,14.9255,14.464,14.5705,14.5705,68428000,871846156.9506485,403384000,21.960572312600082,-100.0,-0.2102287859847003,35.842809673514324,8.36277974087151,15.226384615384614,15.255080503231646,-91.63722025912848
2015-01-13,14.874,15.075,14.6615,14.737,14.737,82728000,819328381.8599594,486112000,22.4944157521613,-96.0,-0.21921425506536352,39.91500673562202,21.43698468786805,15.183711538461539,15.216704169658932,-78.56301531213195
2015-01-14,14.5965,14.7955,14.325,14.6635,14.6635,110774000,867946513.6346674,375338000,23.70417465867231,-100.0,-0.22961923220758784,38.74586648600023,23.964601769911592,15.146480769230768,15.17572608301753,-76.0353982300884
2015-01-15,14.7,14.8,14.341,14.3475,14.3475,88384000,782065764.17933,286954000,24.807244445532678,-32.0,-0.26036251364713614,34.118773352555834,1.5929203539823595,15.108615384615383,15.11437600279401,-98.40707964601764
2015-01-16,14.314,14.5395,14.2625,14.537,14.537,69564000,850374096.3092941,356518000,25.99165679026272,-40.0,-0.2663652268701764,38.835988049420685,18.610169491525507,15.06676923076923,15.071607409994455,-81.38983050847449
2015-01-20,14.6295,14.668,14.3195,14.472,14.472,61502000,842697376.0797389,295016000,26.475572498684937,-39.99999999999999,-0.2732178913398471,37.835274722155326,14.203389830508478,15.035230769230768,15.02719204629116,-85.79661016949153
2015-01-21,14.482,15.3,14.363,14.8625,14.8625,201302000,856017252.2803794,496318000,24.609581993021266,-40.0,-0.24432219664981858,46.71803466575099,40.67796610169497,15.015788461538461,15.014992635454778,-59.32203389830503
2015-01-22,15.0,15.6125,15.0,15.516,15.516,107252000,929473928.1987466,603570000,23.651316044566205,-40.0,-0.16676776694509776,57.62937324255998,84.9830508474576,15.021557692307693,15.052104292087757,-15.016949152542406
2015-01-23,15.404,15.8465,15.386,15.6195,15.6195,89928000,930743270.2182907,693498000,23.300045503139437,16.0,-0.0958488517411702,59.05935952103073,85.6691919191919,15.033711538461537,15.09413360378496,-14.330808080808088
2015-01-26,15.591,15.65,15.376,15.483,15.483,63394000,916861372.408072,630104000,22.940856904488925,16.0,-0.05008219337067388,56.35789819192303,77.05176767676768,15.06178846153846,15.12293852202311,-22.94823232323231
2015-01-27,15.315,15.512,15.1315,15.3375,15.3375,58406000,921696560.3187158,571698000,21.822037926032596,16.0,-0.025261225207229288,53.54629225582259,67.86616161616163,15.076923076923077,15.138831964836214,-32.13383838383837
2015-01-28,15.4905,15.5755,15.19,15.1955,15.1955,61276000,862169032.4328532,510422000,20.950963491425888,16.0,-0.01685435584604278,50.87854675658137,58.90151515151509,15.088807692307693,15.14302959707057,-41.098484848484915
2015-01-29,15.2365,15.64,14.9665,15.589,15.589,173132000,1009080595.9072406,683554000,19.455899166718897,16.0,0.021314608534899193,57.236652694931884,83.74368686868686,15.111653846153846,15.176064441732008,-16.256313131313135
2015-01-30,17.316,17.975,17.037001,17.7265,17.7265,477122000,1233398878.6324892,1160676000,21.613101755120883,36.0,0.2214889867987715,75.66373435485255,93.3063973063973,15.203942307692309,15.364985594196304,-6.6936026936026884
2015-02-02,17.502501,18.25,17.5005,18.223499,18.223499,204638000,1423565600.0787868,1365314000,23.829235029395623,40.0,0.4154433174978305,78.03386650601601,99.33539811912226,15.315826884615385,15.57672732795954,-0.6646018808777344
2015-02-03,18.0145,18.391001,18.0105,18.1775,18.1775,124252000,1408380772.0441685,1241062000,25.994222336457884,43.99999999999999,0.5589980060227582,77.28365480223755,94.82860728385432,15.432211500000001,15.769377155518093,-5.171392716145663
2015-02-04,17.919001,18.375,17.911501,18.237499,18.237499,83398000,1442297291.4023545,1324460000,27.747056763533994,44.0,0.6698855254537097,77.58634179511216,96.28189505101247,15.539249923076925,15.952200995850086,-3.718104948987528
2015-02-05,18.299999,18.940001,18.295,18.6945,18.6945,144952000,1476905707.5877564,1469412000,29.8187693319492,52.0,0.7855851087633887,79.79474081906494,94.75144954538764,15.658192230769231,16.155334255416747,-5.248550454612352
2015-02-06,18.7435,18.7995,18.550501,18.714001,18.714001,77848000,1501292238.6501305,1547260000,31.742502431191888,52.0,0.8688360289203914,79.88581424490992,95.10875552239901,15.78123073076923,16.344865125385876,-4.891244477601004
2015-02-09,18.549999,18.720501,18.360001,18.528,18.528,54492000,1497588596.5308514,1492768000,33.00432860949147,52.0,0.9093221569189502,76.35085638773683,90.99845073225896,15.897019192307692,16.50657881980174,-9.00154926774104
2015-02-10,18.5595,18.715,18.425501,18.65,18.65,45744000,1522791178.4257798,1538512000,34.17602434648395,52.0,0.9404116058418204,77.067647190303,92.7016250908204,16.02101919230769,16.665350759075686,-7.298374909179594
2015-02-11,18.561501,18.855,18.555,18.757,18.757,55730000,1542110911.7591136,1594242000,35.40277142865271,52.0,0.962588107352996,77.70587549114501,95.39446447855438,16.161307653846155,16.820287739884893,-4.605535521445631
2015-02-12,18.754999,18.925501,18.657499,18.8585,18.8585,55822000,1570021703.4696226,1650064000,36.61277201519056,52.0,0.9770900603050201,78.32220021834944,97.94888688841404,16.31876919230769,16.971266425819348,-2.051113111585964
2015-02-13,18.9205,19.15,18.8505,19.091499,19.091499,69502000,1612372207.6298897,1719566000,37.95888249162153,76.0,0.9959038746086861,79.7089448680967,98.60162543324968,16.479173,17.12832069057347,-1.3983745667503218
2015-02-17,18.886,18.9995,18.633499,18.7715,18.7715,73464000,1594307539.67543,1646102000,38.501335920290465,76.0,0.973767724851065,72.81915204180875,90.95255169116771,16.623346076923077,17.250037676456916,-9.047448308832296
2015-02-18,18.688999,18.837,18.6425,18.668501,18.668501,53012000,1555468958.82196,1593090000,39.00504267548305,76.0,0.9371110750426581,70.70082668375045,88.49052228994861,16.770346115384616,17.355109033756403,-11.509477710051383
2015-02-19,18.6745,19.094,18.671499,18.950001,18.950001,59076000,1574275776.3868885,1652166000,39.78573391866164,76.0,0.9201679895797419,73.01158488724765,90.5348275129331,16.93878846153846,17.47324917940408,-9.465172487066885
2015-02-20,18.931,19.184999,18.792,19.183001,19.183001,65160000,1638773231.800261,1717326000,40.61712976134728,92.0,0.914994142113585,74.78427491984701,99.88138906582904,17.1097885,17.599897462411185,-0.11861093417095442
2015-02-23,19.172001,19.226999,18.9,19.007,19.007,43540000,1623727386.2166362,1673786000,41.43973564294738,96.0,0.8864733084336791,70.991097063075,83.27637138178864,17.27684619230769,17.704127280010358,-16.723628618211368
2015-02-24,18.932501,19.024,18.808001,18.929501,18.929501,38416000,1628529586.300895,1635370000,41.842210135365114,96.0,0.8478434095855079,69.32369524605919,77.38514235673476,17.453077,17.794895703713294,-22.61485764326524
2015-02-25,18.863501,19.3925,18.827,19.268499,19.268499,63490000,1664175825.0630522,1698860000,42.69019985554813,100.0,0.8349583616607497,72.37967763121509,88.70150341685647,17.63505773076923,17.904051503438236,-11.298496583143525
2015-02-26,19.203501,19.4685,19.164,19.24,19.24,53742000,1637260701.910342,1645118000,43.56724360599011,100.0,0.8130746191366711,71.73271050589292,79.38653981645444,17.818442346153844,18.0030106513317,-20.613460183545563
2015-02-27,19.200001,19.2995,18.9895,19.007999,19.007999,50646000,1592659220.323246,1594472000,43.68627651238586,76.0,0.768156226912545,66.52000977701996,58.45724714230704,17.977884615384617,18.077454232714537,-41.54275285769296
2015-03-02,19.0425,19.295,18.974001,19.283001,19.283001,42784000,1632244673.1875844,1637256000,43.73484484514143,76.0,0.7461473187379468,69.36208420831267,82.21484392602481,18.12276926923077,18.1667539932542,-17.78515607397518
2015-03-03,19.1975,19.305,19.08,19.230499,19.230499,38930000,1645394016.0320284,1598326000,43.79636806552111,76.0,0.7162125750827713,68.17226082265326,73.94625068418163,18.261653846153845,18.245549919679814,-26.05374931581837
2015-03-04,19.2855,19.395,19.109501,19.136,19.136,45182000,1608599280.561851,1553144000,44.00591995231843,76.0,0.6770590799103928,65.9784531841878,60.179688407558764,18.402153846153848,18.311509184888717,-39.820311592441236
2015-03-05,19.2805,19.421,19.1945,19.3915,19.3915,53870000,1648436918.5309465,1607014000,44.245558079565285,76.0,0.6590492579957328,68.89316148068889,90.77845415754012,18.55807692307692,18.39150850452659,-9.22154584245987
2015-03-06,19.275999,19.35,18.944,19.004499,19.004499,52540000,1611555132.6196163,1554474000,43.316403195601936,76.0,0.6065565911623594,60.44593722701922,44.43108451367117,18.704576884615385,18.43691520789499,-55.56891548632883
2015-03-09,18.92,18.966499,18.764,18.927999,18.927999,46228000,1640204991.4929938,1508246000,41.721874649865434,72.0,0.5524149679605728,58.90831882148372,34.564043583535266,18.832999923076922,18.473291785087955,-65.43595641646473
2015-03-10,18.872499,18.8885,18.459,18.4755,18.4755,62420000,1582580940.2706425,1445826000,39.16368922353445,68.0,0.467604203708909,50.693880681924014,1.634472511144194,18.861807615384613,18.473455356562923,-98.3655274888558
2015-03-11,18.5305,18.6675,18.313,18.318501,18.318501,49902000,1534227661.8616164,1395924000,36.40119890619952,60.0,0.38330406415322926,48.18336846828623,0.4760709649504475,18.86546153846154,18.461977256076782,-99.52392903504955
2015-03-12,18.441,18.775,18.375999,18.712,18.712,56200000,1572680337.9200726,1452124000,34.09422050300401,60.0,0.3442790424027322,54.29307356938001,34.53050627434019,18.88601923076923,18.480497459330355,-65.4694937256598
2015-03-13,18.576,18.699499,18.334,18.528999,18.528999,52234000,1576181526.065594,1399890000,31.811746145895118,56.00000000000001,0.2951821046505998,51.26565747018619,18.69311986153181,18.897230769230767,18.484090166046627,-81.30688013846819
2015-03-16,18.518999,18.697001,18.336,18.6675,18.6675,47082000,1615568444.4342413,1446972000,29.69230567143686,-36.0,0.26440045707100523,53.38423626707902,30.679359584595552,18.896192307692306,18.497676079672804,-69.32064041540445
2015-03-17,18.5555,18.725,18.482,18.596001,18.596001,40740000,1613053964.9280686,1406232000,27.824743611820878,-36.0,0.2315670470633897,52.12449002638637,24.491648636953897,18.891653846153847,18.504959407104447,-75.5083513630461
2015-03-18,18.498501,18.7995,18.334999,18.757,18.757,53082000,1656422379.8119986,1459314000,26.139942397333076,-36.0,0.21604714979744344,54.71582971175439,40.072202166065196,18.90046153846154,18.523629080652267,-59.927797833934804
2015-03-19,18.693501,18.855499,18.609501,18.662001,18.662001,38314000,1634462049.354027,1421000000,24.35273540704082,-36.0,0.19384734254010638,52.896471664797694,31.49828519855605,18.900923115384614,18.533878852455803,-68.50171480144395
2015-03-20,18.814501,18.9685,18.796,18.9245,18.9245,75272000,1671334420.3685193,1496272000,22.974238211134256,-36.0,0.19518533579957165,57.137542774988,55.1895306859205,18.90736542307692,18.56281375227389,-44.8104693140795
2015-03-23,18.9035,19.088499,18.747,18.755501,18.755501,44786000,1628778153.3164926,1451486000,22.136765744594662,-36.0,0.18052788509630702,53.780272697764325,39.936913357400705,18.903403923076922,18.577086881735084,-60.063086642599295
2015-03-24,18.699499,18.761999,18.613501,18.7045,18.7045,44564000,1638831446.963545,1406922000,20.782895130303338,-36.0,0.16291837374649631,52.77252495435334,35.33393501805058,18.888519346153846,18.58652489049545,-64.66606498194942
2015-03-25,18.758499,19.025,18.5145,18.548,18.548,68590000,1579243464.593319,1338332000,20.44778818095807,-36.0,0.13478079791691755,49.69526504288228,22.661523625843667,18.879923192307693,18.583671194903193,-77.33847637415633
2015-03-26,18.4795,18.57,18.282499,18.3675,18.3675,58600000,1555294186.503851,1279732000,19.20437662094186,-80.0,0.09680086474083893,46.33904135703239,10.546029776674764,18.86834623076923,18.567658513799255,-89.45397022332523
2015-03-27,18.355499,18.658501,18.328501,18.528,18.528,52196000,1566207579.2553656,1331928000,18.35552221367903,-80.0,0.07874478188504241,49.59861552185784,30.45918114143897,18.852115423076924,18.564720846110422,-69.54081885856102
2015-03-30,18.5935,18.806,18.577499,18.7295,18.7295,36418000,1578240766.9350698,1368346000,18.053322758170637,-80.0,0.07977497586542981,53.42379027527733,55.45918114143941,18.834673076923078,18.5769267093615,-44.54081885856059
2015-03-31,18.662001,18.885,18.5755,18.605,18.605,50122000,1537673526.2242455,1318224000,18.021910544561855,-80.0,0.06974136743563975,50.8556034665997,40.01253101736974,18.819211538461538,18.579006212371763,-59.98746898263026
2015-04-01,18.605,18.658001,18.417,18.513,18.513,49162000,1527677770.3477144,1269062000,17.314810820824086,-80.0,0.05374647345292516,48.98177599699336,28.598138957816506,18.80319226923077,18.574116863307186,-71.4018610421835
2015-04-02,18.525,18.664,18.450001,18.612499,18.612499,37506000,1547131382.1963675,1306568000,16.679733426950186,-80.0,0.048539608099478215,51.081116558725036,40.94292803970215,18.7779615,18.57695998454369,-59.05707196029785
2015-04-06,18.504999,19.01,18.468,18.851999,18.851999,61014000,1572572419.0450757,1367582000,17.196661651409467,-60.0,0.06301241036558736,55.79619282245527,70.65756823821337,18.763038384615385,18.597333244947865,-29.34243176178663
2015-04-07,18.807501,18.9655,18.7015,18.720501,18.720501,39098000,1539102457.6662877,1328484000,17.676666431264515,-60.0,0.06314354136763356,52.78773762452807,54.342679900744265,18.75198076923077,18.606456782359135,-45.657320099255735
2015-04-08,18.733,19.079,18.7325,19.059999,19.059999,52728000,1586047573.2333875,1381212000,18.451019362835407,-60.0,0.08960915635364941,58.94278283995635,96.46401985111692,18.74340376923077,18.640052502184385,-3.5359801488830795
2015-04-09,19.033001,19.221001,18.940001,19.177,19.177,47846000,1618909431.9807181,1429058000,19.55472918118895,-60.0,0.11865655092840655,60.83766434911687,95.3115709929226,18.741346115384616,18.67982639091147,-4.688429007077398
2015-04-10,19.2155,19.356001,19.066,19.1325,19.1325,51470000,1591044557.480286,1377588000,20.917687969965552,-60.0,0.13651241219434596,59.7089422032326,79.18019714914371,18.7412115,18.71335776936247,-20.81980285085629
2015-04-13,19.1765,19.264,19.007,19.118,19.118,37890000,1585884440.7487679,1339698000,21.860422486514548,39.99999999999999,0.14778965492755347,59.32272794583854,77.82947772803394,18.73069226923077,18.743331267928216,-22.170522271966057
2015-04-14,19.175501,19.390499,19.060499,19.255501,19.255501,51672000,1595279976.1669495,1391370000,23.065298230451216,48.0,0.165909629662373,61.84320828385131,87.81606498194947,18.74034619230769,18.7812697666002,-12.18393501805053
2015-04-15,19.2325,19.289,19.082001,19.172501,19.172501,38664000,1590423791.6636424,1352706000,24.18411142124955,48.0,0.1715944004128751,59.4486235124791,80.32509025270771,18.749750115384614,18.81024985796315,-19.674909747292283
2015-04-16,19.1845,19.372499,19.1775,19.302,19.302,41608000,1601946279.5122979,1394314000,25.44564487943998,48.0,0.18442319344631386,61.925719926192144,91.66674513511336,18.78153857692308,18.846675794410324,-8.333254864886642
2015-04-17,19.1315,19.177999,18.719999,18.778,18.778,76794000,1544602623.5908997,1317520000,24.277963159409182,48.0,0.150571983504463,48.907246094565124,37.08272941215125,18.799211615384614,18.841588698528078,-62.91727058784875
2015-04-20,18.9275,19.597,18.85,19.4755,19.4755,100322000,1612289756.1210198,1417842000,24.397949818902152,64.0,0.1779754858747573,60.738975877015434,89.70338983050839,18.828577,18.8885450912297,-10.296610169491617
2015-04-21,19.5655,19.73,19.34,19.559,19.559,92870000,1623719909.967174,1510712000,24.824686200461517,68.0,0.20407822436003187,61.87713099184663,86.97638994668701,18.868192423076923,18.938208417805278,-13.023610053312987
2015-04-22,19.595501,19.714001,19.4,19.49,19.49,69494000,1594063107.937881,1441218000,25.2209414119095,68.0,0.21669913657088813,60.32096678271184,81.2499853515509,18.899827038461538,18.97908186833822,-18.7500146484491
2015-04-23,19.5105,19.594,19.307501,19.4995,19.4995,159600000,1648376876.5723274,1600818000,25.16161156466797,68.0,0.2248756445814344,60.468377510703924,81.73534072900165,18.934576999999997,19.017631359572427,-18.26465927099835
2015-04-24,21.950001,22.6325,21.950001,22.254999,22.254999,343538000,1611882265.4241805,1944356000,28.44836757392988,80.0,0.4485309412326437,81.70220087635164,90.39682014754518,19.069115423076923,19.25743636997447,-9.603179852454812
2015-04-27,22.193001,22.349501,21.870501,21.927999,21.927999,108618000,1529340748.7811737,1835738000,31.290829044094778,80.0,0.5925625162017418,76.45393778175116,81.99358926681423,19.19473073076923,19.455255824050433,-18.006410733185774
2015-04-28,21.925501,21.950001,21.402,21.4655,21.4655,82810000,1465722082.37363,1752928000,32.75150151579724,80.0,0.6617604109359121,69.64014048356626,70.17253158529539,19.292461499999998,19.604162800046694,-29.827468414704608
2015-04-29,21.3375,21.712,21.3015,21.4685,21.4685,72434000,1452223419.7670522,1825362000,33.86768216393498,80.0,0.708673172782504,69.65902970058711,70.24920888199131,19.396807615384617,19.742261851895087,-29.750791118008706
2015-04-30,21.355499,21.5875,20.962,21.089001,21.089001,72958000,1408892083.1019843,1752404000,34.11353729615505,80.0,0.7070787135707697,64.21610618898168,60.549556409059036,19.48851919230769,19.842020307310268,-39.45044359094096
2015-05-01,21.191,21.282,20.799999,21.143499,21.143499,71316000,1439223365.9914384,1823720000,33.979744164095045,80.0,0.7021190351163291,64.64335461879858,61.9424761808367,19.588346076923077,19.938426136398395,-38.0575238191633
2015-05-04,21.24,21.488501,21.121,21.152,21.152,45408000,1401476014.533892,1869128000,34.0889619076154,76.0,0.6909100330780475,64.71412766232723,62.15975408057405,19.69544223076923,20.02832049666518,-37.84024591942595
2015-05-05,21.1425,21.3755,21.051001,21.0595,21.0595,57128000,1347340509.869779,1812000000,34.0228947485729,64.0,0.6668755154346293,63.230984201073305,59.79553743245047,19.792807615384614,20.104704163578873,-40.20446256754953
2015-05-06,21.071501,21.136,20.727501,20.955,20.955,51050000,1353151476.2368934,1760950000,33.20735550725127,64.0,0.6321091495836946,61.5157261899315,57.1246115975433,19.87840376923077,20.16768904035081,-42.8753884024567
2015-05-07,21.2075,21.424999,21.1425,21.344,21.344,55322000,1376749281.2627528,1816272000,32.841888213732666,64.0,0.628698359819186,65.29030350166887,65.9352280237938,19.98374992307692,20.25482318551001,-34.0647719762062
2015-05-08,21.5375,21.76,21.508499,21.6845,21.6845,58176000,1399996688.5334985,1874448000,32.92004228264797,60.0,0.6460238281254043,68.22784431588732,71.48871322968819,20.105730692307695,20.36072517176853,-28.511286770311806
2015-05-11,21.6255,21.950001,21.568501,21.6425,21.6425,47874000,1370694788.8008635,1826574000,33.21581906313738,56.00000000000001,0.6488853907228673,67.46934283889654,70.22555495505408,20.222269192307692,20.45567145534123,-29.77444504494592
2015-05-12,21.554001,21.6625,21.335501,21.551001,21.551001,38956000,1383084621.6627374,1787618000,32.914866747899296,52.0,0.6364335848864258,65.75431651860563,67.47370450336976,20.326076961538465,20.536806977167807,-32.52629549663023
2015-05-13,21.499001,21.6765,21.290001,21.3435,21.3435,39926000,1354211695.9216614,1747692000,32.52287019334664,19.999999999999996,0.6028723058420802,61.91087913367843,32.335922486048474,20.426961538461537,20.596562015896115,-67.66407751395153
2015-05-14,21.4725,21.65,21.3505,21.614,21.614,37770000,1382901762.6996253,1785462000,32.15887339269061,20.0,0.5912858643589942,64.79941142110431,54.65468557336626,20.52519234615385,20.671927792496405,-45.34531442663374
2015-05-15,21.4,21.52,21.215,21.299999,21.299999,84806000,1345364124.627494,1700656000,31.45247052965418,20.0,0.550421354771288,59.188161966577105,46.830102249488704,20.606846153846156,20.718451585644818,-53.169897750511296
2015-05-18,21.299999,21.363501,21.073,21.261999,21.261999,47804000,1359762376.5715492,1652852000,30.415004929195796,20.0,0.5091010540427874,58.527640735303414,43.721717791410974,20.688749961538463,20.758714357078535,-56.278282208589026
2015-05-19,21.2435,21.412001,21.0315,21.085501,21.085501,49284000,1324467224.348559,1603568000,29.545480204516092,20.0,0.45684626510686144,55.43333102692554,29.284253578732148,20.764423076923077,20.782920775072718,-70.71574642126785
2015-05-20,21.030001,21.355,20.917999,21.193001,21.193001,43924000,1335825422.0918133,1647492000,28.414354710066767,20.000000000000004,0.4192751767370453,56.92702287738658,38.07770961145183,20.838942307692307,20.813297088030293,-61.92229038854817
2015-05-21,21.4,21.844999,21.4,21.581499,21.581499,82428000,1320636222.9520404,1729920000,28.29622661606494,20.0,0.41605236759559716,61.897208788869364,69.85668711656447,20.93159607692308,20.87020093336138,-30.143312883435534
2015-05-22,21.577499,21.622,21.380501,21.3815,21.3815,40412000,1280558564.6097698,1689508000,28.12822817217591,20.0,0.3928317009737121,58.175586983079945,53.496850715746326,21.011576846153847,20.908074938297577,-46.503149284253674
2015-05-26,21.309999,21.35,21.1,21.2735,21.2735,44884000,1297973556.6097689,1644624000,27.156155466498323,16.0,0.36154677184290307,56.21016133599746,44.66249488752542,21.107557615384618,20.935143461386648,-55.33750511247458
2015-05-27,21.372499,21.592501,21.2505,21.570999,21.570999,44622000,1336984682.700044,1689246000,26.72903861214956,4.0,0.356647710309165,60.19908177901243,63.27507117234278,21.18815373076923,20.9822438716543,-36.72492882765722
2015-05-28,21.4855,21.567499,21.2735,21.328501,21.328501,38248000,1313047467.757136,1650998000,26.332430104539988,4.0,0.3294004830641093,55.741797506091096,39.77724849370449,21.256211461538463,21.007892547828057,-60.22275150629551
2015-05-29,21.3615,21.625,21.3615,21.4615,21.4615,60322000,1298510666.9981234,1711320000,26.082206178286214,4.0,0.3149086955295033,57.596225113563754,52.66472351797783,21.332038384615387,21.041493099840793,-47.33527648202217
2015-06-01,21.52,21.658001,21.309999,21.546,21.546,45066000,1314568574.7112975,1756386000,25.675930671366594,-32.0,0.3067067685946441,58.77800907790515,67.7455231930959,21.41074992307692,21.078863981334067,-32.2544768069041
2015-06-02,21.5035,21.661501,21.3125,21.5495,21.5495,33378000,1326523315.8782277,1789764000,25.306912632633555,-28.000000000000004,0.2970647259124064,58.82919128257573,68.12308522114326,21.38361534615385,21.113725908642653,-31.876914778856747
2015-06-03,21.719999,21.9195,21.637501,21.8295,21.8295,54558000,1346256937.0683737,1844322000,25.549902232695633,-24.0,0.30846124830196686,62.80767863662173,91.0134887533812,21.379826923076923,21.16674621170616,-8.986511246618802
2015-06-04,21.719999,21.837999,21.462999,21.539,21.539,50216000,1316395423.5537074,1794106000,25.133088629146812,12.0,0.2907011305353606,56.687187376414485,62.00702745179511,21.382653846153843,21.194320566394595,-37.99297254820489
2015-06-05,21.483,21.540001,21.325001,21.3475,21.3475,38158000,1286223626.7351027,1755948000,24.265732050432256,12.000000000000004,0.2581973216807789,53.01930898661261,42.88572852148939,21.378000000000004,21.20566719110611,-57.11427147851061
2015-06-08,21.281,21.34,21.071501,21.174999,21.174999,43450000,1276270869.5553734,1712498000,22.653190340836794,12.0,0.21602819141943286,49.88794769338957,25.661482115344985,21.381307615384614,21.203395473246395,-74.33851788465502
2015-06-09,21.148001,21.3745,20.957001,21.274,21.274,45774000,1300007513.7772756,1758272000,21.251334107648194,12.0,0.18842535498767177,51.65277931438258,35.54674433675076,21.386326884615382,21.208625438191106,-64.45325566324924
2015-06-10,21.323,21.610001,21.283001,21.5385,21.5385,43446000,1324453926.9515872,1801718000,20.202857710852378,12.0,0.18575161869512513,56.10100155761982,60.41554328887602,21.40119226923077,21.233060590917688,-39.58445671112398
2015-06-11,21.6145,21.9445,21.5735,21.6485,21.6485,58450000,1289636002.423285,1860168000,20.06176277078409,12.0,0.19031491226996167,57.8383397264075,70.02528610155524,21.423846115384613,21.26383388047934,-29.97471389844476
2015-06-12,21.5625,21.618,21.413,21.496,21.496,41088000,1281819260.95987,1819080000,19.419348190891434,-28.0,0.179556069204434,54.611511916520264,54.5822324883364,21.44465380769231,21.281031370814205,-45.4177675116636
2015-06-15,21.382999,21.4025,21.132,21.1835,21.1835,41020000,1256418706.4312186,1778060000,18.05468290771075,-28.0,0.14415177826472458,48.6248699290129,22.936630821904323,21.43848073076923,21.273806824827968,-77.06336917809568
2015-06-16,21.2075,21.3985,21.133499,21.363001,21.363001,45928000,1290041861.7551615,1823988000,16.78749371618583,-28.000000000000004,0.1290897864656415,51.887434646506364,41.11396568502843,21.426115384615386,21.280413800766638,-58.88603431497157
2015-06-17,21.417999,21.567499,21.237499,21.390499,21.390499,43718000,1286862370.84607,1867706000,16.043954816762405,60.0,0.11801154461204888,52.38627011265751,43.89857609982357,21.416423038461538,21.288568259969107,-56.10142390017643
2015-06-18,21.514999,21.9865,21.470501,21.9695,21.9695,67568000,1349978207.1790864,1935274000,16.36456957442174,80.0,0.15417526344912602,61.44964730672666,98.3487113634885,21.43251915384615,21.339007648119544,-1.6512886365114972
2015-06-19,22.013,22.2495,21.662001,21.746,21.746,89902000,1285784091.2708035,1845372000,17.188599190868015,84.0,0.1629226185100947,56.94369690721724,61.04445728778106,21.447999923076924,21.36915522974032,-38.95554271221894
2015-06-22,21.85,21.962,21.709,21.814501,21.814501,36472000,1279729739.2708035,1881844000,17.953769548996696,84.0,0.17338375858908606,57.961167179714856,66.3443453341162,21.4557115,21.40214380531511,-33.6556546658838
2015-06-23,21.779499,22.351999,21.6845,22.2995,22.2995,64900000,1334420929.6695905,1946744000,19.372567355364847,92.0,0.21829330413714132,64.37939211319787,96.23662542885359,21.494153846153843,21.468614634551024,-3.7633745711464144
2015-06-24,22.248501,22.3235,22.011499,22.042,22.042,52416000,1292253232.8224654,1894328000,20.69002246127813,92.0,0.23044986199801087,59.21064647794008,77.777817602606,21.52415388461538,21.51108762458428,-22.222182397393993
2015-06-25,21.9035,22.1735,21.8195,22.004999,22.004999,44750000,1294401991.297042,1849578000,21.19664586421265,92.0,0.23439637471523866,58.48404446160428,75.12541236618272,21.559519192307693,21.547673652392852,-24.874587633817278
2015-06-26,22.087999,22.1745,21.753,21.905001,21.905001,52490000,1279769796.7062943,1797088000,21.425761360042134,40.0,0.22684013966788186,56.46727542521929,67.95708667682668,21.586903807692302,21.574142344808195,-32.04291332317333
2015-06-29,21.749001,21.85,21.450001,21.493,21.493,55064000,1236544310.9825795,1742024000,20.618076655465615,40.0,0.1854687630391183,48.97393585097989,29.59018818867866,21.5835,21.56813180074833,-70.40981181132135
2015-06-30,21.709999,21.7785,21.523001,21.7045,21.7045,51938000,1258396776.40123,1793962000,19.868083715501708,40.0,0.16781348205602242,52.461489788064824,46.926267972350715,21.595923076923075,21.578233148841047,-53.073732027649285
2015-07-01,21.967501,22.0,21.778999,21.869499,21.869499,39742000,1251203506.9499612,1833704000,19.741267907634512,40.0,0.16523090599170587,55.04304475501984,60.45078725474373,21.618846115384613,21.599808397075044,-39.54921274525627
2015-07-02,21.85,21.91,21.674,21.8855,21.8855,26868000,1272492981.5262325,1860572000,19.25801321782834,40.0,0.1626009799471113,55.296573448864486,61.76234570684077,21.630942307692308,21.620970738032447,-38.23765429315923
2015-07-06,21.761499,21.9865,21.676001,21.802,21.802,38064000,1265321357.5789735,1822508000,19.013658877092503,40.0,0.1520265252973907,53.597929807571425,54.862617972917505,21.649153807692304,21.634380312993006,-45.137382027082495
2015-07-07,21.784,21.886499,21.2785,21.836,21.836,69084000,1322929440.9541101,1891592000,17.81009368882904,40.0,0.1447214508533392,54.21467739727913,53.701301031852765,21.66355765384615,21.649315104623152,-46.298698968147235
2015-07-08,21.717501,21.7995,21.4415,21.485001,21.485001,47662000,1286850372.0267358,1843930000,16.692497442584393,40.0,0.10934893439884164,47.234855502105525,19.23625452841593,21.66121153846154,21.637143689465884,-80.76374547158407
2015-07-09,21.745001,21.936001,21.7075,21.7195,21.7195,45428000,1246193782.217501,1889358000,15.770928426237635,40.00000000000001,0.09909575558806338,51.708089804465445,41.080615817993284,21.667749999999998,21.643244156912857,-58.919384182006716
2015-07-10,22.0245,22.236,21.950001,22.175501,22.175501,48020000,1273897893.1409657,1937378000,15.748233788534048,40.0,0.12630949007434467,58.98898124790187,83.55862464706544,21.68105773076923,21.682670589734126,-16.441375352934564
2015-07-13,22.414499,22.893499,22.377001,22.7785,22.7785,79136000,1317794411.6173205,2016514000,17.070635337057123,92.0,0.19429385196445992,66.23792571678155,92.87931447635586,21.72873080769231,21.76384313864271,-7.120685523644138
2015-07-14,23.115999,23.48,22.908001,23.2785,23.2785,94724000,1345780931.3070407,2111238000,19.125368056533677,96.0,0.2852298180952957,70.84042290605102,90.84714967067912,21.803000038461537,21.876039943187696,-9.152850329320891
2015-07-15,23.152,23.235001,23.01,23.0595,23.0595,59748000,1312321934.467026,2051490000,21.033334153190477,96.0,0.3357553776781934,66.56046449630797,80.8993867817397,21.87548084615385,21.96370365109972,-19.100613218260307
2015-07-16,23.275,23.794001,23.24,23.774,23.774,81912000,1388319425.6051285,2133402000,23.435332870474788,88.0,0.42851180894481544,72.41590914395199,99.2048900000437,21.971634692307696,22.097799676944188,-0.7951099999562949
2015-07-17,23.885,24.271,23.862499,24.150499,24.150499,98644000,1428766747.2909994,2232046000,26.087478843607038,92.0,0.526335009407898,74.90913464812594,95.97323308270674,22.072096192307693,22.249851478652026,-4.026766917293262
2015-07-20,24.6285,24.66,24.27,24.405001,24.405001,95050000,1399521080.8807425,2327096000,28.839267333391383,96.0,0.6172811521136445,76.4581493586981,92.45899748632259,22.17811546153846,22.40949218393706,-7.54100251367741
2015-07-21,24.395,24.444,24.127501,24.4,24.4,63636000,1445463603.1762314,2263460000,30.93697364438399,96.0,0.6811017693091621,76.35839152441726,92.31110453940553,22.28980776923077,22.55693720734913,-7.688895460594459
2015-07-22,24.2995,24.625,24.245001,24.4135,24.4135,62298000,1438413910.1559865,2325758000,33.03570728358973,92.0,0.7244187569203575,76.44772570909171,92.71033564985949,22.414038538461536,22.69446037717512,-7.289664350140503
2015-07-23,24.583,24.583,23.785,24.108999,24.108999,187488000,1403171334.9980924,2138270000,33.593074983144355,88.0,0.7258104052548191,70.02074464398684,83.7054265858347,22.519653846153844,22.79924101590289,-16.2945734141653
2015-07-24,28.949499,29.0285,26.467501,26.471001,26.471001,438188000,966181037.9257399,2576458000,36.47041637469946,52.0,0.90705119634017,82.38890373195153,67.00001290322581,22.715057769230768,23.07122323694712,-32.99998709677419
2015-07-27,26.387501,27.247499,26.33,26.570499,26.570499,149820000,894904034.0053005,2726278000,38.915434380424706,52.0,1.0466493637564405,82.71245003607683,67.6024647423224,22.892019269230772,23.33042884902511,-32.397535257677596
2015-07-28,26.799999,26.8195,26.156,26.3015,26.3015,105462000,835695902.8824675,2620816000,40.88974156824029,52.0,1.122634909581084,78.5128145544772,62.750990301871326,23.067230807692304,23.55050819354177,-37.24900969812867
2015-07-29,26.546,26.6485,26.250999,26.450001,26.450001,75052000,835790874.1051818,2695868000,42.723026814069044,52.0,1.1812204180239654,79.14241936591867,63.572799826629904,23.24551926923077,23.765285438464602,-36.42720017337009
2015-07-30,26.3825,26.959999,26.2145,26.837999,26.837999,74862000,886150724.5382475,2770730000,44.5400178109767,52.0,1.2446109512139856,80.73107843819506,67.0675587563044,23.420076923076923,23.99289385043019,-32.93244124369561
2015-07-31,26.9545,27.142,26.726,26.807501,26.807501,60512000,849349246.2305549,2710218000,46.29389081554707,52.0,1.277659409397458,80.21389697754452,63.712125432909936,23.603365423076923,24.201383268916842,-36.287874567090064
2015-08-03,26.872499,27.021999,26.468,26.751499,26.751499,60284000,850763746.4661146,2649934000,47.40512222338634,52.0,1.2845244588643112,79.21043378603132,62.16663620503444,23.785923115384612,24.39028073047856,-37.83336379496556
2015-08-04,26.484501,26.8475,26.458,26.594999,26.594999,58692000,833359270.5123285,2591242000,48.416346450170515,52.0,1.262780273017949,76.33648211443887,57.959730500129595,23.966307653846155,24.553593194887554,-42.040269499870405
2015-08-05,26.940001,26.957001,26.705999,26.8505,26.8505,57788000,842107981.6779765,2649030000,49.411934618926004,52.0,1.2517354177478026,77.75548400930225,58.46285877753408,24.172365346153846,24.7237344397107,-41.53714122246591
2015-08-06,26.965,27.136999,26.375999,26.473,26.473,76410000,785177210.0879631,2572620000,49.6092392731001,52.0,1.1987032899122418,70.98272860167013,51.2634690569276,24.355769192307694,24.853309666398797,-48.73653094307241
2015-08-07,26.458,26.473,25.9105,26.131001,26.131001,79384000,768030548.342186,2493236000,48.84711380699309,52.0,1.1162114941446433,65.42295529069192,44.74112710975495,24.519673115384617,24.947953468887775,-55.25887289024505
2015-08-10,26.426001,26.614,26.15,26.200001,26.200001,52318000,726988204.8852898,2545554000,48.259746959264184,52.00000000000001,1.044365084421944,66.0015473700096,46.05704205206446,24.68561546153846,25.04069773045164,-53.94295794793554
2015-08-11,26.182501,26.448999,26.1,26.372999,26.372999,53532000,757205341.5189189,2599086000,47.60961606457652,52.0,0.9899739761272706,67.47124738040159,49.35632688090015,24.861423115384618,25.139386713381146,-50.643673119099844
2015-08-12,26.1875,26.375,25.653,26.2955,26.2955,79246000,818999660.0784758,2519840000,46.09923966964302,48.0,0.929895848818024,66.09288331000641,19.03421715301441,25.032942346153845,25.225024734612173,-80.96578284698559
2015-08-13,26.3685,26.733,26.2745,26.483,26.483,57904000,813758621.910537,2577744000,45.079850122912305,44.0,0.8871862522216851,67.80646093628489,52.05396804889815,25.225173076923078,25.318208087603864,-47.94603195110185
2015-08-14,26.4125,26.7055,26.4125,26.576,26.576,39896000,818388191.8764071,2617640000,44.13327411523379,40.0,0.8510327363445356,68.65267410782235,61.98791134989935,25.41196153846154,25.411377858892468,-38.01208865010065
2015-08-17,26.564501,26.937,26.356001,26.761,26.761,51634000,838739576.9321471,2669274000,43.506852564277146,36.0,0.8277667881633519,70.32374041845547,74.41235728676965,25.588326884615388,25.51134986934488,-25.58764271323036
2015-08-18,26.752001,26.974501,26.65,26.750999,26.750999,41426000,823100767.5663828,2627848000,42.9665724809913,32.0,0.7993074408628473,70.10616702257012,73.74069845533921,25.741115307692308,25.603175730874888,-26.259301544660783
2015-08-19,26.687,26.862499,26.450001,26.646,26.646,46480000,820790841.2152249,2581368000,41.98931996437035,28.000000000000004,0.7595253261303974,67.73668095285328,66.68905305574222,25.87063453846154,25.680421973032303,-33.310946944257786
2015-08-20,26.519501,26.6625,25.7885,25.789,25.789,88160000,732731710.7804427,2493208000,39.71018801302278,24.0,0.6513367709852531,52.22230487311849,9.164426660665049,25.97561530769231,25.688464789844723,-90.83557333933496
2015-08-21,25.368,25.616501,24.723499,24.723499,24.723499,134130000,598601710.7804427,2359078000,37.76392891871462,4.0,0.4741537859457807,39.96601611516848,0.0,26.012134500000002,25.616985842448816,-100.0
2015-08-24,23.179001,23.829,22.549999,23.168501,23.168501,201952000,591970458.6203581,2157126000,37.89747909009014,-84.0,0.20588632147387642,29.19653247999888,13.483802049269663,25.974365346153846,25.435616594860015,-86.51619795073033
2015-08-25,24.3745,24.472,23.3125,23.318501,23.318501,113586000,479560188.8247568,2270712000,37.12394335343738,-84.0,0.00532478866569619,31.12456555738318,16.75391323304996,25.932576884615383,25.27879321746298,-83.24608676695004
2015-08-26,24.201,25.186001,23.938,25.0385,25.0385,127172000,576671320.008145,2397884000,35.52382520627678,-84.0,-0.014663099302712368,48.45675205654629,56.243640527227676,25.957134576923075,25.260993719873127,-43.756359472772324
2015-08-27,25.685499,26.134501,25.363001,25.918501,25.918501,122290000,630485260.3840357,2520174000,33.038001255459,-84.0,0.04004348532948043,54.733130449207444,76.1329071610771,26.01501923076923,25.309697962845487,-23.867092838922908
2015-08-28,25.875,26.075001,25.652,25.900499,25.900499,54934000,640095051.3727093,2465240000,30.729736158271063,-84.0,0.08101237659026239,54.586694936592245,75.72603651213176,26.083923076923078,25.35346100263471,-24.27396348786824
2015-08-31,25.822001,25.970501,25.453501,25.644501,25.644501,60046000,624415728.3553017,2405194000,28.79034129705903,-80.0,0.09176579992460177,52.43815217574267,69.9401198146142,26.052134615384617,25.375019520958066,-30.059880185385794
2015-09-01,24.957001,25.5,24.671499,24.827,24.827,77290000,576138782.7511325,2327904000,27.738616782185947,-64.0,0.0339313276090607,46.18632438443913,51.46344153534119,25.98507696153846,25.33442548236858,-48.5365584646588
2015-09-02,25.254499,25.542999,24.886,25.5275,25.5275,74142000,646782674.3582737,2402046000,26.709872825893196,-64.0,0.04411307918395835,51.52000187637077,67.29573181343346,25.955307730769235,25.34872729848943,-32.70426818656654
2015-09-03,25.725,25.792,25.1285,25.236,25.236,62994000,604201198.8496078,2339052000,25.44391445371246,-64.0,0.028333960569607797,49.32895768372015,60.70741972768915,25.908615384615384,25.34037712823095,-39.29258027231086
2015-09-04,24.8825,25.1425,24.782,24.950001,24.950001,53850000,600541788.8634778,2285202000,24.62195009235582,-64.0,-0.007166225929609027,47.2076751359283,54.24343801856119,25.836000076923078,25.311460377991622,-45.75656198143881
2015-09-08,25.4345,25.9175,25.425501,25.877001,25.877001,76214000,664208646.3448954,2361416000,22.916049211903886,-48.0,0.039050621980457834,54.097839886187145,77.14787246376811,25.80021161538462,25.35335227591817,-22.85212753623188
2015-09-09,26.200001,26.497499,25.753,25.8445,25.8445,87414000,598281259.4901111,2274002000,21.840757609059455,-48.00000000000001,0.07222270940879838,53.83255926934945,80.10942732901461,25.76532703846154,25.38973358881312,-19.890572670985396
2015-09-10,25.7575,26.306499,25.739,26.112,26.112,51520000,614486347.9924695,2325522000,20.825210618799158,-48.0,0.11872821711579817,55.75563041666482,90.23435085497142,25.746750153846158,25.44323480445659,-9.765649145028569
2015-09-11,26.053499,26.472,26.0305,26.472,26.472,64558000,679044347.9924695,2390080000,20.063130681482306,-48.0,0.18252907680514951,58.274602925277065,99.3540468651045,25.732192461538464,25.519439633756104,-0.6459531348955017
2015-09-14,26.472,26.622499,25.929001,26.069,26.069,62604000,641716548.9216717,2327476000,19.523303788060723,-15.999999999999996,0.19828725374917155,54.531755498789884,83.27797077884308,25.716654000000002,25.560147809033428,-16.722029221156923
2015-09-15,26.1625,26.396,25.860001,26.1185,26.1185,57318000,639684643.4181168,2384794000,18.919599523390787,-16.0,0.2123224379218449,54.91479335812392,81.22558436415883,25.716173192307693,25.601507230586506,-18.77441563584117
2015-09-16,26.099001,26.415001,25.926001,26.369499,26.369499,45056000,676355620.4651518,2429850000,18.382938862505373,-16.0,0.24092174816628642,56.897626531531316,87.03229113275243,25.72269234615385,25.658395509802318,-12.967708867247568
2015-09-17,26.349001,27.348499,26.328501,26.943501,26.943501,83390000,693524347.0508904,2513240000,18.93600999304893,68.0,0.30637240151259704,61.109906219077395,84.87119910347407,25.74463473076923,25.753588509076224,-15.128800896525929
2015-09-18,26.731001,27.312,26.567499,27.013,27.013,123202000,717767721.0718791,2636442000,19.44957604283937,68.0,0.35970405981512243,61.59924052207152,87.4673515128876,25.77223088461539,25.846878249144652,-12.532648487112391
2015-09-21,27.216499,27.489,26.9795,27.4195,27.4195,65666000,765518953.6528405,2702108000,20.11245399950889,76.0,0.4298162814502575,64.41923723863161,97.53327505473818,25.808250115384617,25.963368749208012,-2.4667249452618276
2015-09-22,26.9855,27.1775,26.632999,26.92,26.92,76834000,769681810.7164644,2625274000,20.091957488923402,76.0,0.4400031641393234,58.7135644528806,78.9804211304027,25.821480884615383,26.03423032334075,-21.0195788695973
2015-09-23,26.915001,27.060499,26.700001,26.803499,26.803499,44752000,750626166.8460402,2580522000,20.072925014808305,76.0,0.4336765318969711,57.435794243524654,74.67672700406347,25.82311546153846,26.091213188278473,-25.323272995936534
2015-09-24,26.5275,26.728001,26.143499,26.6875,26.6875,70020000,810942590.0575949,2510502000,19.07836678864399,76.0,0.41452410456297173,56.12604538015422,70.3915773919468,25.82067319230769,26.135382581739325,-29.608422608053214
2015-09-25,27.1285,27.139999,26.07,26.2125,26.2125,80620000,751796161.5282222,2429882000,18.713989624633655,76.0,0.3569029822407437,50.99767027196006,38.139054101794954,25.804000115384618,26.141094983091968,-61.860945898205046
2015-09-28,26.000999,26.014,24.716499,25.202999,25.202999,108690000,724613127.6114852,2321192000,18.23392916942864,76.0,0.22716096352970538,42.17721390498526,17.54733361683185,25.781461615384615,26.07160639175182,-82.45266638316815
2015-09-29,25.299999,25.573999,24.525,24.803499,24.803499,89150000,682800038.0375199,2232042000,17.999078596061633,76.0,0.09105355897228051,39.28169967403914,9.396052631578943,25.78453853846154,25.977672510881316,-90.60394736842106
2015-09-30,25.271999,25.639999,25.0835,25.5945,25.5945,80094000,749797170.2767514,2312136000,17.680012240569212,72.0,0.046478851025899104,47.03492396723939,36.082995951417026,25.877846192307693,25.949289361927143,-63.917004048582974
2015-10-01,25.549999,26.040001,25.299999,26.035999,26.035999,75370000,824351954.2638217,2387506000,16.78107609062539,68.0,0.046245266725733813,50.81041364700354,50.97837381916331,25.98236534615385,25.955712298080687,-49.021626180836684
2015-10-02,25.6495,26.629999,25.405001,26.627001,26.627001,91956000,915857857.0587648,2479462000,16.011095531850017,-24.0,0.09268070618599111,55.394147959200275,70.91771255060728,26.043461538461543,26.005437387111748,-29.08228744939272
2015-10-05,26.849501,27.2955,26.799999,27.184,27.184,67828000,953159896.4653454,2547290000,16.05935783753928,-24.0,0.17243852677524174,59.24840784962061,89.70985155195683,26.092134576923076,26.092738321399768,-10.290148448043167
2015-10-06,27.275,27.575001,26.6665,26.874001,26.874001,90056000,904241352.6838857,2457234000,16.39517826878792,20.0,0.20823247137622047,56.33106367145755,77.01640097822919,26.12957696153846,26.15060963092571,-22.983599021770818
2015-10-07,27.0895,27.1,26.450001,27.097,27.097,76242000,979779579.293465,2533476000,16.368941534560076,20.0,0.25169223456643053,57.93561222309281,84.32784120398654,26.18544230769231,26.220712621227513,-15.672158796013468
2015-10-08,26.835501,26.9695,25.994499,26.658001,26.658001,93528000,1013545838.5937116,2439948000,15.668631996597304,20.0,0.247853755760282,53.748703073336365,69.9344360870701,26.255865423076923,26.253104352988437,-30.0655639129299
2015-10-09,26.724001,27.0895,26.5135,26.99,26.99,70748000,1059851387.2048221,2510696000,15.169283912327142,20.0,0.2685061070573447,56.31964364316025,80.81964563290302,26.312115423076925,26.307689215730033,-19.180354367096978
2015-10-12,26.997999,27.541,26.99,27.509501,27.509501,55522000,1109025338.282862,2566218000,15.253186302368865,20.0,0.32306850072817994,60.06076786489377,97.852459720505,26.39955776923077,26.39671231086114,-2.1475402794949927
2015-10-13,27.313,27.66,27.155001,27.445,27.445,58760000,1117751971.8801563,2507458000,15.470160684381037,40.0,0.35698974362438207,59.380740625247235,93.14194577352472,26.49551926923077,26.474363250797353,-6.8580542264752715
2015-10-14,27.566999,27.612499,26.983999,27.241501,27.241501,71642000,1104814691.9565284,2435816000,15.377909685551305,39.99999999999999,0.36326441833081446,57.181018461996544,86.65074960127589,26.548000038461534,26.53118826925681,-13.349250398724097
2015-10-15,27.387501,28.15,27.35,28.122,28.122,98740000,1196642891.9565287,2534556000,15.937658107767648,48.0,0.4342799450286634,63.484131874827696,99.22758620689659,26.635596192307695,26.649026175237786,-0.7724137931034122
2015-10-16,28.2635,28.547001,28.015499,28.538,28.538,86316000,1280035364.6095004,2620872000,16.881252478511765,52.0,0.5181550164297875,66.02851478337915,99.77620592336996,26.728903884615384,26.78895016225721,-0.22379407663004963
2015-10-19,28.538,28.950001,28.368999,28.657499,28.657499,87508000,1279432600.7360547,2708380000,18.151668467098567,56.0,0.5874968869984194,66.7453330535135,92.4349689809986,26.812961538461536,26.927361187275192,-7.565031019001391
2015-10-20,28.6,28.65,27.764,28.044001,28.044001,86924000,1247449474.1536624,2621456000,18.255445797648697,56.0,0.5861894307544873,59.772208854951046,75.17809579282425,26.888923115384618,27.01007524747703,-24.82190420717574
2015-10-21,28.193501,28.262501,27.625999,27.7885,27.7885,66872000,1214722745.8794384,2554584000,18.123357533055916,56.0,0.5581030028624667,57.09684565813531,67.23551480959095,26.953153884615386,27.06773634025651,-32.76448519040905
2015-10-22,28.135,28.4575,27.8335,28.195499,28.195499,155588000,1239656221.5589263,2710172000,18.234176543683407,56.0,0.5622049752791192,60.15619892040052,74.47127425391697,27.02338465384615,27.151274315052323,-25.52872574608303
2015-10-23,30.884001,30.9725,29.768,29.9515,29.9515,213854000,1090961555.7224793,2924026000,20.35641976737421,72.0,0.6990917288787273,70.07210964683922,79.48975904183223,27.13907692307692,27.35869843986326,-20.510240958167767
2015-10-26,30.115,30.4925,29.814501,30.4305,30.4305,85394000,1160737750.9764543,3009420000,22.327074189372812,72.0,0.8365831543043036,72.11102779845527,89.11209539732914,27.27051923076923,27.586239296169687,-10.887904602670865
2015-10-27,30.43,30.7355,30.276501,30.550501,30.550501,75742000,1175424305.2870307,3085162000,24.298043882532745,72.0,0.9443433747453724,72.61438947863857,91.52272167080723,27.390942346153846,27.805814237194156,-8.477278329192776
2015-10-28,30.615,30.8615,30.475,30.855,30.855,78524000,1251307135.8174322,3163686000,26.202446231653,72.0,1.042299668541137,73.90159331217248,97.36488001794125,27.5422885,28.031679849253848,-2.635119982058751
2015-10-29,30.885,31.377001,30.769501,31.327499,31.327499,77920000,1316528548.68986,3241606000,28.264211388157822,88.0,1.1448602215886332,75.80223340772562,98.87316236141025,27.7162885,28.27581460116097,-1.1268376385897476
2015-10-30,31.300501,31.535999,31.264,31.295,31.295,77488000,1256703319.5088718,3164118000,30.265581161194625,92.0,1.209574578288656,75.39552304474628,94.7056458699473,27.893500038461543,28.499457964037934,-5.294354130052694
2015-11-02,31.356501,31.431499,31.0205,31.4175,31.4175,56330000,1309196017.3743172,3220448000,31.646949098169245,92.0,1.2562644636999103,75.9199811875911,97.39677065026363,28.093692346153844,28.71560922596105,-2.603229349736378
2015-11-03,31.4765,31.494499,31.1,31.265499,31.265499,64938000,1298743195.090863,3155510000,32.97200474515912,92.0,1.2664030182107275,73.8174108012428,93.53798221165361,28.326865423076924,28.90448994996393,-6.46201778834639
2015-11-04,31.388,32.296501,31.3675,32.047501,32.047501,96810000,1343657255.2587202,3252320000,34.696555423044714,100.0,1.322296312847854,77.30044610034315,94.66866730813942,28.605480884615382,29.137305583299934,-5.331332691860584
2015-11-05,32.355,32.849998,32.154499,32.782501,32.782501,94476000,1419795783.6821985,3346796000,36.584575608622764,100.0,1.4096509304370812,79.99424072250073,98.70794385680402,28.881942461538458,29.40732005861105,-1.2920561431959678
2015-11-06,32.75,33.112999,32.599998,32.968498,32.968498,81844000,1455532505.7470663,3428640000,38.46461818702107,100.0,1.4768641273467296,80.62097348748264,97.3664844177145,29.14857703846154,29.671111017232455,-2.633515582285498
2015-11-09,32.932499,33.098,32.392502,32.774502,32.774502,80976000,1462247277.3722157,3347664000,39.77546376521666,84.0,1.4972182146423627,77.88048776919078,93.83092764716596,29.385019384615386,29.900991830770792,-6.169072352834038
2015-11-10,32.550499,33.0,32.362999,32.984001,32.984001,69790000,1528531567.9306293,3417454000,40.928936775229964,84.0,1.5128150042370372,78.72167152322663,97.55662421756301,29.608096346153843,30.129362880343326,-2.443375782436985
2015-11-11,33.162498,33.798,33.162498,33.662498,33.662498,107746000,1590330274.3202229,3525200000,42.44767003702886,96.0,1.5619197709652042,81.2134682055945,96.63766749379647,29.86919238461538,30.391076592910487,-3.362332506203534
2015-11-12,33.650002,33.782001,33.210999,33.279999,33.279999,85694000,1525346835.754332,3439506000,43.857922351556404,96.0,1.5520797702996383,75.82280734406746,86.99633161700291,30.107000038461535,30.60507084528749,-13.003668382997084
2015-11-13,33.178501,33.349998,32.022499,32.1175,32.1175,125222000,1418047584.0532002,3314284000,42.8831482241187,92.0,1.4339478863559663,62.2902213808844,52.27884488963361,30.316980769230767,30.717102634525453,-47.72115511036638
2015-11-16,32.046001,32.4995,31.1145,32.390499,32.390499,148718000,1543357048.7203484,3463002000,40.67976817706524,80.0,1.3468308275812255,63.91882271273947,57.643665362624034,30.524692269230766,30.8410579208569,-42.356334637375966
2015-11-17,32.532501,32.662498,32.049999,32.165001,32.165001,86404000,1489399249.6382265,3376598000,38.79886520431184,80.0,1.2452397777995188,61.55407961645359,46.07893217068901,30.703749961538456,30.939127778571205,-53.92106782931099
2015-11-18,32.3255,33.243999,32.318501,33.176998,33.176998,89396000,1565851685.425229,3465994000,37.61329554143821,80.0,1.2321839891921975,67.38564565811222,77.6416921692168,30.924211423076923,31.104895943121488,-22.358307830783204
2015-11-19,33.2495,33.643002,32.950001,33.063499,33.063499,94104000,1502571928.945801,3371890000,36.865040777608606,76.0,1.1988590609193182,66.1733308088187,73.55531953195317,31.14813442307692,31.249977651038414,-26.44468046804683
2015-11-20,33.396999,33.443501,32.878502,33.422501,33.422501,77922000,1574701486.8352838,3449812000,36.06037184511474,60.0,1.187725911293338,68.1266162738439,86.08232023721257,31.351999846153845,31.410905306517048,-13.91767976278743
2015-11-23,33.575001,34.1385,33.506001,33.949501,33.949501,87702000,1609990470.2202373,3537514000,35.910528049946734,92.0,1.2075079061870184,70.79282680026651,93.750033068783,31.5601345,31.59894943196023,-6.249966931217014
2015-11-24,33.707001,33.790001,33.060501,33.557499,33.557499,90868000,1642936628.5862417,3446646000,35.08237100260147,92.0,1.1779750314605621,66.3470252406689,80.78700396825396,31.748596038461542,31.744027177740954,-19.212996031746044
2015-11-25,33.75,33.985001,33.562,33.766998,33.766998,53958000,1641277711.018672,3500604000,34.49083741170561,92.0,1.1581246933533933,67.52095581694066,87.71488095238098,31.968711307692306,31.89387686827866,-12.285119047619029
2015-11-27,34.040001,34.0495,33.605,33.662998,33.662998,39336000,1612206769.8623173,3461268000,34.00199017134147,88.0,1.1210781356528656,66.28481185755837,84.27572751322757,32.19465353846154,32.024922878035795,-15.72427248677244
2015-11-30,33.794998,34.064499,33.23,33.240002,33.240002,113864000,1501072234.4344738,3347404000,32.93273698221297,84.0,1.0455339649683708,61.36405271082213,70.28776455026444,32.38867288461539,32.11492873892203,-29.71223544973556
2015-12-01,33.6875,34.049999,33.393002,33.952999,33.952999,95024000,1568037269.1728358,3442428000,31.939859020879368,80.0,1.0313092732358697,65.95225502081584,93.86570767195761,32.54257669230769,32.25108209159447,-6.134292328042397
2015-12-02,34.049999,34.241001,33.712502,33.800499,33.800499,85470000,1511029399.0538769,3356958000,31.239619917639708,100.0,0.9962465173401966,64.19624321009523,85.91070337095702,32.67219203846154,32.365853714439325,-14.089296629042991
2015-12-03,33.972,34.1395,33.074001,33.3125,33.3125,101294000,1455082260.3949008,3255664000,29.53136899424553,96.0,0.9184937653724674,58.800940373556976,70.30223243171847,32.77842276923077,32.435975661517894,-29.697767568281535
2015-12-04,33.299999,33.738998,33.07,33.632,33.632,90696000,1516766841.5027654,3346360000,27.93886717584311,92.0,0.8725963811769901,61.105715775004136,80.52132399765746,32.88523046153846,32.52457005696101,-19.478676002342546
2015-12-07,33.737,33.772999,33.025002,33.491501,33.491501,74656000,1535231400.3927076,3271704000,26.38499481171373,84.0,0.8154848763950326,59.52863377077786,65.79190708178274,32.96846130769231,32.5961945712602,-34.20809291821726
2015-12-08,33.156502,33.9995,32.989498,33.866501,33.866501,73038000,1589033832.6175945,3344742000,25.280378665736407,84.0,0.7913606504103683,62.32364788576158,80.52015604681417,33.06736519230769,32.69029134375944,-19.47984395318584
2015-12-09,33.900002,33.950001,32.784,33.239498,33.239498,103164000,1566471814.3860488,3241578000,23.882264576669893,80.0,0.7134242152325214,55.43063587822291,31.262710183452118,33.137442038461536,32.73097331829578,-68.73728981654789
2015-12-10,33.279499,33.426498,32.978001,33.116001,33.116001,69110000,1539891329.6336415,3172468000,22.58401577967956,44.0,0.6343811025976507,54.16004235422259,22.786600695538205,33.20861519230769,32.75949388731091,-77.21339930446179
2015-12-11,32.561501,32.894001,31.981001,32.0075,32.0075,109488000,1436758910.163762,3062980000,22.14248163368742,44.0,0.4767958935236365,44.33623287674664,1.1725221238938577,33.207076692307695,32.70379063639899,-98.82747787610614
2015-12-14,32.087502,32.929501,31.7635,32.8955,32.8955,86594000,1518302687.061037,3149574000,22.012161815282205,44.0,0.41873573378162376,51.86799280714421,45.69120254643689,33.21142280769231,32.717991329999066,-54.30879745356311
2015-12-15,33.251499,33.575001,32.8675,32.931999,32.931999,95068000,1440568347.174591,3244642000,20.772151649869137,44.0,0.37138668858452206,52.15455386135779,47.16442092253439,33.210018999999996,32.73384374999914,-52.83557907746561
2015-12-16,33.178001,33.8675,32.966,33.788502,33.788502,79290000,1505962060.053127,3323932000,19.402726435029006,44.0,0.39838255700748704,58.411833615700935,81.73566832061837,33.249019,32.811966583332534,-18.264331679381627
2015-12-17,34.0,34.125,33.532501,33.532501,33.532501,73632000,1432330060.053127,3250300000,18.50787587368149,44.00000000000001,0.39457146181742075,56.05224948540304,71.40263515534426,33.270115153846156,32.86533950308568,-28.59736484465575
2015-12-18,33.432499,33.841999,33.206501,33.207001,33.207001,136826000,1295719365.2153757,3113474000,17.21474523163482,44.0,0.36112320818625676,53.11432705432516,58.264396260586764,33.25259603846154,32.890647762116366,-41.735603739413236
2015-12-21,33.424999,33.494999,32.946499,33.225498,33.225498,65018000,1296845237.5289583,3178492000,16.40712916533499,44.0,0.3322774914303679,53.26423739784613,59.010995353786065,33.25049984615385,32.91545148344108,-40.989004646213935
2015-12-22,33.341499,33.4245,32.963001,33.157501,33.157501,53356000,1288463298.144475,3125136000,15.65719996091372,44.0,0.30046667070789823,52.59844703213196,58.67007575757594,33.290499884615386,32.93338107726026,-41.32992424242406
2015-12-23,33.325001,33.330002,32.831501,33.185001,33.185001,54458000,1311240461.163205,3179594000,15.171860370484668,-32.0,0.2743132736095717,52.855110489552125,60.19483379208128,33.321057653846154,32.95201959005579,-39.80516620791872
2015-12-24,33.1675,33.234001,33.029999,33.1395,33.1395,21824000,1312845151.3133016,3157770000,14.72118789365769,-32.0,0.2470669337335636,52.35002914400543,58.26804996824044,33.358538384615386,32.96590702782944,-41.73195003175956
2015-12-28,33.278,33.775002,33.275002,33.759998,33.759998,75672000,1383975620.5613022,3233442000,14.049786024665167,-32.0,0.27240292461436866,58.214206840152364,84.54363751852648,33.38096146153846,33.02472858132356,-15.456362481473514
2015-12-29,33.898998,34.821999,33.894501,34.698502,34.698502,114700000,1468130851.9472458,3348142000,14.870589713922842,40.0,0.36401516904104625,65.19181110644327,95.96216967865608,33.443846192307696,33.14871179752181,-4.037830321343917
2015-12-30,34.594501,34.774502,34.319,34.453499,34.453499,70380000,1439313960.8688312,3277762000,15.632764568233538,39.99999999999999,0.412098424144105,62.2685578006172,87.95160632715597,33.48349996153846,33.245362701409086,-12.048393672844021
2015-12-31,34.304001,34.387501,33.794498,33.794498,33.794498,74992000,1364321960.8688312,3202770000,15.350688768703975,40.0,0.3925043314283343,55.110326290171564,66.40505685959022,33.477538307692306,33.286039390193594,-33.59494314040978
2016-01-04,32.814499,32.886002,31.3755,31.849501,31.849501,186290000,1294948914.689482,3016480000,16.24448752501272,-12.0,0.21752339461195191,40.36238750847472,13.75311584306281,33.41184607692308,33.17962913906814,-86.2468841569372
2016-01-05,32.342999,32.345501,31.3825,31.689501,31.689501,116452000,1252745810.4891748,2900028000,17.074443513013694,-12.0,0.06518763619897783,39.427659888619914,9.110723664797266,33.331942346153845,33.069249276914945,-90.88927633520274
2016-01-06,31.1,31.9895,31.015499,31.6325,31.6325,106584000,1281197471.8160114,2793444000,18.14732512739555,-20.0,-0.05945370883909362,39.08043187333519,16.20914225666628,33.25384626923077,32.962823404550875,-83.79085774333372
2016-01-07,31.09,31.5,30.2605,30.396999,30.396999,141498000,1170864192.2710338,2651946000,19.70135458319228,-24.0,-0.25498813348329463,32.416568220137194,2.9924154318569545,33.1445,32.77276233754711,-97.00758456814305
2016-01-08,30.983,31.207001,30.299999,30.352501,30.352501,110258000,1073370806.9378152,2541688000,21.14438193500353,-24.0,-0.4088284703585714,32.20358127083544,2.016902776916093,33.00601930769231,32.593483719951024,-97.98309722308392
2016-01-11,30.624001,30.9925,29.928499,30.886999,30.886999,97832000,1151801746.5403156,2639520000,22.748690159282667,-32.0,-0.48206161782086454,37.51434025466708,19.58720752017985,32.89396161538461,32.467077444399095,-80.41279247982015
2016-01-12,31.262501,31.2995,30.612,30.894501,30.894501,94482000,1134967046.8515892,2734002000,23.705439583336872,-32.0,-0.5333459855725664,37.588238128058855,19.74051292530915,32.80096165384615,32.35059030036953,-80.25948707469085
2016-01-13,31.044001,31.044001,28.958,29.0905,29.0905,153104000,1001312970.4134667,2580898000,25.650390304043444,-40.0,-0.7113569405282014,28.77537584886909,2.2595501806872798,32.62628857692307,32.10910212997179,-97.74044981931272
2016-01-14,29.012501,30.112499,28.493999,29.65,29.65,144760000,1063340372.0322493,2725658000,27.68563215609833,-43.99999999999999,-0.7980851024959712,33.94786815370621,18.268030973451328,32.478538538461535,31.926946416640543,-81.73196902654867
2016-01-15,28.612,29.231001,28.264999,28.509001,28.509001,155690000,986301702.7334286,2569968000,29.685534492936295,-48.0,-0.9479593934679151,29.278219495802915,3.721244471557143,32.27248084615385,31.67376527466717,-96.27875552844286
2016-01-19,28.8545,29.200001,28.3225,28.724001,28.724001,96144000,978139168.6098208,2666112000,31.542586662857264,-48.0,-1.037428317808125,31.198684168386407,7.000183010523132,32.09880788461539,31.455264217284416,-92.99981698947687
2016-01-20,28.218,28.922501,27.358999,28.588499,28.588499,159328000,1069394507.8060608,2506784000,33.712803516502944,-56.0,-1.1065117848232937,30.6340725610316,16.580129493575804,31.924673192307694,31.24291123822631,-83.4198705064242
2016-01-21,28.679001,29.4405,28.410999,28.750999,28.750999,99044000,1035770473.4010432,2605828000,34.85598454294675,-56.0,-1.1350642243956024,32.21830282923827,19.805073684264432,31.799423153846153,31.058325146505844,-80.19492631573557
2016-01-22,29.436501,30.004999,29.2055,29.819,29.819,102402000,1090525960.777512,2708230000,35.04818798014205,-56.0,-1.05930250355458,41.650487940634605,44.508769038120654,31.681096230769235,30.966523283801706,-55.491230961879346
2016-01-25,29.8995,30.424999,29.728001,29.8265,29.8265,87922000,1027454043.7849239,2796152000,34.62586851965607,-56.0,-0.9872749159605618,41.71182946843309,49.483605942602644,31.561653961538465,30.88207711463121,-50.51639405739736
2016-01-26,30.172501,30.225,29.518999,30.0625,30.0625,75314000,1068098050.3996451,2871466000,34.394329061909126,-56.0,-0.9007658383189785,43.716905074858765,58.38463267797589,31.418346192307695,30.8213676987326,-41.61536732202412
2016-01-27,30.099501,30.1695,28.938999,29.1675,29.1675,103058000,1003315283.1024225,2768408000,34.60384573364981,-56.0,-0.8941189445733606,38.33167957304406,43.673039441429744,31.250461538461536,30.698858980307964,-56.326960558570256
2016-01-28,30.418501,31.903,29.877501,31.7675,31.7675,280304000,1246116236.1989186,3048712000,32.65989072649302,-56.0,-0.6713144671991742,55.48635881015715,97.01804643088767,31.195096115384615,30.778017574359225,-2.9819535691123407
2016-01-29,28.599001,29.65,28.5,29.35,29.35,293552000,1386510670.9815285,2755160000,31.894897854922526,-56.0,-0.6819512502570184,43.39798535178392,43.81603349118984,31.0460385,30.672238494777062,-56.18396650881015
2016-02-01,28.907499,29.09,28.515499,28.740499,28.740499,127102000,1358966200.037179,2628058000,31.18454733132135,-56.0,-0.7311345503706299,40.97424957152973,30.402722182499517,30.876153807692308,30.52914668034913,-69.59727781750048
2016-02-02,28.5,28.577999,27.504499,27.605,27.605,126240000,1256363361.1736488,2501818000,31.182995597552253,-56.0,-0.8519175741021421,36.84568264313291,5.41375321000149,30.661538384615387,30.31254322254549,-94.58624678999851
2016-02-03,27.674999,27.799999,26.094999,26.553499,26.553499,200974000,1163479189.9126513,2300844000,31.92176528721614,-96.0,-1.0207201075202548,33.481350213118276,7.89428238734803,30.408230653846154,30.034095502356934,-92.10571761265197
2016-02-04,26.25,26.949499,25.961,26.813,26.813,123982000,1253220550.2802389,2424826000,32.671163671484386,-100.0,-1.1206397321923376,35.05735062207731,14.338606529787954,30.141038423076925,29.79549583551568,-85.66139347021205
2016-02-05,26.464001,26.4725,24.959499,25.106501,25.106501,194178000,1096774917.0876634,2230648000,33.81485778661635,-100.0,-1.3222844896169867,30.020267237018288,2.117116422968767,29.77211530769231,29.44816288473674,-97.88288357703122
2016-02-08,24.3235,24.674999,23.7605,24.405001,24.405001,196510000,1177249127.043059,2034138000,35.32804515401869,-100.0,-1.5211596187717191,28.224956415341282,7.915271722443946,29.385634615384614,29.074595337719202,-92.08472827755605
2016-02-09,23.900499,24.919001,23.700001,24.1035,24.1035,141558000,1129404845.5697203,1892580000,36.44232911131506,-100.0,-1.6836896758727562,27.46472448495976,4.9189205069999415,29.012903923076923,28.706366053443706,-95.08107949300006
2016-02-10,24.587999,25.233,24.299999,24.524,24.524,135724000,1058851861.9437652,2028304000,37.09835857024208,-96.0,-1.7582965334206015,30.285058967956786,10.04509448312746,28.731153884615384,28.396561160596022,-89.95490551687254
2016-02-11,24.5585,25.465,24.200001,25.191,25.191,147948000,1142708503.7687783,2176252000,37.42471731203984,-92.0,-1.7435036550501657,34.627097163153195,18.17626699698487,28.48121153846154,28.159112185737058,-81.82373300301512
2016-02-12,25.535,25.8375,25.074499,25.354,25.354,107696000,1113914470.3350084,2283948000,37.273407791139064,-31.999999999999993,-1.699041956554236,35.681365216248366,20.16334513755273,28.239730769230768,27.951326097904683,-79.83665486244728
2016-02-16,25.974001,26.2225,25.583,26.055,26.055,102370000,1162658277.9972446,2386318000,36.672877612364175,-32.0,-1.5889247630710521,40.15150982048233,28.709000208338438,28.07273080769231,27.810857498059892,-71.29099979166158
2016-02-17,26.437,26.874001,25.9695,26.705,26.705,96480000,1223084771.190729,2482798000,35.38053068174587,-32.0,-1.4326913520734443,44.03549399260477,36.63293144373172,27.932442307692305,27.728942127833232,-63.367068556268286
2016-02-18,27.0595,27.059999,26.186501,26.25,26.25,94700000,1142153217.8271265,2388098000,33.97761438988622,-32.0,-1.3302555873080983,41.98165438419143,42.857133253299715,27.754096192307692,27.619390859104843,-57.14286674670029
2016-02-19,26.0355,26.797501,25.7675,26.745001,26.745001,99494000,1231504635.4412837,2487592000,33.005436692699114,-32.0,-1.1953527791607996,44.987747591979286,56.49351697467845,27.59450003846154,27.554621239911892,-43.50648302532156
2016-02-22,27.110001,28.032499,27.054001,27.975,27.975,111332000,1329752339.5755794,2598924000,30.826423530655084,-32.0,-0.9779178636133601,51.686432827541466,87.63839181565886,27.55159619230769,27.585760407325825,-12.361608184341142
2016-02-23,27.7775,27.845501,27.2665,27.646999,27.646999,81016000,1355218045.078679,2517908000,28.803054165899912,-32.0,-0.8225838316190597,49.9400703681515,91.10213091846782,27.474557692307695,27.590296599375762,-8.897869081532185
2016-02-24,27.2875,27.713499,26.657499,27.702,27.702,124634000,1477137714.8400433,2642542000,27.46918796688405,-31.999999999999996,-0.6871216603230259,50.24365959667431,92.37162948488378,27.443519192307694,27.59857092534793,-7.628370515116211
2016-02-25,27.775999,27.9695,27.2645,27.7575,27.7575,90510000,1513213331.8613198,2733052000,25.961468443660237,-32.00000000000001,-0.5687325328366981,50.56942045968074,93.65264565615493,27.406346076923075,27.61034344939623,-6.347354343845076
2016-02-26,28.006001,28.125,27.658501,27.761499,27.761499,97540000,1458744913.6653535,2830592000,24.395138753684762,-32.0,-0.46917722745183355,50.5945201696083,91.78528627916076,27.374538384615388,27.621540156848358,-8.214713720839246
2016-02-29,27.700001,28.240499,27.6255,27.625999,27.625999,82908000,1375971454.020704,2747684000,22.81281485078257,-32.0,-0.39664042434458224,49.67412194196727,86.46624224919822,27.331269153846158,27.621870441526255,-13.533757750801778
2016-03-01,27.814501,28.9625,27.799999,28.952,28.952,100770000,1474921094.2962828,2848454000,21.781346093969738,-32.0,-0.22951161935349162,57.770291821794146,99.77952751276175,27.297923,27.720398556968753,-0.22047248723825136
2016-03-02,29.0875,29.25,28.684999,29.0105,29.0105,91644000,1488870584.0210798,2940098000,21.102518000799275,-32.0,-0.09128806422538815,58.090620762296034,95.25742480345046,27.266538384615384,27.81596162682292,-4.742575196549536
2016-03-03,28.898001,28.9935,28.6555,28.8745,28.8745,54826000,1505091294.0802515,2885272000,20.43458273587556,-32.0,0.007198060894644698,57.00798709289899,91.00706717589102,27.220846076923074,27.894371876687885,-8.992932824108982
2016-03-04,29.053499,29.07,28.553499,28.757,28.757,68330000,1490605229.8325546,2816942000,19.67740954644032,-32.0,0.07490430637734846,56.036295224853376,86.55576765748573,27.205057615384614,27.958270256192485,-13.44423234251427
2016-03-07,28.677,28.681499,27.7775,28.139999,28.139999,98538000,1471093703.229096,2718404000,18.536294451716657,-28.000000000000004,0.07787744678257269,51.109886272406435,68.12631730078967,27.065538346153843,27.971731644622672,-31.873682699210335
2016-03-08,27.893499,28.567499,27.737,28.013,28.013,94600000,1439370600.1308386,2623804000,17.524005136012978,60.0,0.06918836366093828,50.13291207221971,64.47954055994263,27.014115269230768,27.974788559835808,-35.520459440057365
2016-03-09,27.978001,28.0175,27.5065,27.973499,27.973499,87546000,1511839842.6122484,2536258000,16.860391201156197,60.0,0.05844112915070099,49.81396270554729,63.34526920315868,26.98461526923077,27.974693036885007,-36.65473079684132
2016-03-10,28.337,28.35,27.395,27.946501,27.946501,78398000,1523989644.4928768,2457860000,15.787022741728757,60.0,0.047201248789114914,49.58178040206478,49.720405122312414,26.99774992307692,27.972604737856486,-50.279594877687586
2016-03-11,28.3475,28.503,28.136499,28.480499,28.480499,75426000,1590154221.326227,2533286000,14.735510745216414,60.0,0.08045529980167032,54.135319954596305,70.3181985272136,27.071865307692306,28.0102265350523,-29.6818014727864
2016-03-14,28.35,28.8445,28.1525,28.668501,28.668501,69084000,1624097426.7713134,2602370000,14.21172000262625,60.0,0.12058948450037477,55.653855620512616,77.56996043588792,27.14323073076923,28.058987606529907,-22.430039564112075
2016-03-15,28.549999,29.076,28.35,28.851,28.851,77536000,1653573922.6390817,2679906000,14.020789737238664,60.0,0.1652177319480721,57.13742410380891,79.90430622009563,27.28724992307692,28.117655191231396,-20.09569377990437
2016-03-16,28.832001,29.066,28.556999,28.713499,28.713499,70754000,1626328681.953896,2609152000,13.843497347950189,60.0,0.18733131918546775,55.62744513962238,71.07811320754712,27.452961384615385,28.1617917696587,-28.921886792452888
2016-03-17,28.4755,28.57,27.7505,27.972,27.972,118562000,1571858159.68422,2490590000,13.2485438803769,52.00000000000001,0.14337103204455914,48.22593567850224,31.105121293800625,27.601749846153844,28.14773312005435,-68.89487870619938
2016-03-18,28.047001,28.116501,27.304501,27.604,27.604,145938000,1533576034.2211661,2344652000,13.259309078358987,52.0,0.07793922836385292,45.02410607410292,15.394456640687073,27.720211384615386,28.10745659264292,-84.60554335931293
2016-03-21,27.445499,27.761999,26.929001,27.698999,27.698999,103114000,1621092921.1428638,2447766000,13.70443398692363,48.0,0.033365066182515335,46.02043520944767,33.17528357401278,27.816672884615382,28.077200474669368,-66.82471642598722
2016-03-22,27.255501,28.138,27.252501,28.024,28.024,80012000,1680503276.194648,2527778000,13.515979461801834,44.0,0.023988066568275457,49.39905633768156,51.00137447665327,27.919365192307694,28.073259698767934,-48.99862552334673
2016-03-23,28.049999,28.624001,27.905001,28.481501,28.481501,79674000,1728595788.0166235,2607452000,12.631962678172469,32.0,0.052863852436683345,53.7842811355006,72.3102339591216,28.012692153846153,28.103499795155493,-27.689766040878396
2016-03-24,28.355499,29.1775,28.354,29.147499,29.147499,103710000,1824749251.98748,2711162000,12.361931752898046,32.0,0.12801293991265084,59.31221517125424,98.66573211729252,28.106634423076926,28.18083306958842,-1.3342678827074697
2016-03-28,29.219999,29.237499,28.778,28.9935,28.9935,62430000,1820877224.9101636,2648732000,12.185414148426327,32.0,0.17314677266547562,57.59667761145893,89.43040019961036,28.21215365384616,28.241030619989278,-10.569599800389636
2016-03-29,29.0075,29.7925,28.825001,29.693001,29.693001,87852000,1890659570.7854562,2736584000,12.677936644962093,92.0,0.2623355046209319,62.852501270332795,96.52526506906405,28.325538269230773,28.348583981471553,-3.4747349309359468
2016-03-30,29.835501,30.162001,29.75,29.9345,29.9345,77810000,1882538455.035737,2814394000,13.529127125699338,96.0,0.34848801535958174,64.4889993155316,92.96316115063408,28.400903653846154,28.46605924210329,-7.036838849365918
2016-03-31,29.964001,30.0375,29.6105,29.681999,29.681999,53636000,1846864611.3074005,2760758000,14.079606730587626,96.0,0.391872517900012,61.44125559176522,85.15304670584601,28.479172884615384,28.556128853799343,-14.846953294154002
2016-04-01,29.5245,29.9515,29.415001,29.924999,29.924999,58348000,1899448274.9414427,2819106000,14.252219603664132,24.0,0.44078205672342463,63.24168562909941,92.66928549334982,28.564672846153844,28.6575266424068,-7.330714506650181
2016-04-04,29.950001,29.975,29.5275,29.6595,29.6595,49416000,1879184954.271052,2769690000,14.442536737473038,24.0,0.4528989312235545,59.94809187785506,84.45712960098984,28.63782669230769,28.731746891117407,-15.542870399010166
2016-04-05,29.5385,29.6735,29.262501,29.306999,29.306999,46178000,1843006144.7508342,2723512000,14.138017051079784,24.0,0.42911122969261584,55.79346457788249,73.55391277451288,28.697269,28.774358158442045,-26.446087225487126
2016-04-06,29.375999,30.119499,29.375,30.104,30.104,56998000,1897630972.9883466,2780510000,14.461977301970425,23.999999999999993,0.469162412485268,62.1761776001606,98.20596968759664,28.79257673076923,28.8728501467056,-1.7940303124033667
2016-04-07,29.938,29.98,29.454,29.571501,29.571501,63780000,1862346082.4180045,2716730000,14.762797534940304,24.0,0.45271641139705565,56.32473914624123,81.73523043612748,28.81640369230769,28.924602061764446,-18.26476956387252
2016-04-08,29.716,29.893,29.450001,29.73,29.73,51838000,1876036845.0653243,2768568000,15.033802786881,24.0,0.44731600129778215,57.60370497435467,86.63776678008044,28.84407676923077,28.984261168300414,-13.362233219919565
2016-04-11,29.806999,30.200001,29.745501,29.796499,29.796499,54086000,1834088481.272145,2822654000,15.722459193445404,56.0,0.4432920560485165,58.157330478968,86.31036471586091,28.879538269230768,29.044426933611494,-13.68963528413908
2016-04-12,29.92,30.202999,29.615499,30.158501,30.158501,52822000,1878908869.8474646,2875476000,16.066953642554335,60.0,0.4639652834908503,61.132777544081286,98.06361885432462,28.933442153846155,29.12695093852916,-1.9363811456753777
2016-04-13,30.384001,30.8405,30.2645,30.740999,30.740999,84566000,1934258197.7432978,2960042000,17.231784044118974,64.0,0.5213419798232657,65.39678055734814,95.99835109591795,29.033480615384615,29.246510054193667,-4.001648904082046
2016-04-14,30.7535,31.219,30.7535,31.0375,31.0375,70242000,1949725018.3662841,3030284000,18.733265076490234,68.0,0.584006514216771,67.35970882175035,92.56452273658338,29.149807538461538,29.37917597610525,-7.435477263416615
2016-04-15,31.096001,31.338499,30.9055,31.2945,31.2945,57754000,1995741724.5341969,3088038000,20.254099527186334,72.0,0.646948739006934,69.00114936918155,98.24949134632296,29.277538346153847,29.52105182972708,-1.7505086536770462
2016-04-18,31.2675,31.882,31.247999,31.7675,31.7675,87218000,2051456742.6777005,3175256000,22.194360686783593,76.0,0.7266220064179514,71.8108839187426,95.62893515133989,29.424499846153847,29.687455397895445,-4.371064848660111
2016-04-19,31.857,31.900499,31.040001,31.395,31.395,81118000,2037269308.1920886,3094138000,23.48695520075642,80.0,0.7510483896440405,66.68468314361081,80.83777925532921,29.53659603846154,29.813940183236525,-19.162220744670787
2016-04-20,31.5,31.827499,31.15,31.6495,31.6495,52188000,2062034649.8206372,3146326000,24.687221535159757,80.0,0.7819289076742386,68.34719130288838,90.48524676667685,29.651249846153846,29.949907577070856,-9.514753233323157
2016-04-21,31.549999,31.891001,31.424999,31.549999,31.549999,51926000,2037965826.3992786,3094400000,25.873534249600674,80.0,0.7892747732799599,66.94070831699216,86.71340918378255,29.755057500000003,30.0684328676582,-13.286590816217462
2016-04-22,31.223499,31.4125,30.577999,31.025,31.025,101678000,2045215599.2311862,2992722000,25.010238169814972,80.0,0.7441552346715667,59.93271792039423,66.81199151781004,29.843961384615383,30.139289692276108,-33.18800848218996
2016-04-25,30.8305,31.349001,30.8125,31.309999,31.309999,53658000,2091072050.618975,3046380000,24.208606095728246,80.0,0.7230597302385284,62.24352745526915,76.61848212967027,29.97234596153846,30.226008900255657,-23.381517870329734
2016-04-26,31.3085,31.3375,30.743999,30.844,30.844,50428000,2057637620.7325892,2995952000,23.31847837599162,80.0,0.661118207047533,56.50515575980717,56.88635534491361,30.096961346153844,30.27178601875524,-43.11364465508639
2016-04-27,30.59,30.797501,30.063999,30.328501,30.328501,81376000,2034950253.4888735,2914576000,22.097886126400063,76.0,0.5639319856637357,50.91333142449955,35.84985582522406,30.198096038461536,30.275987128477073,-64.15014417477595
2016-04-28,30.777,31.34,29.959999,30.1,30.1,157452000,1909445241.1388829,2757124000,20.99586098368673,72.0,0.4631343593868138,48.616676881569525,21.203544857768122,30.27794219230769,30.26295104488618,-78.79645514223188
2016-04-29,33.299999,33.499001,32.700001,32.9795,32.9795,206214000,1847503097.9248662,2963338000,22.25445382063359,100.0,0.6085876794332528,68.1280115969309,86.62287286062944,30.450942153846157,30.46417689341313,-13.377127139370552
2016-05-02,33.195999,34.275002,33.101501,34.192501,34.192501,131570000,1960573485.9603257,3094908000,23.936109951086333,100.0,0.8123749737211092,72.81158601104063,98.08804304423425,30.64498069230769,30.7403490494566,-1.9119569557657454
2016-05-03,33.868,34.014999,33.5215,33.566002,33.566002,98468000,1879864480.1467352,2996440000,25.49764778650674,96.0,0.9128024211122074,67.30995484093779,83.5689569624864,30.820846153846155,30.94965667542278,-16.431043037513604
2016-05-04,33.129501,33.700001,33.106998,33.544998,33.544998,92710000,1924108188.643994,2903730000,26.24388088494482,76.0,0.9794070545825875,67.1268274055497,83.08219020936947,30.968999884615382,31.141904180947016,-16.917809790630525
2016-05-05,33.665501,33.824501,32.799999,32.954498,32.954498,97682000,1855887861.3747456,2806048000,26.440178220025956,76.0,0.9733234249131364,62.0182910904823,69.39737932974788,31.085153653846156,31.276170389765756,-30.60262067025213
2016-05-06,32.802502,33.8475,32.800499,33.697498,33.697498,87306000,1918177505.8755636,2893354000,26.64329674576331,76.0,1.0167356988198293,65.56891495332351,86.61637083450469,31.239595923076926,31.455527990523848,-13.383629165495307
2016-05-09,33.697498,34.348999,33.570499,33.987499,33.987499,79644000,1923855401.8293211,2972998000,27.276433897471314,96.0,1.0622954154268385,66.870695710158,91.76349965823651,31.395845923076926,31.643081398633193,-8.23650034176349
2016-05-10,34.700001,35.227501,34.674999,35.1535,35.1535,122112000,2013256533.4089372,3095110000,28.520252642649336,100.0,1.1788987442166352,71.5312691482637,98.59514054289879,31.607153615384618,31.903112406141847,-1.404859457101214
2016-05-11,35.289501,35.950001,35.0825,35.661499,35.661499,146764000,2062402876.419492,3241874000,30.117647433555867,100.0,1.297344021824408,73.2939942759121,95.18360761816105,31.851557461538462,32.181511413094306,-4.8163923818389565
2016-05-12,35.868999,36.122501,35.5755,35.8965,35.8965,100964000,2079937540.9557557,3342838000,31.699131672682505,96.0,1.3941049997584258,74.09313432957163,96.33264216384843,32.074345923076926,32.4566957528651,-3.6673578361515595
2016-05-13,35.731998,35.962502,35.3255,35.495998,35.495998,95268000,2035667821.8528333,3247570000,32.71246873937164,96.0,1.4220787687978103,70.23575896343569,89.83362601748446,32.302211192307695,32.68182925265287,-10.166373982515537
2016-05-16,35.5065,35.662498,35.014,35.533001,35.533001,108658000,2100930514.4625247,3356228000,33.099320506763455,88.0,1.4307413198252732,70.38914359021696,90.43408018366564,32.52540353846154,32.89302715986376,-9.565919816334356
2016-05-17,35.494999,35.723499,34.695499,34.7635,34.7635,102428000,2012053499.7310076,3253800000,32.912799401473805,88.0,1.3598387792362416,63.10606407758086,77.94725259318375,32.716442038461544,33.03158070357756,-22.052747406816245
2016-05-18,34.478001,35.126999,34.438,34.872501,34.872501,85664000,2034433469.791922,3339464000,32.31135251164004,40.0,1.2974868539401498,63.67934698760287,63.47699050401752,32.897749730769235,33.16794516997922,-36.52300949598248
2016-05-19,34.594002,34.970001,34.478001,34.925999,34.925999,60512000,2084121693.2715955,3399976000,31.752866113937255,40.0,1.2381171021675428,63.975221174093214,63.98792235489994,33.05871126923077,33.29817137961039,-36.01207764510006
2016-05-20,35.052502,35.362,35.0,35.139999,35.139999,58324000,2070909857.2273974,3458300000,31.638959126096672,40.0,1.1945639678480617,65.19656094471027,70.428851510097,33.21649969230769,33.4346030551948,-29.57114848990299
2016-05-23,35.212502,35.299999,34.820999,34.837502,34.837502,51902000,2022584219.256625,3406398000,31.202346703350404,40.0,1.122697062408605,61.99694783588477,61.3243573668278,33.352768999999995,33.53852149555074,-38.6756426331722
2016-05-24,34.900501,35.375,34.900002,35.209999,35.209999,60676000,2041105933.6554232,3467074000,30.88098859910937,40.0,1.0833116742448254,64.31912156914092,72.5356974954418,33.48517280769231,33.66233464402846,-27.4643025045582
2016-05-25,35.400002,35.542999,35.276001,35.4175,35.4175,65354000,2045022307.5608435,3532428000,30.77484371932973,40.0,1.0566615305353722,65.58082920635695,78.77782734628084,33.63988434615385,33.792346892618944,-21.222172653719152
2016-05-26,35.4165,35.75,35.364498,35.745499,35.745499,48934000,2092813631.6006675,3581362000,30.910609473498283,40.0,1.049905223862325,67.53505556600041,85.2272059347917,33.79742276923077,33.93702482649902,-14.7727940652083
2016-05-27,35.75,35.830002,35.555,35.612,35.612,44984000,2066477408.7077436,3536378000,31.127911794586968,40.00000000000001,1.021997596424896,65.89515275984348,69.694229923283,33.953653576923074,34.061097061573165,-30.305770076717003
2016-05-31,35.616501,36.211498,35.566002,36.1395,36.1395,72366000,2122700141.3040726,3608744000,31.748521054060184,88.0,1.0305657219776236,69.0891126283239,95.94033937450165,34.150365115384616,34.215052834789965,-4.059660625498355
2016-06-01,36.044998,36.321499,35.910999,35.972,35.972,65262000,2076834230.2784953,3543482000,32.440130696906074,92.0,1.0121724787841444,66.9451869025921,81.4441632302432,34.32967284615385,34.34519706924997,-18.55583676975679
2016-06-02,36.0485,36.414001,35.775002,36.411999,36.411999,60532000,2136986933.7099566,3604014000,32.73393584668058,96.0,1.0213267243871584,69.61274085447776,99.89868426179959,34.54382665384615,34.498293508564785,-0.10131573820040568
2016-06-03,36.337002,36.349998,35.921501,36.277,36.277,67346000,2181387040.0024166,3536668000,33.00675491432833,96.0,1.0060906521457937,67.80472590887305,93.06675452087332,34.77261507692308,34.63004954496739,-6.933245479126689
2016-06-06,36.325001,36.575001,36.221001,36.336498,36.336498,54096000,2162590055.32445,3590764000,33.54137170155697,100.0,0.9874344171743985,68.1967754389627,88.83935945748263,35.01248038461539,34.75645313422907,-11.160640542517374
2016-06-07,36.494499,36.5,36.0275,36.187,36.187,54650000,2144836034.1604278,3536114000,33.492303159560244,84.0,0.9496391286107766,66.02131747394333,81.84366783169483,35.13584576923077,34.86241956873062,-18.156332168305166
2016-06-08,36.32,36.471001,36.080002,36.332001,36.332001,44468000,2157687319.0281634,3580582000,33.44673951342042,84.0,0.9207723682989837,67.11698498644088,88.41201716738188,35.21813423076923,34.971277452528355,-11.587982832618119
2016-06-09,36.154999,36.445499,36.115002,36.3825,36.3825,43406000,2184545304.407759,3623988000,33.40443041343344,84.0,0.8916912385014371,67.50991889527018,89.02504102047774,35.326461076923074,35.07581245604477,-10.974958979522262
2016-06-10,36.1175,36.249001,35.710499,35.8955,35.8955,68514000,2163106927.205817,3555474000,32.18570819186091,84.0,0.8198961511842526,60.05675598721998,61.2599643557988,35.416865,35.13653005189331,-38.7400356442012
2016-06-13,35.7005,36.099499,35.557999,35.762001,35.762001,67044000,2146578569.266758,3488430000,30.654839407391506,80.0,0.7436534001387756,58.16118518640468,51.46265758964617,35.52484588461539,35.18286123323455,-48.53734241035383
2016-06-14,35.616501,36.040501,35.613499,35.965,35.965,50138000,2178986117.709155,3538568000,29.233318393241344,76.0,0.6916380208280586,60.21741525872778,53.0407236335645,35.6120575,35.24079743818014,-46.9592763664355
2016-06-15,36.099998,36.127998,35.6675,35.713001,35.713001,54188000,2135506560.2561371,3484380000,28.11079025678624,48.0,0.6229008316720481,56.50490161704975,28.78993278000964,35.67842296153846,35.27577547979643,-71.21006721999036
2016-06-16,35.602501,35.900002,35.264999,35.8755,35.8755,61960000,2192685027.192514,3546340000,26.216016411752275,48.0,0.574911206758685,58.290632899282706,46.60305862128459,35.70619219230769,35.32019951833003,-53.39694137871541
2016-06-17,35.9095,35.91,34.959,35.3195,35.3195,117956000,2164157287.9706416,3428384000,25.147049560300985,48.0,0.4864075267637844,50.63110538782885,22.308154512280336,35.693038384615384,35.320147702157435,-77.69184548771966
2016-06-20,35.674999,36.065498,35.540501,35.7005,35.7005,73544000,2135440083.0037558,3501928000,23.749088207442615,48.0,0.4419170934143466,54.99522524408759,45.88487259599445,35.685499923076925,35.34832194644207,-54.11512740400555
2016-06-21,35.785999,35.919998,35.636002,35.791,35.791,42750000,2139353870.5218892,3544678000,22.450981236931273,48.00000000000001,0.4092431972754511,55.990399156308506,51.48511665524929,35.69684615384615,35.381112913372284,-48.51488334475071
2016-06-22,35.828999,35.849998,35.378502,35.529999,35.529999,45210000,2123196839.6669083,3499468000,21.84738555970529,48.0,0.3581596581663433,52.392199196144404,35.3340746695079,35.696730692307696,35.39214151238174,-64.6659253304921
2016-06-23,35.775002,36.105999,35.625,36.104,36.104,56500000,2179227219.1479473,3555968000,20.57684790288821,48.0,0.35984460435531673,58.681111291706166,70.8539165507941,35.74828838461538,35.444871770723836,-29.146083449205907
2016-06-24,34.650002,35.626499,34.610001,34.948002,34.948002,152650000,2128094098.9647312,3403318000,21.256311103787137,44.0,0.264847561006448,45.61294541059777,17.883660255905163,35.75119226923077,35.40806660252207,-82.11633974409484
2016-06-27,34.600498,34.841,34.105999,34.568001,34.568001,111360000,2156729943.1064405,3291958000,22.519936850310852,-60.0,0.157088002131907,42.27974797698137,19.53495176748284,35.737423115384615,35.345839520853765,-80.46504823251716
2016-06-28,35.0,35.400002,34.908501,35.397499,35.397499,80740000,2236647595.969813,3372698000,22.388743494244032,-60.0,0.137041601279968,50.7416512694426,55.20410344090642,35.74732696153846,35.349666148938674,-44.79589655909358
2016-06-29,35.787498,35.974998,35.676998,35.779999,35.779999,61402000,2217691685.916121,3434100000,21.171294561196813,-60.0,0.15028682452953745,54.08437955137358,78.1147194449654,35.78357684615385,35.3815426564247,-21.885280555034605
2016-06-30,35.860001,35.968498,35.626999,35.780998,35.780998,57102000,2212089988.3943124,3491202000,20.12033138504814,-60.0,0.15903115813498658,54.093141839500156,82.83876500433476,35.805538346153845,35.41113194113398,-17.161234995665236
2016-07-01,35.866001,36.400002,35.827,36.284,36.284,58408000,2246849048.8932285,3549610000,18.971247798991005,-60.0,0.20419532653657768,58.398012060902765,94.94324985625558,35.838865269230766,35.475788834383316,-5.05675014374443
2016-07-05,36.139999,36.478001,35.980499,36.404999,36.404999,48628000,2281205985.637201,3598238000,18.033264822993843,-60.0,0.2469056883721663,59.38467580334532,96.92234660847662,35.86423065384615,35.54461921702159,-3.0776533915233797
2016-07-06,36.2855,36.8885,36.129002,36.880501,36.880501,78764000,2358310907.5724797,3677002000,17.81061824998913,24.0,0.3154862660111917,63.089443093449006,99.71252481131192,35.91301915384615,35.64357342316814,-0.28747518868809324
2016-07-07,36.966499,36.977501,36.581501,36.828499,36.828499,58916000,2372890534.6835914,3618086000,17.737651606830877,28.0,0.36147389503309313,62.41888043310233,94.81100831550889,35.93951911538461,35.73134568811865,-5.188991684491109
2016-07-08,37.007,37.305,36.900002,37.290501,37.290501,68584000,2436563896.0335236,3686670000,18.14675849099466,32.0,0.43023958848292665,65.88784831528315,99.54676475562214,35.99023069230769,35.846838674183935,-0.4532352443778759
2016-07-11,37.5,37.794998,37.349998,37.688999,37.688999,63906000,2470025077.6335244,3750576000,19.15245164626697,36.0,0.5110018430264347,68.58173736324386,97.12661890122504,36.03934607692308,35.98329499461475,-2.873381098774952
2016-07-12,37.842999,37.867001,37.016499,37.4105,37.4105,112474000,2461759811.943378,3638102000,19.355181403460886,40.0,0.5462372864092231,64.7341689992641,87.86225053855323,36.08294223076923,36.08901388390255,-12.137749461446772
2016-07-13,37.338001,37.843498,37.0625,37.1315,37.1315,82846000,2393552451.2228646,3555256000,19.54343046371238,39.99999999999999,0.5453620664224204,61.03967214429336,80.44401465354184,36.11351923076923,36.166235077687546,-19.55598534645816
2016-07-14,37.443001,37.452,36.951,37.060001,37.060001,47810000,2366546194.9753594,3507446000,19.46430698504215,40.0,0.5327577765020166,60.09315780473144,78.54295211754737,36.14709619230769,36.2324399608218,-21.45704788245263
2016-07-15,37.327499,37.327499,36.702499,36.771999,36.771999,62428000,2318002182.1753592,3445018000,18.837815426079857,40.0,0.49383678837062206,56.30570176650369,70.88536512344318,36.16401919230769,36.27240729705722,-29.11463487655682
2016-07-18,36.774502,37.080002,36.436001,36.803501,36.803501,59098000,2326352881.7891793,3504116000,17.701037908772513,40.0,0.460228347089668,56.6277065098548,64.05272942369429,36.18021153846154,36.31174757134928,-35.94727057630571
2016-07-19,36.625,37.1665,36.615501,36.997501,36.997501,44336000,2343491955.246663,3548452000,16.811526258503008,40.0,0.44412796321324777,58.648744542654406,61.18307037225857,36.22259619230769,36.362544121619706,-38.81692962774143
2016-07-20,37.200001,37.3125,37.035,37.285999,37.285999,44280000,2379314555.030446,3592732000,16.267897255785055,40.0,0.4494665004814422,61.52031432435073,74.06243387282672,36.2812115,36.43094818668491,-25.937566127173284
2016-07-21,37.375,37.467999,37.1395,37.2215,37.2215,46342000,2356108357.574746,3546390000,16.059265185714292,40.0,0.4433817704154137,60.50863496730142,68.3578096285246,36.329538423076926,36.489507580263805,-31.642190371475397
2016-07-22,37.3895,37.563999,37.176498,37.243,37.243,45554000,2326190095.8463893,3591944000,16.04791476214482,40.0,0.4352768477663602,60.74039600106539,66.92285510431478,36.38838453846154,36.545321833577596,-33.07714489568523
2016-07-25,37.327499,37.424999,36.767502,36.980499,36.980499,53586000,2307322603.2829256,3538358000,15.05145874218098,40.0,0.40302616651406,56.38917445816951,48.99295108915488,36.4308845,36.57755717923852,-51.00704891084512
2016-07-26,37.135502,37.156502,36.637501,36.779499,36.779499,50594000,2284413508.7532425,3487764000,14.112178051715066,40.0,0.3571314599316153,53.2439364718058,24.00405310971368,36.48703830769231,36.59251583262826,-75.99594689028632
2016-07-27,36.898499,37.047001,36.693001,36.8335,36.8335,58262000,2272398699.3634114,3546026000,13.239988839139576,40.00000000000001,0.3214119666270676,53.98649976146709,27.77770789657597,36.530615230769236,36.61036651169283,-72.22229210342402
2016-07-28,37.299,37.667999,36.985001,37.630501,37.630501,152352000,2408021820.813255,3698378000,13.456283461968223,40.0,0.35334222154084927,63.26055833388367,83.47309573724677,36.60136526923077,36.68593202934522,-16.52690426275323
2016-07-29,38.25,38.299999,37.75,37.940498,37.940498,135542000,2366372645.7674813,3833920000,14.63485684820465,92.0,0.399061216455749,66.12078960895784,80.71344497150741,36.69407676923077,36.77886284198631,-19.286555028492582
2016-08-01,37.9935,38.525002,37.853001,38.387001,38.387001,71564000,2408544119.375407,3905484000,16.02433391732895,96.0,0.4659517085804552,69.77119540984236,93.3939236984567,36.781884500000004,36.89798418702436,-6.606076301543297
2016-08-02,38.190498,38.2505,37.851002,38.028999,38.028999,72066000,2400696372.2928176,3833418000,17.30916087580189,96.0,0.48449023422141124,63.83244465735425,76.25644985330304,36.900384384615386,36.98176306205959,-23.74355014669696
2016-08-03,37.853001,37.9445,37.612499,37.731998,37.731998,71630000,2380630755.351904,3761788000,17.85541272063274,92.0,0.4698010764276077,59.321300166504095,62.03907992384867,37.02207657692308,37.03733602042555,-37.96092007615133
2016-08-04,37.685001,38.25,37.517502,38.038502,38.038502,63564000,2407488419.30184,3825352000,18.819670193180283,84.0,0.47738908013413806,62.28365943260315,76.71135628944177,37.12365361538462,37.11149646335699,-23.28864371055824
2016-08-05,38.240501,38.4235,38.154499,38.299,38.299,54088000,2411510018.061696,3879440000,19.95806655663264,84.0,0.4986742331220597,64.64049747710966,88.1643424119704,37.220538269230765,37.199459688293516,-11.83565758802961
2016-08-08,38.3405,38.349998,38.050999,38.327999,38.327999,39726000,2445390297.6813602,3919166000,20.71812706269959,80.0,0.5119810483334248,64.90342030706961,89.56276049655061,37.31849984615384,37.28305519286437,-10.437239503449387
2016-08-09,38.369499,38.630001,38.345001,38.415501,38.415501,37522000,2426431813.470833,3956688000,21.83280213667722,100.0,0.5235522904695884,65.7314343825415,89.23462986198238,37.40048065384615,37.366940067467006,-10.76537013801762
2016-08-10,38.490002,38.605,38.309502,38.428001,38.428001,32086000,2420079719.7172375,3988774000,22.759414676377506,96.0,0.5276488215965571,65.85536315259448,89.86198243412807,37.478288423076926,37.44553717358056,-10.13801756587193
2016-08-11,38.497002,38.6875,38.456001,38.562,38.562,40394000,2416677012.1720634,4029168000,23.746117823247726,72.0,0.5355346414641602,67.22375850821109,93.87804579416856,37.54296146153847,37.5282381236857,-6.121954205831437
2016-08-12,38.423,38.657501,38.421001,38.627998,38.627998,31266000,2440142244.324282,4060434000,24.542962547360816,72.0,0.5408748292069987,67.90598264041392,97.09746199876186,37.61217296153846,37.60970181822751,-2.9025380012381445
2016-08-15,38.595001,38.602001,38.385502,38.4245,38.4245,42370000,2413036474.2745357,4018064000,25.15578882083098,72.0,0.5226614625757975,63.515978086604626,86.81373116757649,37.65578830769231,37.67005723909955,-13.186268832423503
2016-08-16,38.431,38.436501,38.191002,38.202,38.202,32092000,2383819824.609975,3985972000,25.038215959657215,72.0,0.48468618715163814,59.02301475214361,71.48309631899924,37.67551911538462,37.709460406573655,-28.51690368100075
2016-08-17,38.220501,38.261002,37.959999,38.231499,38.231499,37822000,2414227529.961749,4023794000,24.183129869912495,72.0,0.45176318575491337,59.43273513867947,61.02548893245965,37.707096,37.748129932012645,-38.97451106754035
2016-08-18,38.200001,38.258499,38.029999,38.223,38.223,29176000,2434338157.322799,3994618000,23.389121358006687,72.0,0.42014253012209934,59.24892339607479,60.2990774343203,37.74907676923077,37.7833054926043,-39.7009225656797
2016-08-19,38.095001,38.1245,37.844501,37.865501,37.865501,46864000,2394503782.4286036,3947754000,22.06231216144543,72.0,0.3620621243684994,51.96816525080508,29.74355511718837,37.780057538461534,37.789394048707685,-70.25644488281162
2016-08-22,37.875,37.9925,37.605,37.973999,37.973999,33586000,2424882687.7911844,3981340000,20.832430554004482,72.0,0.321086579981845,53.82278739223403,39.01690430240043,37.82628830769231,37.80306848954415,-60.98309569759957
2016-08-23,38.165501,38.235001,38.049999,38.122501,38.122501,30482000,2418292385.8701243,4011822000,19.682132583147087,68.0,0.2971704403058979,56.309407556501576,51.70940463146087,37.87701907692308,37.82673015698533,-48.29059536853913
2016-08-24,38.150002,38.170502,37.768002,37.862499,37.862499,34882000,2399789239.8030434,3976940000,18.706079695181973,48.0,0.25430526602638537,51.11909010235637,23.787436489607583,37.91028823076923,37.82937970091234,-76.21256351039241
2016-08-25,37.799999,38.028,37.737,37.960999,37.960999,32460000,2417301800.215415,4009400000,17.880315038128387,48.0,0.225680924171769,52.89068325835088,32.88674364896103,37.93624976923077,37.839129278622536,-67.11325635103897
2016-08-26,38.002499,38.5,37.990002,38.450001,38.450001,55536000,2461948563.5360556,4064936000,17.351172622905516,48.00000000000001,0.2396912896797332,60.53731877847302,78.06013856812942,37.983499807692304,37.884379035761604,-21.939861431870575
2016-08-29,38.436001,38.749001,38.43,38.564499,38.564499,43972000,2455056008.6036253,4108908000,17.40616669145828,96.0,0.2570702906938891,62.08899405857613,83.87221689491517,38.03432669230769,37.93475829237186,-16.127783105084827
2016-08-30,38.552502,38.591999,38.278,38.379002,38.379002,34184000,2442863494.9968944,4074724000,17.008560335679228,96.0,0.25295925968567445,58.10300141966362,67.65745834138265,38.08811526923077,37.96766523367765,-32.34254165861734
2016-08-31,38.330002,38.481998,38.200001,38.458,38.458,32676000,2469978026.9812775,4107400000,16.411294489285783,92.0,0.2531574745973515,59.301303351838655,74.56287188560144,38.152673,38.0039863274793,-25.437128114398558
2016-09-01,38.544998,38.602001,38.337502,38.530998,38.530998,35846000,2486578785.691139,4143246000,16.151399209991155,88.0,0.25625098799427803,60.427606290592934,80.94381036380192,38.21796138461538,38.043024229147505,-19.056189636198088
2016-09-02,38.705502,38.799999,38.584999,38.622002,38.622002,43636000,2457962905.7655573,4186882000,16.372928477803303,84.0,0.2630140199947846,61.84521990166613,85.10484109191745,38.256096038461536,38.08591147143288,-14.895158908082545
2016-09-06,38.702,39.473999,38.511002,39.443501,39.443501,74396000,2527646680.8925824,4261278000,17.813177826917883,88.0,0.3308480647815699,71.70061082225165,98.36821742547741,38.31390384615385,38.186473658734144,-1.6317825745225882
2016-09-07,39.476501,39.539501,39.216499,39.223999,39.223999,48492000,2481406617.4130993,4212786000,19.24987783380589,92.0,0.3627139167964941,66.74008428426515,83.69078124022673,38.346096076923075,38.2633273877168,-16.309218759773266
2016-09-08,39.1945,39.325001,39.071999,39.202999,39.202999,40610000,2482850909.4740314,4172176000,20.096489199840164,92.0,0.3818713345654885,66.26772497431364,82.60522997920383,38.39124992307692,38.332932692330374,-17.394770020796173
2016-09-09,38.967999,39.049999,38.005501,38.007,38.007,85146000,2397949302.1947446,4087030000,19.082718109871145,92.0,0.2971215697455847,46.208833162552644,20.7805527110092,38.401826923076925,38.30878952993553,-79.21944728899079
2016-09-12,37.8675,38.632999,37.799999,38.574501,38.574501,62494000,2451665933.618514,4149524000,18.513259938838665,44.0,0.27260691560184114,53.41452810316276,46.46327519374449,38.422442269230764,38.32847186105141,-53.53672480625551
2016-09-13,38.438499,38.494499,37.952499,38.050499,38.050499,62344000,2411866996.349141,4087180000,17.984477351451364,44.0,0.20849291687836313,47.135862392032344,17.392445274648964,38.41288453846154,38.30788127875131,-82.60755472535104
2016-09-14,38.110001,38.375,37.942501,38.054501,38.054501,50460000,2387541253.306961,4137640000,17.513226384076663,44.0,0.15620441170322863,47.18692209296238,17.614470116798834,38.402365384615386,38.28911236921418,-82.38552988320117
2016-09-15,38.099998,38.543499,37.879002,38.484501,38.484501,60680000,2437446189.9432445,4198320000,16.650228525273,44.0,0.14775952119048696,52.49604674790002,39.35045777469651,38.40501923076923,38.30358560112425,-60.64954222530349
2016-09-16,38.664001,39.022999,38.583,38.925999,38.925999,109984000,2498937134.2772083,4308304000,16.133246687913193,44.0,0.1746784984675145,57.24810525886081,64.73117018548967,38.424173,38.34969029733726,-35.268829814510326
2016-09-19,38.998501,39.097,38.549999,38.755001,38.755001,45944000,2487430409.1194844,4262360000,15.801137941584953,44.0,0.18013736102395939,54.95509010687119,54.90088542582874,38.431596115384615,38.37971331234932,-45.09911457417126
2016-09-20,38.799999,39.068501,38.799999,39.011002,39.011002,38744000,2509580556.887471,4301104000,15.492751248565876,44.0,0.20278313241691137,57.68752339340941,69.61779865731668,38.44632703846154,38.42647543736047,-30.382201342683313
2016-09-21,39.162498,39.5345,38.9505,39.487,39.487,54372000,2555107796.6134987,4355476000,16.11110077218661,44.0,0.25618597744082194,62.27036265553001,96.98183733045438,38.48719242307692,38.505032812370814,-3.018162669545618
2016-09-22,39.713501,40.294498,39.713501,40.235001,40.235001,81578000,2619977805.8114805,4437054000,17.77342860698357,88.0,0.3547759104089465,68.11473576051377,97.61487176382911,38.56538476923077,38.63317860404705,-2.3851282361708868
2016-09-23,40.156502,40.387501,40.105999,40.287498,40.287498,47070000,2633604766.614601,4484124000,19.42866462547352,92.0,0.4321634999377153,68.4837195190427,96.13515274577561,38.64446165384615,38.75572078152505,-3.8648472542243804
2016-09-26,40.09,40.296501,39.857498,39.958,39.958,53028000,2604856418.717206,4431096000,20.270261900087814,92.0,0.46158512136410934,63.515508967803186,83.40094036642283,38.71119242307692,38.84477850141208,-16.599059633577166
2016-09-27,40.092499,40.832001,40.0555,40.8055,40.8055,76392000,2676034093.450401,4507488000,21.73055733392395,100.0,0.5469828575658156,69.62026416752143,99.12595704092557,38.82426930769231,38.99001713093711,-0.8740429590744374
2016-09-28,40.900002,41.507,40.851501,41.436001,41.436001,88442000,2745317273.8091807,4595930000,23.75529199333894,92.0,0.6579528690336431,73.211464914168,98.08473210554837,38.95742323076923,39.17120112123806,-1.9152678944516204
2016-09-29,41.412998,41.875,41.231499,41.452499,41.452499,98444000,2714491269.740812,4694374000,25.937979013352315,96.0,0.7387132270892494,73.3004035757067,89.63187984493754,39.08550007692308,39.3401861492945,-10.368120155062462
2016-09-30,41.630501,41.997501,41.619999,41.865501,41.865501,88612000,2741133881.4991612,4782986000,28.061095942203075,100.0,0.8265146560263901,75.49382783914416,96.7949488393709,39.23946169230769,39.52724650860602,-3.2050511606291003
2016-10-03,41.799999,41.993,41.5625,41.837002,41.837002,55388000,2756380570.3539805,4727598000,29.86908722247076,56.0,0.8836125544127356,75.03574052049318,96.10297343765285,39.38853873076923,39.698339507968534,-3.8970265623471443
2016-10-04,42.045502,42.1185,41.513,41.7015,41.7015,59006000,2734113235.9196296,4668592000,31.659191074957743,64.0,0.9074684399927762,72.77465117903866,90.16392978602667,39.51359638461538,39.84672176663753,-9.836070213973322
2016-10-05,41.900002,42.283501,41.806,42.217999,42.217999,69382000,2784460051.641481,4737974000,33.46681581695024,68.0,0.9570196273846179,75.77162101096684,98.24556140588643,39.65411561538461,40.02237193207179,-1.7544385941135734
2016-10-06,42.185001,42.3605,42.029999,42.083,42.083,53680000,2747996905.327249,4684294000,35.21354071373126,72.0,0.9741664251715676,73.49438100492516,92.71749305406288,39.79657707692308,40.17501104821462,-7.282506945937116
2016-10-07,42.289501,42.297501,41.872501,41.9715,41.9715,48524000,2722079152.2731314,4635770000,36.30977086098234,72.0,0.9676043274243469,71.58088186989791,89.07457124713622,39.931711692307694,40.308084303902426,-10.925428752863787
2016-10-10,42.162498,42.259998,42.0135,42.085499,42.085499,36542000,2706884079.696477,4672312000,37.32769885485833,72.0,0.9605301901303775,72.37287370531449,91.93545454545445,40.06842326923077,40.43974465176151,-8.064545454545538
2016-10-11,42.050999,42.064499,41.4175,41.549999,41.549999,71764000,2664513195.40763,4600548000,36.446706644943774,72.0,0.9013236131606845,63.43052628259323,69.38038132995132,40.18103853846154,40.52198571459399,-30.61961867004868
2016-10-12,41.700001,41.883499,41.505001,41.704498,41.704498,47608000,2667091210.5305634,4648156000,35.628642450023115,72.0,0.856989906268069,64.78255059623848,73.79139129733015,40.26799996153846,40.609579217216655,-26.208608702669846
2016-10-13,41.450001,41.59,41.060501,41.464001,41.464001,61828000,2699494164.6966715,4586328000,33.72559444952376,72.0,0.7933043079189446,61.00180749281819,64.18304899476718,40.354153884615386,40.67286971964505,-35.81695100523283
2016-10-14,41.754002,41.786999,41.147999,41.147999,41.147999,59996000,2639498164.6966715,4526332000,32.33296371810963,72.0,0.7091595421705534,56.3484546222433,47.396919739696166,40.42896157692308,40.708064481152824,-52.603080260303834
2016-10-17,41.075001,41.099998,40.584,40.647499,40.647499,67230000,2588814886.8545094,4459102000,30.237682327261542,72.0,0.5952266397503507,49.86088277194844,3.57438784126092,40.53051923076923,40.70357814921558,-96.42561215873909
2016-10-18,41.105499,41.162998,40.750999,40.8825,40.8825,50250000,2570642271.7510743,4509352000,28.160965492975524,60.0,0.5179262787117267,52.619251976925796,16.802701942020676,40.619288423076924,40.71683161964406,-83.19729805797932
2016-10-19,41.02,41.033501,40.758499,40.884499,40.884499,41814000,2567144822.1761613,4551166000,26.23258557542422,60.0,0.45162048839700475,52.64311835832774,16.91522656909627,40.72828842307692,40.72925142559635,-83.08477343090374
2016-10-20,40.699501,40.7855,40.154999,40.515999,40.515999,63040000,2576293256.4530306,4488126000,25.608599012171258,60.0,0.365128823752741,47.857439978652366,16.368163061363532,40.822961423076926,40.713454949626254,-83.63183693863647
2016-10-21,40.467999,40.971001,40.450001,40.949501,40.949501,55860000,2627542930.1574445,4543986000,24.593897350812803,52.00000000000001,0.3277850429203042,53.242510366955386,36.02365176891779,40.917769115384615,40.730939842246535,-63.97634823108221
2016-10-24,41.247501,41.915001,41.1105,41.904499,41.904499,81218000,2706640481.740352,4625204000,23.78390454477716,52.0,0.37097382952828184,62.44427677641936,79.324380265527,41.03232680769231,40.81787015022827,-20.675619734473006
2016-10-25,41.965,42.154499,41.660999,41.758999,41.758999,64968000,2667475375.3573747,4560236000,23.38509552349176,48.0,0.3889767383575773,60.49103393892182,72.72723975187509,41.14786519230769,40.88758339835951,-27.272760248124918
2016-10-26,41.638,41.672001,41.0,41.129501,41.129501,79962000,2618332254.978089,4480274000,21.791185610140992,44.0,0.34843243344197816,52.79646198013759,45.48429826436573,41.22934592307692,40.905503220703245,-54.51570173563427
2016-10-27,41.562,41.585999,40.7715,40.917999,40.917999,148128000,2523490026.6536827,4332146000,20.52778096517223,40.0,0.2958242579845489,50.47339985344466,36.24704809836028,41.28438434615384,40.906428833984485,-63.75295190163972
2016-10-28,39.099998,39.474499,38.730499,38.816002,38.816002,216822000,2356503863.9278736,4115324000,21.614669987986854,-64.0,0.08355513752093202,34.31388818253431,2.49716705607464,41.229807461538456,40.75158240183748,-97.50283294392536
2016-10-31,39.051498,39.685001,39.005501,39.491001,39.491001,108266000,2402949101.6026335,4223590000,22.2811534965336,-64.0,-0.02985869916732753,40.86161910864351,22.21092289719613,41.19917296153846,40.65820600170137,-77.78907710280387
2016-11-01,39.950001,40.042,38.835499,39.2705,39.2705,106108000,2373355064.0576997,4117482000,22.332753867550046,-64.0,-0.13596524700950852,39.47723651609644,15.771057242990558,41.17273065384615,40.55541296453831,-84.22894275700945
2016-11-02,39.196499,39.237499,38.177502,38.278,38.278,100530000,2291887502.8004513,4016952000,22.97161703371151,-76.0,-0.29672148538147525,33.9085319107662,2.526982041977946,41.075519115384616,40.38671570790585,-97.47301795802204
2016-11-03,38.252499,38.849998,38.200001,38.351501,38.351501,77450000,2250541284.8179064,4094402000,23.564847116575724,-76.0,-0.4134253361243907,34.64379318355837,4.3751353093804655,40.9568845,40.235959062875786,-95.62486469061953
2016-11-04,38.1395,38.299999,37.661499,37.752499,37.752499,102442000,2177299666.9635606,3991960000,24.569999614329863,-84.0,-0.5479322125056072,31.56214852012627,2.02537280213668,40.814576807692305,40.05199905821832,-97.97462719786331
2016-11-07,38.582001,39.386501,38.547001,39.246498,39.246498,119688000,2257067049.77714,4111648000,23.85738120147472,-84.0,-0.5278914437158946,44.76035011351021,35.27707545070115,40.713845923076924,39.992332313165114,-64.72292454929885
2016-11-08,39.248501,39.587002,38.955002,39.387501,39.387501,68252000,2282229359.1062546,4179900000,22.932089792436965,-84.0,-0.49492602721437606,45.822294391334864,38.41535722234588,40.619634346153845,39.9475299936714,-61.58464277765412
2016-11-09,38.200001,38.875,38.004501,38.594002,38.594002,171258000,2342922831.211336,4008642000,22.971405253148728,-84.0,-0.5267573045739837,41.04074385955519,20.754573781437873,40.500115192307696,39.847268660806854,-79.24542621856213
2016-11-10,38.940498,38.941502,35.884998,37.118999,37.118999,254940000,2293836456.75215,3753702000,24.39178200824257,-100.0,-0.6633574642765367,33.94903962099197,19.682603129020947,40.30399980769231,39.645174611858195,-80.31739687097905
2016-11-11,36.786499,37.162998,36.445,36.9505,36.9505,132456000,2347889355.105626,3621246000,25.710703280829705,-96.0,-0.7762622678693987,33.24236991084115,16.99500486561842,40.10659596153846,39.44556908505388,-83.00499513438159
2016-11-14,37.275501,37.299999,35.505001,35.953499,35.953499,146426000,2274635323.150159,3474820000,27.405736650122353,-100.0,-0.9354069969764183,29.349478244524775,7.272547429868665,39.875134384615386,39.18689722690175,-92.72745257013133
2016-11-15,36.5,37.339001,36.2995,37.161999,37.161999,135116000,2363737317.9072585,3609936000,28.92501818781513,-56.0,-0.9530285710975619,38.71758733445678,27.248783834495608,39.685769,39.036904765649766,-72.7512161655044
2016-11-16,36.993999,37.4935,36.780499,37.324501,37.324501,72976000,2402119057.8038363,3682912000,30.108679235287436,-56.0,-0.9430108007241316,39.87212775093951,40.103601521622494,39.52324984615385,38.910060042268306,-59.896398478377506
2016-11-17,37.466,37.875,37.400002,37.82,37.82,73802000,2458829996.3677883,3756714000,30.648598347967617,-56.0,-0.8848885726455222,43.37519717078141,51.02489553116497,39.37384607692308,38.829314853952134,-48.97510446883503
2016-11-18,38.049999,38.387001,37.882,38.007999,38.007999,87468000,2415008961.5500355,3844182000,30.440409193656375,-56.0,-0.8142699429811415,44.69181506881626,55.16858169904814,39.24092292307692,38.76847664254827,-44.83141830095186
2016-11-21,38.299999,39.017502,38.255501,39.0,39.0,92292000,2503061348.783123,3936474000,29.450262838114277,-56.0,-0.6705285443212219,51.1466961473839,85.61974874577449,39.15830757692308,38.785626520878026,-14.380251254225525
2016-11-22,39.408501,39.619999,39.049999,39.266499,39.266499,106226000,2477529836.5024223,4042700000,27.844163245677827,-56.0,-0.5290101089686274,52.74235153778515,91.40947334603815,39.10519219230769,38.82124670451669,-8.590526653961845
2016-11-23,39.086498,39.087502,38.655998,39.006001,39.006001,70806000,2521588646.1820536,3971894000,26.71753291614606,-56.0,-0.4328857039605367,50.98921015365683,85.07902069454221,39.033019153846155,38.83493220788582,-14.920979305457799
2016-11-25,39.325001,39.337502,38.895,39.018501,39.018501,36742000,2505355813.3361,4008636000,25.381990475573197,-56.0,-0.351644239023031,51.07325171433959,85.38278754934997,38.96125,38.84852989619058,-14.617212450650023
2016-11-28,38.849499,38.849998,38.212002,38.338501,38.338501,88776000,2451784031.619601,3919860000,24.77344695326973,-56.0,-0.3382311911201654,46.410890748637584,68.85787064781078,38.87750007692308,38.810749977954245,-31.142129352189215
2016-11-29,38.400002,38.494499,38.066002,38.125999,38.125999,65446000,2404665178.190056,3854414000,24.336946773023858,-56.0,-0.3408196328929023,45.02754899717576,63.693785513383,38.76890384615385,38.76002768329097,-36.306214486617
2016-11-30,38.099998,38.404499,37.512501,37.5285,37.5285,92518000,2315466009.5820546,3761896000,24.40348818796204,-56.00000000000001,-0.38662736781009244,41.3000384471602,49.17375415492307,38.60059619230769,38.66880341045461,-50.82624584507693
2016-12-01,37.620499,37.668499,36.901501,37.182499,37.182499,93320000,2290523589.080306,3668576000,24.935286211584607,-52.0,-0.44571182829722744,39.27256712899579,40.76546331249735,38.42457696153846,38.55870678745797,-59.23453668750265
2016-12-02,37.169998,37.4245,36.834999,37.016998,37.016998,71226000,2263277364.429287,3597350000,25.47882614484979,-48.0,-0.5001260941683725,38.30394209964123,36.74356585349497,38.26640376923077,38.44450613653516,-63.256434146505036
2016-12-05,37.25,38.074501,37.099998,37.967999,37.967999,86294000,2330709475.675738,3683644000,25.064373721261756,-36.0,-0.46119558345011313,46.47352811270094,50.2484415745946,38.15294223076923,38.40920931160663,-49.7515584254054
2016-12-06,38.199501,38.411999,37.862499,38.236,38.236,75894000,2357987395.2171383,3759538000,24.23935180333993,-36.0,-0.4040596837882333,48.541478257763835,51.259059693607945,38.13063446153846,38.396378992228364,-48.740940306392055
2016-12-07,38.227501,38.521,37.791,38.521,38.521,73698000,2431685395.2171383,3833236000,23.330601013180797,-36.0,-0.3319553785398881,50.721794350999,60.538635547576284,38.093326730769235,38.40561017798923,-39.461364452423716
2016-12-08,38.593498,38.689499,38.259499,38.366501,38.366501,63792000,2399641635.14272,3769444000,22.260086070918327,24.000000000000007,-0.28400514076936645,49.49743103272444,54.99109515260316,38.05855753846154,38.402713201841884,-45.00890484739684
2016-12-09,38.5,38.512501,38.266998,38.432999,38.432999,49418000,2417053265.8845043,3818862000,21.266036481674604,23.999999999999996,-0.23789608108283744,50.0562414803095,57.37881508078998,38.06451903846154,38.40495659429804,-42.62118491921002
2016-12-12,38.32,38.344501,37.860001,38.006001,38.006001,59278000,2393501119.3416767,3759584000,20.82636062163787,24.0,-0.23312220148702778,46.498366498272674,42.04675044883288,38.051230576923075,38.37540432805374,-57.95324955116712
2016-12-13,38.248001,39.123001,38.099998,38.716999,38.716999,105706000,2415303460.384665,3865290000,19.344856072942715,24.0,-0.17000752999188506,52.54658089636314,75.20470504930464,38.088326730769225,38.400707637086796,-24.795294950695364
2016-12-14,38.912498,39.042999,38.140499,38.441002,38.441002,109096000,2378858264.3469915,3756194000,17.96917327772578,24.0,-0.14063816024506792,50.175363727414634,64.17586712183746,38.05734611538462,38.40369240470999,-35.82413287816255
2016-12-15,38.313999,38.455002,38.015499,38.049999,38.049999,76038000,2314757889.3461385,3680156000,16.85109283276856,24.0,-0.14721637870275117,46.943432423795784,53.10310043435263,38.00590373076923,38.37749289324999,-46.89689956564737
2016-12-16,38.25,38.2565,37.700001,37.8885,37.8885,96964000,2283481759.534584,3583192000,16.24005714399733,24.0,-0.16357568514449383,45.63589948608325,46.0445838771119,37.978769038461536,38.3412711974537,-53.9554161228881
2016-12-19,37.9445,38.525002,37.807999,38.299999,38.299999,62264000,2306667577.7361813,3645456000,15.261677922616622,24.000000000000004,-0.14170256414990945,49.49590578247507,64.02966430973387,38.024192115384615,38.33821399764231,-35.97033569026613
2016-12-20,38.432499,38.719501,38.385502,38.561001,38.561001,54072000,2309419591.748198,3699528000,14.281432471340022,24.0,-0.10212998714105481,51.832019497928115,75.43708440814278,38.08613446153846,38.3547167385577,-24.56291559185722
2016-12-21,38.5,38.561001,38.285,38.529999,38.529999,40892000,2341125148.336761,3658636000,13.308597314458996,20.0,-0.07243505088464275,51.52713597327856,74.08210307508446,38.18523061538462,38.367700609775646,-25.917896924915535
2016-12-22,38.405998,38.560501,38.151001,38.317001,38.317001,50872000,2331497358.34897,3607764000,12.619334518324667,16.0,-0.0653356102178293,49.37811416541408,60.158240002609816,38.229653769230765,38.3639450831256,-39.841759997390184
2016-12-23,38.227501,38.325001,37.899502,38.029499,38.029499,39632000,2316081824.6814413,3568132000,12.374844444262417,-28.0,-0.08196343749917645,46.55565732416851,23.15516514406188,38.25676907692308,38.33917129919037,-76.84483485593812
2016-12-27,38.169998,38.732498,38.060001,38.57,38.57,52774000,2343351861.237738,3620906000,11.545005279499806,-28.0,-0.05093999234924951,52.099068398973834,61.13836964160217,38.28561523076923,38.356269721472565,-38.86163035839783
2016-12-28,38.8125,39.0,38.525002,38.606499,38.606499,66020000,2299986406.8989825,3686926000,11.203588906899109,-28.0,-0.023141760481365736,52.457680433262006,63.70330288123668,38.30863446153846,38.37480522358571,-36.29669711876332
2016-12-29,38.619999,38.669998,38.0425,38.2575,38.2575,63166000,2280105612.5888815,3623760000,10.722540400929791,-28.000000000000004,-0.02893917129163981,48.703067953449164,39.17772312016861,38.280076769230774,38.36611594776454,-60.82227687983139
2016-12-30,38.323502,38.369999,37.414001,37.4935,37.4935,82788000,2211086602.088859,3540972000,11.153505623296358,-20.0,-0.09409738008839241,41.6715436236943,4.651784669397208,38.2118845,38.301477729411616,-95.3482153306028
2017-01-03,37.896,37.938,37.384998,37.683498,37.683498,70422000,2216689524.241039,3611394000,11.591452374361248,-20.0,-0.12891838834693914,43.8429340921778,17.17488404795603,38.161019,38.2557014531589,-82.82511595204397
2017-01-04,37.919498,37.984001,37.709999,37.859001,37.859001,50210000,2221087814.837457,3661604000,11.908209163094515,28.0,-0.14073041033473288,45.84828267952526,28.58882473532866,38.116422846153846,38.22631623440639,-71.41117526467134
2017-01-05,38.077499,39.119999,38.013,39.022499,39.022499,116602000,2317150148.5866303,3778206000,11.753098222526246,28.0,-0.05556642288546243,56.84942604356609,94.38040669717212,38.14273046153846,38.28529273556148,-5.619593302827881
2017-01-06,39.118,39.972,38.924,39.7995,39.7995,119724000,2397461190.5713634,3897930000,12.589519230033591,92.0,0.07377372024870965,62.35025619661295,93.33204999454969,38.207095884615384,38.397456236630994,-6.667950005450307
2017-01-09,39.900002,40.088501,39.588501,39.846001,39.846001,68922000,2399528850.5713634,3966852000,13.48593688843096,96.0,0.1779773455504241,62.65707038757676,91.03015606048893,38.296230538461536,38.5047558487324,-8.969843939511069
2017-01-10,39.830002,39.900002,39.477001,39.794998,39.794998,51168000,2425293389.7190247,3915684000,14.120991551528801,96.0,0.2535215152819674,62.05970338918675,89.14360368751204,38.39671126923077,38.600329341418885,-10.856396312487961
2017-01-11,39.682999,39.974998,39.475498,39.951,39.951,59856000,2479397941.1184244,3975540000,14.797953397357828,92.0,0.32226401276073346,63.21491625700106,94.9139690246321,38.5095575,38.7003790198323,-5.086030975367899
2017-01-12,40.015499,40.706501,39.974998,40.681999,40.681999,97478000,2570345808.074539,4073018000,16.20080781862784,28.0,0.4307628810103594,68.11417380636522,99.26232190667884,38.61394211538462,38.8471656850299,-0.7376780933211667
2017-01-13,40.716,41.0825,40.57,40.856998,40.856998,75838000,2579445776.168196,4148856000,17.844455981246803,32.0,0.5248201723055175,69.17269026449756,93.90123386004915,38.71474973076923,38.996042152805465,-6.09876613995086
2017-01-17,40.785,40.799999,40.172001,40.486,40.486,73410000,2579445776.1681952,4075446000,18.608579155512697,32.0,0.5629356435788679,64.29934507310509,83.86748675186637,38.79032665384615,39.106409400745804,-16.132513248133634
2017-01-18,40.474998,40.586498,40.213501,40.374001,40.374001,47084000,2572882112.7928867,4028362000,19.31812210304531,32.0,0.5774485781254697,62.85958126699278,80.8384417371511,38.86753819230769,39.200305074764636,-19.1615582628489
2017-01-19,40.5,40.675499,40.366001,40.452,40.452,50816000,2550306199.539812,4079178000,20.076462552426854,31.999999999999993,0.588460642763124,63.473001730084135,82.94794701936593,38.94519207692308,39.29302321737466,-17.052052980634087
2017-01-20,40.764,40.800999,40.313,40.4165,40.4165,67524000,2511424610.692293,4011654000,20.924499269832207,32.0,0.5875503157098549,62.96329203722146,81.98783935749043,39.03790357692308,39.37624371979135,-18.012160642509564
2017-01-23,40.34,40.924999,40.254002,40.894001,40.894001,55950000,2562205174.4653063,4067604000,21.8562270101281,32.0,0.6182326142782557,66.82257917763226,94.90199058715858,39.12163442307693,39.48867018499199,-5.0980094128414315
2017-01-24,41.099998,41.199501,40.724998,41.122002,41.122002,59434000,2602224858.5768933,4127038000,23.033072393708032,56.0,0.653414180230385,68.50989350537178,97.77908137035038,39.224749807692305,39.60965772684444,-2.2209186296496206
2017-01-25,41.289501,41.870998,41.2645,41.826,41.826,78452000,2669035655.816126,4205490000,24.778970650191077,60.0,0.7296911543498013,73.06492082713619,98.83364377068108,39.36998061538462,39.773831228559665,-1.1663562293189271
2017-01-26,41.776501,42.192001,41.650002,41.9575,41.9575,71726000,2678695789.547001,4277216000,26.666230235721088,64.0,0.7916267761886573,73.82650444872985,92.82432900112347,39.526480615384614,39.93558447088858,-7.1756709988765195
2017-01-27,41.950001,41.985001,41.472,41.788502,41.788502,59974000,2692725118.7724805,4217242000,27.979879489876833,64.0,0.8176491263337553,71.04627186954932,85.1463812114326,39.660653807692306,40.07283762119313,-14.8536187885674
2017-01-30,41.650002,41.674999,40.819,41.519001,41.519001,74946000,2740354670.720556,4142296000,27.76658392265554,64.0,0.8072204134692811,66.73051660759617,75.22550131547818,39.77442303846154,40.179960834438084,-24.77449868452182
2017-01-31,41.1875,41.349499,40.978001,41.174,41.174,62744000,2743817009.683349,4079552000,27.568523753092908,64.0,0.7623292291627095,61.57398775004038,62.52531287467749,39.87611538461538,40.253593365220446,-37.47468712532251
2017-02-01,41.460499,41.688999,41.247002,41.6175,41.6175,77004000,2795908130.2022657,4156556000,27.797036176146417,64.0,0.7538494781628273,65.28743782742033,74.08659347777164,40.00305765384615,40.354623486315226,-25.91340652222836
2017-02-02,41.829498,42.1245,41.412998,41.997501,41.997501,147010000,2890437257.372675,4303566000,28.484562468543135,64.0,0.7689283914459608,68.12940010926077,90.37128712871295,40.155673115384616,40.476318116958545,-9.628712871287043
2017-02-03,40.335999,40.915001,40.200001,40.509998,40.509998,217376000,2861553307.364286,4086190000,26.926227843160376,64.0,0.6533184301555863,50.648732503573285,16.732524752475353,40.23028842307693,40.478812923109764,-83.26747524752464
2017-02-06,40.490002,40.535999,40.150002,40.382,40.382,77946000,2877303973.96014,4008244000,25.404256521352277,64.0,0.54508493421406,49.47243611659997,11.361318002604193,40.29857692307692,40.471641595472,-88.6386819973958
2017-02-07,40.4655,40.807999,40.375,40.625,40.625,69322000,2888030657.6753445,4077566000,24.358332208924317,64.0,0.4734594324454733,51.76286826489636,23.26142177346806,40.389634615384615,40.48300147728889,-76.73857822653194
2017-02-08,40.634499,41.074001,40.625,40.9855,40.9855,57160000,2922657446.56891,4134726000,23.733053065240135,64.0,0.4407048720006159,55.02039778567079,40.91569094793888,40.52394230769231,40.5202235900823,-59.08430905206112
2017-02-09,41.080002,41.25,40.9855,41.068001,41.068001,49698000,2903962355.4384756,4184424000,23.376873888998883,60.0,0.41660146570335854,55.75676156708656,44.95589860719829,40.654115499999996,40.56079969452065,-55.04410139280171
2017-02-10,41.191002,41.400002,41.142502,41.373001,41.373001,48592000,2942363811.0345926,4233016000,23.23791265891842,56.00000000000001,0.417299919849917,58.46400165575007,59.892242846348275,40.78926934615385,40.62096275418578,-40.107757153651725
2017-02-13,41.581001,42.150002,41.427502,41.8265,41.8265,83452000,2951083938.6359777,4316468000,23.95656293181458,52.0,0.4492681455220051,62.17056088420612,82.10082375162793,40.89711553846154,40.71026180943128,-17.899176248372076
2017-02-14,41.849998,41.915501,41.572498,41.8195,41.8195,55848000,2975670032.19201,4260620000,24.623881042361017,40.0,0.4686362067121337,62.07847486078584,81.75802240843407,40.974807846153844,40.79242760132526,-18.241977591565927
2017-02-15,41.700001,42.140499,41.640999,42.134998,42.134998,59378000,3033740170.818638,4319998000,25.481415145430308,40.0,0.5036379616991269,64.6219422516079,99.24980000000012,41.06284619230769,40.89187726048635,-0.7501999999998787
2017-02-16,42.091999,42.25,41.969002,42.207001,42.207001,54294000,3071417769.9474564,4374292000,26.393127703938507,100.0,0.5310653542194359,65.19567840303445,97.9524266213586,41.15561553846154,40.98929383378366,-2.0475733786413985
2017-02-17,42.099998,42.363499,42.036499,42.253502,42.253502,62246000,3091786869.2624407,4436538000,27.361805711545514,100.0,0.5502115067157547,65.58386161821448,95.0306234885342,41.24417330769231,41.082938883133025,-4.969376511465796
2017-02-21,42.442001,42.898998,42.362499,42.821999,42.821999,70154000,3141803691.57525,4506692000,28.790088733724954,40.0,0.6042920249767931,69.99054861458556,97.19901374901963,41.326480999999994,41.2117581510491,-2.8009862509803853
2017-02-22,42.8475,42.921501,42.609001,42.780499,42.780499,52340000,3146911405.62325,4454352000,30.1372153245165,43.99999999999999,0.6364657412784425,69.29304841647625,94.91242825633346,41.4004618076923,41.32796117689731,-5.087571743666527
2017-02-23,42.878502,43.042999,42.400002,42.609501,42.609501,69240000,3122790467.640647,4385112000,30.833591201359354,48.0,0.6407790319275577,66.3585787085002,85.01560838120469,41.48213492307693,41.422890052682696,-14.984391618795318
2017-02-24,42.234501,42.290501,41.887501,42.262001,42.262001,73760000,3186117911.809381,4311352000,30.26198422655484,48.0,0.6091352678272557,60.730083476891295,73.00384341912545,41.5547503076923,41.48504641915065,-26.99615658087456
2017-02-27,42.118999,42.625,41.983501,42.431999,42.431999,54272000,3207733429.813306,4365624000,30.166293054826735,48.0,0.5909625265198812,62.40982797239064,77.09894194113252,41.63090411538462,41.55519105476912,-22.90105805886748
2017-02-28,42.572498,42.704498,42.102501,42.251999,42.251999,55874000,3179610568.9452286,4309750000,30.1779740875284,48.0,0.5556310337403758,59.50736081342791,67.28700053225815,41.701500230769234,41.60680645811955,-32.71299946774185
2017-03-01,42.6525,42.741501,42.4505,42.653999,42.653999,55202000,3201614845.1985745,4364952000,30.23773279811279,48.0,0.5536860632294704,63.58098327336279,81.09355095676824,41.76919246153846,41.68437627603662,-18.906449043231753
2017-03-02,42.653999,42.741001,42.363998,42.445499,42.445499,42642000,3177409651.494545,4322310000,30.067254978115944,48.0,0.529219934615746,60.198356979484174,68.56085539729854,41.82009619230769,41.74075573707095,-31.439144602701464
2017-03-03,42.360001,42.599499,42.313499,42.493999,42.493999,38822000,3187590245.90014,4361132000,29.772392254477943,48.0,0.5078892647945565,60.72183485941768,66.01664998449407,41.845788461538454,41.796551534324955,-33.98335001550593
2017-03-06,42.261501,42.4245,42.056,42.330502,42.330502,52208000,3213163523.5989194,4308924000,28.81595465520386,48.0,0.47234679396832746,57.95464889175722,51.547329787603026,41.86013469230769,41.83610342067126,-48.452670212396974
2017-03-07,42.273998,42.423,42.1875,42.300999,42.300999,44952000,3211540670.5033765,4263972000,27.9278340273065,48.0,0.4367637436746392,57.445911499382696,47.07560627674722,41.879846115384616,41.870540130251165,-52.92439372325278
2017-03-08,42.400002,42.6535,42.3395,42.525002,42.525002,45730000,3219842558.7836313,4309702000,27.53932332168597,48.0,0.4217771060522395,60.29571612254167,55.17110371458882,41.91853846153845,41.91901878726959,-44.82889628541118
2017-03-09,42.549999,42.82,42.515499,42.650002,42.650002,40964000,3215067476.994081,4350666000,27.47617972022943,48.0,0.4152003716637296,61.83180477455057,65.98895021886662,41.97530776923077,41.973165691916286,-34.01104978113339
2017-03-10,42.849998,42.8675,42.585999,42.623001,42.623001,48728000,3179149615.8994493,4301938000,27.502662237826446,48.00000000000001,0.40316210544293796,61.28029365835054,63.652208831170704,42.013980884615385,42.02130164066323,-36.347791168829296
2017-03-13,42.588501,42.7845,42.585499,42.7295,42.7295,38194000,3196231460.6841493,4340132000,27.525571583568336,48.0,0.3976316221594942,62.693724629554275,72.8689275100433,42.0421346923077,42.07376077839188,-27.131072489956694
2017-03-14,42.677502,42.6875,42.377499,42.626499,42.626499,42612000,3222073355.994165,4297520000,26.851043156357,48.0,0.38055060394984963,60.39735872630163,63.95493544774646,42.12353857692308,42.11470435036285,-36.04506455225354
2017-03-15,42.716499,42.7225,42.355499,42.648499,42.648499,51244000,3252651977.730891,4348764000,26.304400449436887,44.0,0.3645862665610977,60.728233288799714,77.65293638054744,42.21071161538461,42.15424469478042,-22.347063619452552
2017-03-16,42.764999,42.775002,42.525501,42.671001,42.671001,36846000,3258780498.8750944,4385610000,25.9210744159712,40.0,0.3497187969082489,61.086349781047005,77.77158118957124,42.28940396153847,42.19252293961149,-22.22841881042877
2017-03-17,42.6745,42.691502,42.532001,42.615501,42.615501,67688000,3261962875.8633275,4317922000,25.56512881346735,36.0,0.32965774465136377,59.64173940574332,68.94651879236018,42.352096307692314,42.22385464778842,-31.05348120763982
2017-03-20,42.5755,42.889999,42.550499,42.848499,42.848499,45654000,3296455515.0385838,4363576000,25.721780459110878,32.0,0.32877034764496216,63.53996955014653,95.02397484888998,42.420576999999994,42.27012459980409,-4.976025151110016
2017-03-21,42.942001,43.139999,42.065498,42.16,42.16,87658000,3224216498.0195208,4275918000,24.179004193878004,100.0,0.2694054258006773,48.601120964264176,9.594104791609462,42.45084619230769,42.26196722204083,-90.40589520839053
2017-03-22,42.0215,42.468498,41.952499,42.403,42.403,53174000,3263891283.284609,4329092000,22.487354000945455,96.0,0.2392089152298027,52.81749170738045,37.9369263157891,42.47301926923077,42.272414094482244,-62.0630736842109
2017-03-23,42.41,42.544498,42.240002,42.368999,42.368999,39060000,3257926120.7865806,4290032000,21.06914984345351,92.0,0.21011232244372735,52.1725839658089,35.073684210526245,42.49415384615384,42.27956853192801,-64.92631578947375
2017-03-24,42.584,42.59,42.176498,42.280499,42.280499,42766000,3236672504.117253,4247266000,19.575933232402516,68.0,0.17786157513333478,50.44601878396182,27.621052631578596,42.499750038461535,42.279637455488896,-72.37894736842141
2017-03-27,41.9035,42.514999,41.674999,42.341,42.341,55116000,3268954863.9172525,4302382000,19.531029533839643,-16.0,0.15539327367780942,51.62462556962571,45.46081911262797,42.50490384615385,42.284182829156386,-54.53918088737203
2017-03-28,42.587502,42.923,42.505001,42.799999,42.799999,60832000,3293985836.488957,4363214000,18.287016755615703,-16.0,0.17263434491717788,59.49556899364172,76.79180887371996,42.52592296153846,42.32239143440406,-23.20819112628004
2017-03-29,42.952499,43.821999,42.951,43.716,43.716,89716000,3361865287.230003,4452930000,18.663303565052836,8.0,0.25724626859569355,69.98961403571184,95.06292501164428,42.560307615384616,42.42562169852228,-4.937074988355712
2017-03-30,43.747501,43.853001,43.583,43.817001,43.817001,55254000,3402384941.801652,4508184000,19.063217860562617,12.0,0.32866314021166687,70.88532270628649,98.34710895582275,42.60017307692307,42.528686831965075,-1.6528910441772493
2017-03-31,43.849998,44.517502,43.8325,44.327,44.327,79152000,3437511919.0893087,4587336000,20.38637464977807,16.0,0.4215547616747699,74.95084713213541,93.29808974695885,42.66623073076922,42.661895214782476,-6.701910253041144
2017-04-03,44.400002,44.6745,44.271,44.5755,44.5755,68446000,3472371034.330943,4655782000,21.806037400862945,20.0,0.5093524165341776,76.6609767273271,96.6994510086843,42.755211461538465,42.80364371739118,-3.300548991315678
2017-04-04,44.575001,45.426998,44.514,45.341499,45.341499,99694000,3553393060.6661596,4755476000,23.8971071455504,24.0,0.633440500352414,80.97309466270507,97.72124139691938,42.8671153076923,42.991632997584425,-2.278758603080617
2017-04-05,45.541,46.186001,45.280998,45.464001,45.464001,150168000,3463956780.9013433,4905644000,26.41322788979966,28.0,0.7332140531974503,81.55986965911174,83.99468676803968,42.99065384615385,43.174771368133726,-16.00531323196032
2017-04-06,45.689999,45.859501,44.724499,44.914001,44.914001,126882000,3379443680.2759695,4778762000,27.44380772339944,28.0,0.7591538561022659,70.97653711877331,71.80227364119992,43.077577000000005,43.303603192716416,-28.197726358800086
2017-04-07,44.982498,45.004501,44.4655,44.743999,44.743999,74218000,3381921785.7822685,4704544000,27.853022420708935,28.0,0.7572643244054476,68.0377256140396,68.03366524776544,43.16598084615385,43.41029917844113,-31.966334752234555
2017-04-10,44.981499,45.425499,44.950001,45.352001,45.352001,63686000,3425919822.3081846,4768230000,28.648378236724664,28.0,0.7956557132537512,72.43383889652966,81.51186809493774,43.275904000000004,43.55412894300105,-18.488131905062257
2017-04-11,45.352001,45.562,44.875,45.118,45.118,60254000,3408290922.7448664,4707976000,29.515433581507605,27.999999999999993,0.79800038869611,68.52729951922292,76.3245283420403,43.38311546153846,43.66997124351949,-23.675471657959715
2017-04-12,45.154499,45.204498,44.762501,44.811501,44.811501,49122000,3370060299.835661,4658854000,30.0640702192484,28.0,0.7662933009236426,63.68259299787121,69.53005119483436,43.47967323076922,43.75452900325879,-30.469948805165643
2017-04-13,44.572498,44.748501,44.224499,44.233501,44.233501,63492000,3308749799.0818458,4595362000,29.435722955402987,28.0,0.6866106161911034,55.68715359985031,56.71693339971914,43.545384730769236,43.790008410424804,-43.28306660028086
2017-04-17,44.375,45.118999,44.375,45.099499,45.099499,57094000,3362850964.4140573,4652456000,29.29811049641491,28.0,0.6854390014725453,63.15183386126956,70.48350991578384,43.639596153846156,43.8870077133563,-29.516490084216155
2017-04-18,45.0495,45.480499,45.039001,45.188999,45.188999,59984000,3343625835.4938817,4712440000,29.568503862320252,28.0,0.6838494001805486,63.8299767013542,69.18078232433326,43.73828838461539,43.98345151236694,-30.81921767566674
2017-04-19,45.391998,45.525002,44.8685,44.959999,44.959999,57404000,3302223031.5176573,4655036000,29.462244856723032,28.0,0.6565430242374575,60.74931629480834,52.900440683657266,43.8240768076923,44.055788363302725,-47.099559316342734
2017-04-20,44.985001,45.265999,44.814499,45.103001,45.103001,56288000,3317869474.8221974,4711324000,29.247760417261656,28.0,0.6390747351169566,61.983232424094325,53.983448488018446,43.91932688461539,44.13335966972474,-46.016551511981554
2017-04-21,45.133499,45.182499,44.838501,44.926498,44.926498,48410000,3294226681.433864,4662914000,29.048596294904662,28.000000000000004,0.6040258392519817,59.49707462048725,35.78884956528223,44.00694223076924,44.19211065715253,-64.21115043471778
2017-04-24,45.433998,45.4995,45.191002,45.370499,45.370499,62458000,3304450018.9206567,4725372000,29.28046283705297,28.0,0.6051012759474901,63.46678566151132,58.42461542226331,44.11076907692307,44.27939868254864,-41.57538457773669
2017-04-25,45.352001,45.473999,45.150002,45.381001,45.381001,67612000,3333248197.953178,4792984000,29.392471673127243,28.0,0.5998858799004125,63.557766563505226,58.96002145294772,44.21713446153846,44.3609988542117,-41.03997854705228
2017-04-26,45.514999,45.787498,45.377998,45.4645,45.4645,52178000,3303114160.6198454,4845162000,29.90437315133232,28.0,0.5956243259615235,64.31861473933029,75.84094698355105,44.31774988461538,44.44273967982565,-24.159053016448944
2017-04-27,45.719501,46.092999,45.605499,45.918999,45.918999,106110000,3333477945.23523,4951272000,30.741104350390795,28.0,0.6217540905283627,68.20932673972604,90.6877174203907,44.46232676923077,44.552092222060786,-9.312282579609297
2017-04-28,47.441502,47.4795,46.216499,46.2495,46.2495,147294000,3193881246.0196314,5098566000,32.68764602218389,92.0,0.6615053637299724,70.71039434751508,62.21199317603884,44.61026907692308,44.67782613153777,-37.78800682396116
2017-05-01,46.389999,47.720001,46.389999,47.411499,47.411499,109330000,3252491737.83844,5207896000,34.64452581331717,96.0,0.7778060779052538,77.43275620688877,91.17431487666137,44.804211384615385,44.88032041809053,-8.825685123338625
2017-05-02,47.3325,47.505001,47.070499,47.347,47.347,76976000,3273485095.751638,5130920000,36.46162847651237,96.0,0.8549157647616141,76.38479027867538,89.32911495973963,44.999076807692305,45.0630374241579,-10.670885040260368
2017-05-03,47.299999,47.299999,46.794998,47.051498,47.051498,71654000,3274620064.486354,5059266000,37.43957649619275,92.0,0.8820138981703138,71.60346169570536,80.87533636084314,45.180249807692306,45.210330800146195,-19.12466363915686
2017-05-04,47.237499,47.25,46.710999,46.876499,46.876499,48368000,3255954807.1528797,5010898000,38.133563694360305,88.0,0.8792331548503967,68.85471201605434,74.78320634283817,45.33703826923076,45.33375066680203,-25.216793657161837
2017-05-05,47.026001,47.039501,46.514999,46.7075,46.7075,57328000,3240707475.3981867,4953570000,38.27588800990561,84.0,0.8535533570373559,66.21129017200857,65.15228693699063,45.45209596153847,45.43550987666855,-34.847713063009365
2017-05-08,47.047501,47.452499,46.960499,47.452,47.452,68314000,3308882903.503876,5021884000,38.826287370275985,80.0,0.8830970669326916,71.41726274786815,90.77608619784104,45.591903615384616,45.58487951543384,-9.223913802158965
2017-05-09,47.639999,47.894501,47.509998,47.640999,47.640999,65242000,3288097083.2580004,5087126000,39.72822169471465,68.0,0.9112569072560106,72.57256328701567,91.76942092894754,45.71936511538461,45.73718466243874,-8.230579071052468
2017-05-10,47.674999,47.6875,47.25,47.447498,47.447498,41930000,3284023499.898001,5045196000,39.913405152548115,68.0,0.9074987889081143,69.47631127333422,85.37293848167553,45.82982657692308,45.86387453929514,-14.627061518324462
2017-05-11,47.255501,47.5145,47.039001,47.381001,47.381001,43882000,3303265266.719803,5001314000,39.57644620930684,68.0,0.8889079236622379,68.39636932652597,81.2898456148098,45.90826896153847,45.97625427712513,-18.71015438519019
2017-05-12,47.724998,48.1395,47.5765,48.067501,48.067501,72518000,3357235403.5510645,5073832000,39.90096692660557,80.0,0.9189759588837134,73.05323275346679,97.59160233591062,46.00840357692308,46.131161441782524,-2.4083976640893625
2017-05-15,47.936501,48.157501,47.803001,47.898499,47.898499,85412000,3317841317.0969033,4988420000,40.21928324481318,84.0,0.9185792348106929,70.30667297131774,90.68171540019918,46.12319196153846,46.26207533498382,-9.318284599800824
2017-05-16,48.049999,48.502998,48.045502,48.303501,48.303501,62522000,3325836276.7118506,5050942000,40.83601838266937,88.0,0.9401081235305639,72.93295008013426,93.11485525965666,46.26009588461538,46.41329205091094,-6.8851447403433506
2017-05-17,47.735001,48.02,47.206001,47.237999,47.237999,102912000,3231015142.1207767,4948030000,39.55292610258566,88.0,0.8612646930571799,58.3188406924075,44.67528741538936,46.332634269230766,46.47438145454717,-55.32471258461064
2017-05-18,47.240002,48.137501,47.237999,47.9245,47.9245,78786000,3272488280.59073,5026816000,38.502704840321535,88.0,0.8444414048736775,63.40656263210248,72.62194634261552,46.44057657692308,46.581797643099236,-27.378053657384484
2017-05-19,48.141998,48.445999,47.986,47.992001,47.992001,79442000,3195119030.49671,5106258000,37.89026775050845,88.0,0.8270221972669702,63.87350483102845,74.29591262369863,46.5629035,46.686257151017806,-25.70408737630137
2017-05-22,48.200001,48.569,48.145,48.533501,48.533501,52844000,3239114402.40237,5159102000,37.462718825382254,100.0,0.8471464967515416,67.4605962569886,98.27171457073285,46.728288115384615,46.823090028720195,-1.728285429267148
2017-05-23,48.750999,48.759998,48.342499,48.577,48.577,48312000,3245074208.140826,5207414000,37.28475149842023,92.0,0.8567293126240543,67.73772217061332,91.84863779449323,46.86203815384616,46.95300928585203,-8.151362205506768
2017-05-24,48.799999,49.049999,48.511501,49.017502,49.017502,48920000,3288089810.204344,5256334000,37.43807298967645,96.0,0.8896136804714772,70.47957100118042,98.71806706114401,47.009288269230765,47.10593467208522,-1.2819329388559912
2017-05-25,49.2425,49.950001,49.105499,49.668999,49.668999,96440000,3320350369.8240957,5352774000,38.387220189649575,100.0,0.9572110093494146,73.99911093482028,90.60037424293408,47.190403653846154,47.29579128896779,-9.399625757065916
2017-05-26,49.75,49.932499,49.462502,49.789001,49.789001,69384000,3347366162.231281,5422158000,39.268571161053195,96.0,1.0088363010987962,74.59981539033623,94.4692545517004,47.37063442307692,47.48047348978499,-5.530745448299598
2017-05-30,49.8255,50.060001,49.776001,49.834999,49.834999,65262000,3309219144.456634,5487420000,40.191598909994646,96.0,1.041456113140633,74.83976633990729,92.55206885137383,47.559422923076916,47.65488278683796,-7.447931148626161
2017-05-31,50.0,50.006001,49.108002,49.730999,49.730999,78262000,3339547446.258752,5409158000,39.48723584729017,96.0,1.0468482039068476,73.15701232842699,89.10950016550802,47.72713446153846,47.80866917299811,-10.890499834491976
2017-06-01,49.929501,49.949501,49.568501,49.797501,49.797501,49096000,3349469734.9726624,5458254000,38.83318443192174,92.0,1.0444478852318682,73.56630330011214,90.80238262088287,47.896999846153854,47.95599004907232,-9.197617379117132
2017-06-02,49.949501,50.424,49.783501,50.336498,50.336498,75046000,3404010862.70276,5533300000,38.75240522121201,100.0,1.0736616653556652,76.67109199401723,97.28085683059562,48.08438438461538,48.13232397136326,-2.7191431694043615
2017-06-05,50.3615,50.6605,50.175499,50.567001,50.567001,54398000,3437435056.0425673,5587698000,38.91654163483664,100.0,1.102702197756301,77.86828489835099,97.29341360353551,48.2631536923077,48.31267041792895,-2.7065863964644765
2017-06-06,50.599998,50.825001,50.0625,50.150002,50.150002,66928000,3385867911.585052,5520770000,39.23190362539959,100.0,1.0796234673265275,70.79064136667817,81.34846642718983,48.41317299999999,48.44876905363792,-18.651533572810163
2017-06-07,50.297501,50.512501,50.099998,50.503502,50.503502,56460000,3439864494.1553597,5577230000,39.524739759493755,84.0,1.0774378697838074,73.02868850280339,91.03711121432319,48.53209619230769,48.60097149410918,-8.962888785676814
2017-06-08,50.603001,50.6805,50.3055,50.5135,50.5135,55358000,3445916968.822026,5632588000,39.97406024990626,84.0,1.0642445740476774,73.09148643067236,89.027795340685,48.653884653846156,48.742640272323314,-10.972204659315
2017-06-09,50.625,50.649502,46.349998,48.915501,48.915501,152954000,3475497487.1580944,5479634000,39.32842332613619,-12.0,0.9143040993364835,52.1796399821026,57.32963754437705,48.725577076923074,48.75544477066974,-42.67036245562296
2017-06-12,48.349998,48.797501,47.25,48.245499,48.245499,188944000,3529646787.9779334,5290690000,38.72890332549256,-12.0,0.7329624955104919,46.21002806321311,42.357535849696696,48.778230923076926,48.71767100987939,-57.6424641503033
2017-06-13,48.899502,49.224998,48.305,49.039501,49.039501,91600000,3584308609.416676,5382290000,37.593364678713066,-12.0,0.645872082307676,53.06315939069912,60.10058540742881,48.867923269230765,48.74151026840684,-39.89941459257119
2017-06-14,49.429501,49.516998,48.335499,48.823502,48.823502,79498000,3570481866.8515105,5302792000,36.156893109138146,-12.0,0.5530477975213373,51.15383058391725,55.273795347176254,48.92067334615384,48.74758373000633,-44.726204652823746
2017-06-15,47.935001,48.286499,47.542999,48.2085,48.2085,107478000,3655409291.1366487,5195314000,35.48848357852659,-12.0,0.42495969066570183,46.0707987097791,41.53074310788174,48.9425003076923,48.70765160185771,-58.46925689211826
2017-06-16,49.799999,49.987499,49.099998,49.385502,49.385502,229454000,3573583372.2678266,5424768000,32.99335786910754,-12.0,0.41365481275127536,55.23804806935083,67.83244614584622,49.017038923076925,48.757862742460844,-32.16755385415379
2017-06-19,50.849998,50.849998,49.494999,49.758499,49.758499,100868000,3511945981.2941065,5525636000,31.326229418235954,24.0,0.42983844614879274,57.69245037596004,75.7444666666667,49.10848115384616,48.831983946723,-24.255533333333307
2017-06-20,49.900002,50.243999,49.601002,49.629501,49.629501,81536000,3437637680.53376,5444100000,29.778181570998047,24.0,0.42732904842719677,56.537832673800224,72.8778444444444,49.16855807692308,48.89105928400278,-27.122155555555594
2017-06-21,49.935001,50.136002,49.6325,50.1115,50.1115,58450000,3490398956.755106,5502550000,28.34070856999142,24.0,0.4589432120535548,59.77705622911789,83.58893333333334,49.2536735,48.981462300002576,-16.411066666666663
2017-06-22,50.1115,50.348,49.860001,50.064999,50.064999,45068000,3483195173.132599,5457482000,27.200989231682147,24.0,0.47477254011348435,59.3177366558459,82.5555777777778,49.32142342307692,49.061724277780165,-17.4444222222222
2017-06-23,50.126999,50.230999,49.901001,50.187,50.187,57582000,3525422229.05415,5515064000,26.142678417537816,24.0,0.49149619554375334,60.182193937705854,85.26671111111108,49.43484653846154,49.14507803498164,-14.733288888888929
2017-06-26,50.424999,50.490002,49.599998,49.699001,49.699001,67724000,3472765305.5436945,5447340000,24.779322256863903,23.999999999999993,0.4600689831823601,55.135468005547,74.42228888888897,49.50309657692307,49.18610936572374,-25.57771111111104
2017-06-27,49.5345,49.939999,48.799999,48.839001,48.839001,75648000,3402293486.7647476,5371692000,23.41918778907239,24.0,0.3615995833757708,47.565440908894246,55.311177777777864,49.5356735,49.16039763492939,-44.688822222222136
2017-06-28,48.927502,49.534,48.460499,49.516499,49.516499,74752000,3474608162.995138,5446444000,22.504880045427036,24.0,0.3343758247423949,53.03593212886969,70.36668888888897,49.57348111538462,49.18677551382351,-29.633311111111027
2017-06-29,48.950001,49.377998,48.262501,48.796501,48.796501,86060000,3470943794.7180386,5360384000,21.85698907722742,24.0,0.25180038051690445,47.37874885364201,42.95838497688053,49.581923461538466,49.157866290577324,-57.04161502311947
2017-06-30,49.006001,49.1735,48.380501,48.400002,48.400002,67806000,3406472691.246281,5292578000,21.255376035327778,24.0,0.15260544979303603,44.559912513466486,25.91482489108704,49.55817346153846,49.101728194979,-74.08517510891296
2017-07-03,48.6395,48.724499,47.549999,47.682999,47.682999,58182000,3361467712.957648,5234396000,21.51833820031692,24.0,0.015952709769571527,39.93309085519382,4.2334454893999265,49.481788846153854,48.99663714349908,-95.76655451060009
2017-07-05,48.0765,48.75,47.762501,48.57,48.57,73060000,3407893154.3403735,5307456000,21.72347784621915,24.000000000000007,-0.020535285516842805,47.232574739451444,31.055376793279926,49.43490419230769,48.96503439212878,-68.94462320672007
2017-07-06,48.233002,48.720001,47.951,48.257,48.257,65192000,3394583406.769173,5242264000,21.913964660271226,23.999999999999996,-0.07385738683222343,45.14761995511967,21.4242792194785,49.37421192307693,48.91258740011924,-78.5757207805215
2017-07-07,48.477501,49.005501,48.457001,48.938,48.938,52868000,3434439035.3270583,5295132000,21.613288386993627,24.0,-0.06046749599005352,50.28916383497075,42.060649109287695,49.34371196153846,48.914469814925226,-57.939350890712305
2017-07-10,49.25,49.972,49.174999,49.823502,49.823502,70926000,3478935032.9857807,5366058000,20.182396726728737,24.0,0.02135058368389764,56.057023190316066,77.329955105488,49.344711999999994,48.98180553233817,-22.670044894512007
2017-07-11,49.650002,49.7995,49.186001,49.706501,49.706501,59654000,3520503388.6864424,5306404000,18.853711613625624,24.0,0.07587634315854785,55.14655105181898,73.35033331598659,49.32048134615385,49.0354866780909,-26.649666684013408
2017-07-12,50.032501,50.427502,49.904999,50.3255,50.3255,72172000,3564496839.1125646,5378576000,18.392528772713515,24.0,0.16711010521807168,58.945652093512635,94.40469958704126,49.311192846153844,49.131043220454536,-5.595300412958728
2017-07-13,50.230999,50.344002,49.794998,50.031502,50.031502,57616000,3556521331.5825653,5320960000,17.8012314708922,24.0,0.2132323278548114,56.49795948731374,84.40477781825413,49.30663515384616,49.19774387079124,-15.595222181745873
2017-07-14,50.119999,50.2225,49.844501,50.0905,50.0905,42050000,3569202999.9203124,5363010000,17.252169690629554,24.000000000000004,0.25164436749494,56.884871647851995,86.41151046444516,49.290750461538465,49.263873954436335,-13.58848953555485
2017-07-17,50.234501,50.737499,50.190498,50.501999,50.501999,74252000,3579519665.2499914,5437262000,17.380030978046758,24.0,0.311697659321311,59.58486656256512,92.6117647058823,49.29030811538462,49.355586920774385,-7.388235294117704
2017-07-18,50.299999,51.301498,50.200001,51.2225,51.2225,80152000,3648174860.9990487,5517414000,18.105126640865233,100.0,0.41267171235540445,63.85315840036147,97.89422841376192,49.37903884615385,49.4938767784948,-2.1057715862380775
2017-07-19,51.25,51.579498,51.125,51.343498,51.343498,59280000,3645892081.844904,5576694000,19.051361263236267,92.0,0.4967318882384646,64.53063115888824,94.1431924911756,49.49819265384615,49.630885757865556,-5.8568075088244
2017-07-20,51.579498,51.748501,51.125999,51.435001,51.435001,61950000,3645444450.993919,5638644000,20.093623212371337,96.0,0.5642296227538068,65.0638897425255,92.53305107393071,49.59032726923077,49.76452392394959,-7.4669489260692945
2017-07-21,51.063999,51.305,50.549999,51.283501,51.283501,54692000,3697021691.389627,5583952000,20.019882434052935,96.0,0.598597025889724,63.36526428692837,88.92462121013646,49.68494261538462,49.87704074439777,-11.07537878986354
2017-07-24,51.417,52.150501,51.371498,51.947498,51.947498,65760000,3728508454.2390647,5649712000,20.801887076240487,56.0,0.671669857111425,67.38430503391487,95.37367821330913,49.82875023076924,50.03040794851645,-4.626321786690872
2017-07-25,51.9025,52.1665,51.624001,51.9935,51.9935,48952000,3746239397.6103888,5698664000,21.54277164607132,60.0,0.7249359686713177,67.64910076736149,95.896097734551,49.929057846153846,50.175822174552266,-4.1039022654489825
2017-07-26,52.16,52.66,52.16,52.639999,52.639999,58426000,3799991083.90639,5757090000,22.67474333096639,64.0,0.8099798683986208,71.18920040177905,99.52412551133146,50.03988476923077,50.3583537912521,-0.47587448866853177
2017-07-27,53.477501,54.165501,52.008999,52.299999,52.299999,219834000,3639486214.136735,5537256000,24.74918369385136,68.0,0.84025665743399,67.03464833014803,62.618950959242184,50.14259623076923,50.50217936227046,-37.381049040757816
2017-07-28,50.606998,51.642502,50.049999,51.001999,51.001999,154188000,3669645717.406744,5383068000,24.044245063455104,68.0,0.7508580544567636,54.06310777951999,36.46948488804097,50.17684619230769,50.539203039139316,-63.530515111959026
2017-07-31,50.952499,50.952499,49.351002,49.389,49.389,147042000,3529581316.3856997,5236026000,22.689410864566902,68.0,0.5435873421018727,42.94259941557144,0.7892409989077113,50.150846230769226,50.45400281401788,-99.21075900109228
2017-08-01,49.8055,50.32,49.578999,49.809502,49.809502,91452000,3495025218.971526,5327478000,21.43135053702786,68.0,0.4085453498910354,46.057697766228074,9.523316964028885,50.136327076923074,50.406262012979525,-90.47668303597112
2017-08-02,50.088501,50.1605,49.086498,49.794498,49.794498,81400000,3520945689.510687,5246078000,20.027187387421826,68.0,0.29689053149347444,45.96127590062709,13.939743685916278,50.14000003846154,50.36094616016623,-86.06025631408372
2017-08-03,49.973499,49.974998,49.2295,49.346001,49.346001,65116000,3476181398.344245,5180962000,18.723321605644795,68.0,0.17025077882879458,43.05940242283894,5.109329527862107,50.15950003846154,50.285765037190956,-94.8906704721379
2017-08-04,49.484001,49.5835,49.099998,49.379002,49.379002,54606000,3484595995.669592,5235568000,17.64934746864148,68.0,0.07172397797950225,43.34286338696405,5.759083032634574,50.15421169230769,50.21859740480644,-94.24091696736542
2017-08-07,49.532501,49.75,49.356998,49.613499,49.613499,53532000,3500941561.341013,5289100000,16.45745678787861,68.0,0.012419561610627738,45.422003247832386,10.376071839295989,50.18563469230769,50.173775300746705,-89.62392816070401
2017-08-08,49.717499,49.813999,49.289501,49.492001,49.492001,58056000,3487714483.47227,5231044000,15.430938976955407,68.0,-0.04387769408134545,44.510603124247034,7.983909440494582,50.22763465384616,50.1232735006914,-92.01609055950541
2017-08-09,49.130001,49.400002,48.7635,49.100498,49.100498,71394000,3491920042.3487544,5159650000,15.085629530348914,64.0,-0.11871620843737674,41.613102463796736,6.238392032878212,50.28215384615385,50.047512352492035,-93.76160796712178
2017-08-10,48.814999,48.993,47.734001,47.846001,47.846001,113682000,3398464244.275841,5045968000,15.75375940060819,-40.0,-0.2760713156002197,33.97997756766786,1.7414289046101512,50.25430773076923,49.88443743749262,-98.25857109538985
2017-08-11,48.0,48.519501,47.569,48.399502,48.399502,69360000,3450311099.860422,5115328000,16.514650573977384,-43.99999999999999,-0.3520551936839311,39.27281874189779,12.590038264225171,50.25978857692307,49.77444221990058,-87.40996173577483
2017-08-14,48.920502,49.275002,48.809502,49.165001,49.165001,63458000,3483777935.7014523,5178786000,16.194140779385723,-44.0,-0.3465092498043987,45.75050348097308,24.19466016908047,50.26851938461539,49.72929842583387,-75.80533983091954
2017-08-15,49.445,49.587002,49.099998,49.137001,49.137001,50986000,3440539859.5706606,5127800000,15.511206053090232,-44.0,-0.3404489319522881,45.5590736321811,23.77019271277297,50.242115500000004,49.68542454243877,-76.22980728722703
2017-08-16,49.0825,49.323002,48.660999,48.909,48.909,62642000,3424832023.4400086,5065158000,15.330572140333768,-44.0,-0.35000917372682494,43.946564752726076,32.89552822117179,50.21144238461538,49.62791161336923,-67.10447177882821
2017-08-17,48.891998,48.891998,48.015999,48.0285,48.0285,70248000,3356588980.632882,4994910000,15.766661991334118,-44.0,-0.4237499993481677,38.30771220901599,13.58061580629988,50.123096230769235,49.509436679045585,-86.41938419370013
2017-08-18,48.07,48.2715,47.732498,47.9235,47.9235,65696000,3337453354.7762055,4929214000,16.418308720403548,-44.0,-0.48507115903043285,37.68670225127199,12.886223191566513,50.04201923076923,49.39195988800517,-87.11377680843349
2017-08-21,47.878502,48.060001,47.272999,47.664501,47.664501,63290000,3337131839.1765,4865924000,17.405758603412163,-68.0,-0.5482478150888426,36.13079626283245,13.558506126924376,49.948711576923074,49.26399997037516,-86.44149387307563
2017-08-22,47.776001,48.3965,47.775002,48.345001,48.345001,55000000,3383016942.587935,4920924000,17.827625496877634,-68.0,-0.5372124565581018,42.81145088449887,39.67440402457605,49.865750115384614,49.1959259725696,-60.32559597542395
2017-08-23,47.969002,48.099998,47.709999,47.900002,47.900002,53366000,3381649537.958692,4867558000,18.2793350681485,-68.0,-0.557942936836767,39.874237500925815,24.67544273907914,49.73796173076923,49.09993160423111,-75.32455726092086
2017-08-24,47.870998,47.950001,47.056999,47.622501,47.622501,103914000,3409344593.3202705,4763644000,19.27255712745941,-80.0,-0.5899632739572382,38.11795124346032,20.511498005078025,49.59484646153847,48.99049230021399,-79.48850199492198
2017-08-25,47.799999,47.881001,47.205002,47.263,47.263,66496000,3354258772.944796,4697148000,20.1948347539624,-80.0,-0.6370053469267631,35.91120151695182,7.471926006528842,49.43438488461538,48.86252990760555,-92.52807399347115
2017-08-28,47.327,47.650002,47.112499,47.300999,47.300999,51934000,3338750835.68305,4749082000,21.134076655534304,-80.0,-0.6635710924507237,36.330776737159255,9.644257338825279,49.28121173076923,48.74686095148662,-90.35574266117472
2017-08-29,47.0,47.799999,46.816502,47.702999,47.702999,57486000,3384897417.260828,4806568000,22.271203470845176,-92.0,-0.6447542709387193,40.75008221341088,31.99772604223061,49.11796176923077,48.66953784396909,-68.00227395776939
2017-08-30,47.922001,48.470501,47.845501,48.379501,48.379501,58092000,3426073026.860828,4864660000,22.156894388159987,-92.0,-0.5686981484328584,47.37044628611638,56.415773326114376,48.9789618076923,48.64805363330471,-43.584226673885624
2017-08-31,48.735001,49.049999,48.638,49.029999,49.029999,66630000,3486234079.1206627,4931290000,21.187777782805572,-92.0,-0.45073754933643784,52.828472587773106,79.89521746977073,48.840115653846155,48.676345882689546,-20.104782530229272
2017-09-01,49.209999,49.224998,48.844002,48.912498,48.912498,50718000,3453752386.73544,4880572000,20.04329634785888,-88.0,-0.3625549654365443,51.78380015323884,75.65406966251582,48.709827153846156,48.69383863211995,-24.345930337484184
2017-09-05,48.77,48.838501,48.018501,48.2635,48.2635,57664000,3430546002.1890984,4822908000,19.915866829968458,-84.0,-0.3411062861367853,46.33380038941475,57.72982246159981,48.60450026923077,48.66196169640736,-42.27017753840019
2017-09-06,48.416,48.591999,48.029999,48.389999,48.389999,42598000,3442521952.367035,4865506000,19.797539420498783,-80.0,-0.31032342587473494,47.49375747724329,65.3311028957492,48.56607715384616,48.6418163114883,-34.6688971042508
2017-09-07,48.700001,49.029499,48.627499,48.973499,48.973499,51336000,3479555385.2028546,4916842000,19.026860528343608,-76.0,-0.236122342468569,52.58469832306408,89.55784024553071,48.53392319230769,48.6663853995262,-10.442159754469289
2017-09-08,48.955002,48.993999,48.1735,48.294998,48.294998,52106000,3442880908.6733284,4864736000,18.833750266286433,-72.0,-0.2294221735039912,46.89127510352131,61.38669111345836,48.476250115384616,48.63887522178352,-38.61330888654164
2017-09-11,48.723,49.097,48.710999,48.897999,48.897999,43734000,3441521192.6777735,4908470000,18.494370939184016,-60.0,-0.1734556117966548,51.877943441276386,86.42310387893521,48.459019269230765,48.658069575725484,-13.576896121064797
2017-09-12,49.163502,49.233501,48.776001,49.129002,49.129002,49622000,3468474561.517118,4958092000,17.9611900555784,-60.0,-0.10920287414221974,53.67254214854215,95.67649800434351,48.449403884615386,48.692953459005075,-4.323501995656479
2017-09-13,49.198502,50.0,48.971001,49.98,49.98,67494000,3533344885.497996,5025586000,16.994957385166803,40.0,0.010267947372128106,59.643359427973024,99.37176024611912,48.463500076923076,48.78829023981952,-0.6282397538808921
2017-09-14,49.84,49.928001,49.387001,49.6105,49.6105,78266000,3519745697.82332,4947320000,16.097741334070317,39.99999999999999,0.074277645739528,56.253251473583234,87.76503079317159,48.468057730769225,48.84919466649956,-12.234969206828406
2017-09-15,49.650501,49.8125,49.2015,49.3395,49.3395,75204000,3478512735.4665275,4872116000,14.98397856171509,40.0,0.10196299180243074,53.83630939540419,79.25238212808681,48.477250115384614,48.88551358009218,-20.74761787191319
2017-09-18,49.52,49.6395,48.408501,48.709499,48.709499,68226000,3443651327.2298026,4803890000,14.937424913573109,40.0,0.07223532855482517,48.60776395007384,59.4627984688541,48.51046157692308,48.87247546304831,-40.5372015311459
2017-09-19,48.862499,48.911999,48.373001,48.493,48.493,53422000,3414016378.677118,4750468000,14.937439592673371,40.0,0.030850654175011982,46.92130779639286,30.053344188138542,48.51405765384615,48.84436616948918,-69.94665581186146
2017-09-20,48.5895,48.740501,48.108002,48.6605,48.6605,57776000,3457176900.1514597,4808244000,15.26407112663727,40.0,0.011437012946679204,48.41257965537598,32.39966308335248,48.494653769230766,48.83074645323072,-67.60033691664752
2017-09-21,48.565498,48.584999,48.101002,48.232498,48.232498,46752000,3435828780.720967,4761492000,15.57615028565907,40.0,-0.038046050841302304,44.93826921897383,10.799753116201378,48.45986519230769,48.786431752991405,-89.20024688379863
2017-09-22,48.050499,48.280499,47.721001,47.755001,47.755001,52836000,3389414337.1876564,4708656000,16.336365204503792,40.0,-0.1144721885573432,41.37115077544812,1.4918830591851482,48.41548061538462,48.71002947499204,-98.50811694081486
2017-09-25,47.4655,47.471001,46.644501,46.989498,46.989498,102480000,3372488584.156803,4606176000,18.09632519464031,-32.0,-0.23411145669888356,36.38480720204208,10.281540837890256,48.37551899999999,48.582582699066705,-89.71845916210974
2017-09-26,47.274502,47.431499,46.587502,46.93,46.93,71296000,3359057096.4903774,4534880000,19.778113741053556,-36.0,-0.3299242684143522,36.021406784908805,10.036577310814517,48.33730746153846,48.460169165802505,-89.96342268918548
2017-09-27,47.400002,47.764999,47.165001,47.543499,47.543499,62978000,3375536184.8273377,4597858000,20.668620520462422,-36.0,-0.3522913742493827,42.40872048391204,28.014580521365772,48.33265353846154,48.39226767203935,-71.98541947863423
2017-09-28,47.592999,47.985001,47.505001,47.82,47.82,50452000,3391302224.6106715,4648310000,21.070383665137705,-35.99999999999999,-0.3437436836728409,45.07041031350693,36.11717867673475,48.31246119230769,48.349877474110514,-63.88282132326525
2017-09-29,48.005501,48.241501,47.918999,48.067501,48.067501,50876000,3387279811.5775743,4699186000,20.960946138617665,-36.0,-0.3133857986493638,47.41324696175708,43.369959484225326,48.31890346153846,48.32896069825047,-56.630040515774674
2017-10-02,48.200001,48.365501,47.605999,47.959499,47.959499,48858000,3383902410.707004,4650328000,21.236767237693403,-36.0,-0.29464532692271916,46.481589749067126,40.2050638564477,48.33186492307693,48.30159316504673,-59.7949361435523
2017-10-03,47.900002,48.184502,47.518501,47.855,47.855,53332000,3384462716.178016,4596996000,21.596994917279766,-36.0,-0.28494094221468913,45.54897962598974,37.943373130780635,48.35463415384616,48.268512189858086,-62.056626869219365
2017-10-04,47.710499,48.3895,47.702499,48.272499,48.272499,50548000,3417793371.376481,4647544000,21.51083739661504,-36.0,-0.2407858380449852,49.87603596790807,52.24800139410949,48.39199953846154,48.26880750912786,-47.75199860589051
2017-10-05,48.5,49.0755,48.481998,49.0425,49.0425,64584000,3475195350.0859036,4712128000,20.1935296585598,-36.0,-0.14202280386022892,56.70893944636471,80.43904353803633,48.44351880769231,48.326118064007275,-19.560956461963663
2017-10-06,48.782001,49.787498,48.782001,49.479,49.479,75642000,3504421685.5617924,4787770000,19.551912153700226,-36.0,-0.028205351962085956,60.034909391340506,90.3594254492818,48.48580723076923,48.411516725932664,-9.640574550718197
2017-10-09,49.661999,49.924999,49.375,49.5495,49.5495,58772000,3482943258.822835,4846542000,19.133744157744918,-36.0,0.06691322547334977,60.56192724888629,88.7490835197755,48.50578803846153,48.49581178327099,-11.25091648022449
2017-10-10,49.8335,49.897499,49.005001,49.360001,49.360001,61698000,3470327251.1634336,4784844000,18.135807109242204,-36.0,0.12555705422791164,58.33514722642247,83.07120575688899,48.52299969230769,48.55982579932499,-16.928794243111017
2017-10-11,49.563499,49.775002,49.334999,49.75,49.75,46742000,3511757271.5451126,4831586000,17.20915127848969,-36.00000000000001,0.20118325562561523,61.47468078383047,94.75657955647601,48.58017276923077,48.64798685122684,-5.243420443523986
2017-10-12,49.8405,50.422001,49.619999,50.046501,50.046501,81346000,3516930336.814276,4912932000,17.24370153725679,48.0,0.28179436776768085,63.713347954514354,90.20732565062602,48.64388438461538,48.7515804918767,-9.792674349373993
2017-10-13,50.349998,50.3885,50.051498,50.146999,50.146999,48630000,3495862271.9363227,4961562000,17.275783920397668,48.0,0.34975682465657343,64.46703435772086,92.82821562869097,48.689019,48.85494482581176,-7.171784371309018
2017-10-16,50.422001,50.4785,50.051998,50.317001,50.317001,40178000,3505612715.573164,5001740000,17.428272711695275,56.0,0.4125793441603207,65.76250351006553,95.12602840682918,48.766788346153845,48.96324528315903,-4.873971593170819
2017-10-17,50.279499,50.573502,50.219002,50.456501,50.456501,46394000,3521382487.680358,5048134000,17.703273626106313,60.0,0.46822571306883987,66.83114244577972,96.18703073585459,48.82673073076923,49.073856817739845,-3.8129692641454214
2017-10-18,50.463501,51.115501,49.827499,49.849998,49.849998,49994000,3473135092.120413,4998140000,18.659478910148316,64.0,0.45810538428698067,58.309698049635976,64.81782040589374,48.85446134615385,49.13134875716652,-35.18217959410626
2017-10-19,49.5,49.552502,49.012001,49.330502,49.330502,62164000,3484233847.0977407,4935976000,17.97406083697047,64.0,0.40351450123239374,52.17326142751576,50.37534056157914,48.829480653846154,49.14610084922826,-49.62465943842086
2017-10-20,49.676498,49.730999,49.099998,49.1455,49.1455,47302000,3443753819.1833634,4888674000,17.585063531784204,64.0,0.3413874162040713,50.14922383091065,45.232110091743046,48.811596038461545,49.14605634187802,-54.767889908256954
2017-10-23,49.336498,49.339001,48.125,48.314999,48.314999,69882000,3395745788.1800942,4818792000,16.905657275495596,64.0,0.22257110267813118,42.229117462905336,17.946077968896514,48.772192153846156,49.08449653877595,-82.05392203110348
2017-10-24,48.450001,48.9925,48.25,48.794998,48.794998,54478000,3421241932.406357,4873270000,16.274780037513317,64.0,0.16523549404466564,47.39970434451805,22.404205850457807,48.77548057692308,49.063052202570326,-77.59579414954219
2017-10-25,48.900002,49.222,48.312,48.6455,48.6455,60662000,3405043178.560203,4812608000,15.321517519842105,64.0,0.10650564119457329,46.018237233557656,17.405110381170182,48.78134596153846,49.03212240978734,-82.59488961882982
2017-10-26,49.016499,49.145,48.427502,48.621498,48.621498,112374000,3353436195.3435264,4700234000,14.436345182004553,64.0,0.05736379475995079,45.78750481063177,16.602502390067826,48.77984588461538,49.00170578684013,-83.39749760993217
2017-10-27,52.907001,55.278999,52.5275,55.047501,55.047501,331300000,3628988192.2368555,5031534000,17.578082774901535,92.0,0.5308242535959593,77.83290219156993,96.76407558905164,49.041961384615384,49.44954246929642,-3.2359244109483662
2017-10-30,54.7505,56.1395,54.678001,55.5425,55.5425,132262000,3653196181.9364715,5163796000,20.740752332684373,96.0,0.9352068779991498,78.8690765082962,92.55100131012537,49.341480576923075,49.900872656755936,-7.44899868987462
2017-10-31,55.450001,55.527,55.056,55.264,55.264,69540000,3645075799.7708673,5094256000,23.67751692205415,96.0,1.2191567190215977,76.69684044005201,89.07604965999133,49.65973065384616,50.29814134884809,-10.923950340008679
2017-11-01,55.27,55.448502,54.837002,55.183998,55.183998,75110000,3655208218.6097894,5019146000,26.12933230804114,92.0,1.4213490933950652,76.0488727159096,88.07783392600916,49.97719211538462,50.66005665634083,-11.922166073990839
2017-11-02,54.890499,55.097,54.343498,54.710999,54.710999,73698000,3653398783.465623,4945448000,27.789704359044546,88.0,1.5258320978939892,72.1668530616593,82.17604342129893,50.25286519230769,50.960126459574845,-17.823956578701072
2017-11-03,54.557499,55.633999,54.425999,55.580002,55.580002,75030000,3721721175.9987354,5020478000,29.548965932907063,76.0,1.6596257783658643,74.72006378292593,93.01892819265085,50.55132680769231,51.3023394625693,-6.981071807349154
2017-11-06,55.4575,56.2705,55.438499,56.033001,56.033001,67622000,3750737074.85703,5088100000,31.424881961239066,96.0,1.7816734450789724,75.95815540161867,97.08429194033516,50.857692192307695,51.65275883571232,-2.9157080596648424
2017-11-07,56.237,56.529999,55.875,56.158501,56.158501,53780000,3743511905.5666957,5141880000,33.26261000929075,100.0,1.867002261505732,76.30439424722292,95.58003516716664,51.17303842307692,51.98651751454844,-4.41996483283336
2017-11-08,56.140999,56.777,55.955502,56.644001,56.644001,51630000,3778424303.4057655,5193510000,35.061423893989726,100.0,1.9513082884895994,77.64561691978498,98.46279472954232,51.51107692307692,52.33151629124855,-1.5372052704576753
2017-11-09,56.298,56.480999,55.788502,56.456501,56.456501,74654000,3847796334.842726,5118856000,36.488434199525464,48.0,1.9801656225824829,75.85978171246369,96.295665742025,51.82584623076923,52.63707071411903,-3.7043342579750123
2017-11-10,56.305,56.587502,56.202999,56.267502,56.267502,43598000,3818826058.392348,5075258000,37.860244118828014,48.0,1.9651318117141372,74.01192183840827,94.0248856573238,52.10373092307692,52.905991550110215,-5.975114342676212
2017-11-13,56.150002,56.994999,56.117001,56.4585,56.4585,58368000,3805862748.6809363,5133626000,39.31307856119535,60.0,1.9461948281367825,74.68307614060438,93.82127073837047,52.372173230769235,53.16914032417613,-6.178729261629525
2017-11-14,56.505501,56.900002,56.1945,56.841999,56.841999,62768000,3858309779.203883,5196394000,40.662139114822146,60.0,1.93977181447206,76.02207413592014,98.21418087453083,52.65265396153847,53.441203929792714,-1.7858191254691846
2017-11-15,56.350498,56.587502,56.081501,56.334499,56.334499,78574000,3858309002.7824926,5117820000,41.71294983592778,60.0,1.8721495466211024,70.69356894820544,85.21544157032828,52.920903884615385,53.6555220831414,-14.784558429671714
2017-11-16,56.507999,56.908001,56.502499,56.864498,56.864498,44266000,3893077127.072878,5162086000,42.85365498569522,60.0,1.840113222274958,72.83497705133212,95.07822173176619,53.19453842307693,53.8932240029087,-4.9217782682338145
2017-11-17,56.914001,56.939999,56.290501,56.493999,56.493999,48268000,3875055383.301535,5113818000,43.51245859999109,60.0,1.7644881109237005,69.03730870468831,81.1050420120529,53.44251911538462,54.085874002693245,-18.894957987947095
2017-11-20,56.488499,56.671001,56.127499,56.315498,56.315498,43278000,3861717367.779973,5070540000,43.81357500822696,60.0,1.6708901449257212,67.2188378558232,74.37296836772828,53.67976907692308,54.25103133582708,-25.627031632271724
2017-11-21,56.643002,57.0,56.41,56.974499,56.974499,49588000,3907018779.346075,5120128000,44.311680167078926,84.0,1.631086802392531,70.32641949570771,99.0400534236376,53.93582669230769,54.45276968132137,-0.9599465763623898
2017-11-22,57.049999,58.0135,57.049999,57.807999,57.807999,71106000,3947792991.1984763,5191234000,45.34570422876032,88.0,1.6478039921184688,73.71978976182925,94.27175072564445,54.21857661538461,54.70130518640868,-5.728249274355546
2017-11-24,58.035,59.341999,58.035,59.299999,59.299999,70560000,4013818144.576558,5261794000,46.85534933141234,92.0,1.761143055383883,78.46677855399041,98.92404252593823,54.5820381923077,55.04194917260063,-1.0759574740617799
2017-11-27,60.132999,60.670502,59.557499,59.7915,59.7915,134880000,3935653274.5088224,5396674000,48.65789832707241,96.0,1.8690795174250496,79.76355147699954,81.9950430151577,54.984384269230766,55.393767752407996,-18.00495698484228
2017-11-28,60.243999,60.266998,59.425999,59.68,59.68,91188000,3899547012.2706985,5305486000,50.1162225448433,96.0,1.923450483213152,78.60703588500107,79.7111429741909,55.38955734615384,55.711266437414814,-20.28885702580909
2017-11-29,59.740002,59.740002,57.259499,58.063499,58.063499,185150000,3834421539.5540767,5120336000,48.605410404298375,92.0,1.8151775078823107,64.09694497178023,46.599692748873416,55.76449965384616,55.885505886495196,-53.400307251126584
2017-11-30,58.355,58.928501,58.0,58.837502,58.837502,90184000,3906928329.0481114,5210520000,47.2025134166495,88.0,1.7714062991999455,67.21730506759273,60.0566659279438,56.1507498076923,56.10417226527333,-39.9433340720562
2017-12-01,58.602501,58.982498,57.599998,58.1175,58.1175,82142000,3886281662.5511856,5128378000,45.454508364425216,84.0,1.6594895938311396,61.833687523250035,44.366933020934155,56.515057500000005,56.25330765303086,-55.633066979065845
2017-12-04,58.692501,58.759998,56.400002,56.697498,56.697498,118638000,3797554162.7791524,5009740000,42.647160976212,80.0,1.439617490264915,52.84428077859467,13.423335492844753,56.825672884615386,56.28621064169524,-86.57666450715526
2017-12-05,56.412998,57.963501,56.237,57.078499,57.078499,81596000,3795498171.622472,5091336000,39.89341226926269,64.0,1.2813403664991867,54.74532062405015,21.72581788498191,56.903788192307694,56.34489866823633,-78.27418211501809
2017-12-06,56.899502,57.794498,56.804001,57.6175,57.6175,57066000,3832169222.6867356,5148402000,37.336359898524044,64.0,1.1857291343009706,57.363994949878446,32.79771111751412,56.98359588461539,56.43916543355216,-67.20228888248587
2017-12-07,57.829498,58.1595,57.549999,57.989498,57.989498,50232000,3854379806.9253173,5198634000,35.290173005258275,64.0,1.1269825206493636,59.122090183755596,40.986083434239376,57.088422730769224,56.554004882918676,-59.013916565760624
2017-12-08,58.52,58.6395,57.855,58.099998,58.099998,61002000,3831479446.1757956,5259636000,33.80457973288585,64.0,1.076927680658514,59.65428381996491,43.41839527730885,57.200576576923076,56.668522891591365,-56.58160472269115
2017-12-11,58.23,58.494999,57.849998,58.445999,58.445999,47270000,3871567348.7836986,5306906000,32.41927264097891,60.0,1.053039464931686,61.35103673489494,49.825149509349494,57.34423042307693,56.80018778851052,-50.174850490650506
2017-12-12,58.3255,58.68,58.080502,58.254002,58.254002,44718000,3852732914.7005153,5262188000,31.30164853020558,56.00000000000001,1.007007176656451,59.846976728753184,45.494554868814745,57.447076576923074,56.907877730102335,-54.505445131185255
2017-12-13,58.5,58.543499,58.0135,58.206501,58.206501,52336000,3838513591.660284,5209852000,30.175023401907264,44.0,0.9556768747125375,59.45860201667066,44.42314450292348,57.530672730769226,57.00407204639105,-55.57685549707652
2017-12-14,58.185501,58.8965,58.122501,58.713001,58.713001,64286000,3872317855.3427944,5274138000,29.47268733461603,44.0,0.9449744800304032,62.270208366058114,55.847521891272365,57.62892273076923,57.130659376288015,-44.152478108727635
2017-12-15,58.9515,59.137501,58.466499,58.957001,58.957001,95572000,3916471987.7358418,5369710000,29.04931420117695,44.0,0.9452848604927766,63.58054911966428,67.49385483565989,57.717884269230765,57.26594394100742,-32.506145164340104
2017-12-18,59.3685,59.738998,59.045502,59.528999,59.528999,58952000,3939721226.514436,5428662000,29.188844436579586,28.0,0.980385029111531,66.5163214500906,93.97650929117374,57.83605726923077,57.433577649080945,-6.023490708826269
2017-12-19,59.4575,59.648499,58.957001,59.368999,59.368999,51756000,3949638198.780444,5376906000,29.175989276140786,28.0,0.9839491494924744,64.939409407056,89.43463131618009,57.95534561538462,57.57694219359347,-10.56536868381992
2017-12-20,59.525002,59.549999,58.799999,58.881001,58.881001,47424000,3912458035.708444,5329482000,28.903676555444697,28.0,0.9365998403950115,60.24798707601093,75.49978612209361,58.04851873076923,57.67353914221617,-24.500213877906397
2017-12-21,58.794998,58.9585,58.382,58.737999,58.737999,42462000,3922438115.632122,5287020000,27.97973264544239,28.000000000000004,0.8774217339466261,58.905044516367454,71.4163457546235,58.12144180769231,57.75238802057053,-28.5836542453765
2017-12-22,58.604,58.730999,58.391499,58.417999,58.417999,31702000,3895685176.015038,5255318000,27.121784729011672,16.0,0.7955309470261369,55.90217703151649,62.27870489931747,58.20157642307693,57.8016925375653,-37.72129510068253
2017-12-26,58.417999,58.916,58.0275,58.838001,58.838001,40104000,3928747933.705528,5295422000,25.7422751371296,16.0,0.7558100518943931,58.8661173030704,69.30160405615396,58.27748038461539,57.87845612737528,-30.69839594384604
2017-12-27,58.995499,59.364498,58.780499,59.112999,59.112999,37344000,3933927568.1638064,5332766000,25.023620092136333,16.0,0.7380136348892563,60.72736919851564,71.40249949862931,58.37821115384615,57.9699037475697,-28.597500501370693
2017-12-28,59.450001,59.505001,59.219002,59.305,59.305,36834000,3919245046.539604,5369600000,24.524949671562517,-24.0,0.730976480427799,62.01955261359956,77.02498676548429,58.49319200000001,58.06879976626824,-22.975013234515718
2017-12-29,59.1175,59.200001,58.375,58.473499,58.473499,53768000,3878316047.2971787,5315832000,22.777565850101986,-24.0,0.6508022599189403,53.76855433938067,33.006934886182975,58.55084584615385,58.0987774872854,-66.99306511381702
2018-01-02,58.599998,59.5,58.525501,59.4505,59.4505,53890000,3926731326.440615,5369722000,21.542528519870775,-24.000000000000004,0.6585085514300175,60.42989948476482,83.28030516407415,58.61401896153846,58.19890508081981,-16.71969483592585
2018-01-03,59.415001,60.274502,59.415001,60.209999,60.209999,62176000,3979575077.780056,5431898000,21.29748245772734,-24.0,0.7176286880676912,64.6892929273807,97.14714980349443,58.64901896153845,58.34787500075909,-2.852850196505573
2018-01-04,60.25,60.793499,60.233002,60.4795,60.4795,60442000,3972296010.3773766,5492340000,21.58420438749147,80.0,0.7772684340024156,66.08437046232797,88.64789900502508,58.675480500000006,58.50577314885101,-11.352100994974915
2018-01-05,60.8755,61.457001,60.5,61.457001,61.457001,70894000,4043190010.3773766,5563234000,22.42649208871088,84.0,0.8931142584925666,70.61862195937655,99.99999999999999,58.74382669230769,58.72438261930649,-0.0
2018-01-08,61.799999,62.653999,61.601501,62.343498,62.343498,85590000,4078279618.7566795,5648824000,24.033821472997925,88.0,1.044416425731363,74.01193834305994,93.28864007103422,58.90844203846154,58.9924652400986,-6.711359928965778
2018-01-09,62.845001,62.966499,62.088001,62.634998,62.634998,73226000,4096241993.282291,5722050000,25.709203372269656,92.0,1.1743093895141072,75.0330283664185,93.28809339706292,59.05449957692308,59.26228248157278,-6.711906602937075
2018-01-10,62.2575,62.716499,61.8615,62.716499,62.716499,53720000,4149961993.282291,5775770000,26.896034196521153,92.0,1.2691964421699495,75.32494399923887,94.93824558377112,59.23138415384616,59.51815037182665,-5.06175441622888
2018-01-11,62.987,63.838501,62.823002,63.834,63.834,62500000,4211907955.3167195,5838270000,28.646498666618783,100.0,1.4182197518898292,78.95782933388055,99.922543465403,59.505865,59.83784293687653,-0.07745653459701088
2018-01-12,63.669498,65.288002,63.669498,65.260002,65.260002,108874000,4317014930.95348,5947144000,30.895502565819815,100.0,1.6325690030733284,82.49877246639954,99.61435173490752,59.820538192307694,60.23948434895974,-0.38564826509249345
2018-01-16,66.150002,66.997002,64.614998,65.242996,65.242996,144414000,4248748328.835264,5802730000,33.51275806295923,100.0,1.780545071629362,82.32086054967111,80.44477831656661,60.1138265,60.61011484162939,-19.555221683433388
2018-01-17,65.612,65.699997,64.043999,64.75,64.75,105076000,4233266351.3836007,5697654000,35.19343938449302,92.0,1.8368623097102486,77.12812473033009,73.93874415709952,60.37384580769231,60.916773001508695,-26.06125584290048
2018-01-18,64.697502,65.230003,64.200996,64.666,64.666,80538000,4225517928.426322,5617116000,36.75407204020296,92.0,1.8533517434236515,76.24561044031938,72.9644924693824,60.62638434615384,61.194493519915454,-27.035507530617593
2018-01-19,65.599998,65.650002,64.649498,64.728996,64.728996,91570000,4148499857.97383,5708686000,38.35888092929622,84.0,1.8501753197697823,76.46311895279504,73.69513484223269,60.86803807692308,61.45630851844023,-26.304865157767317
2018-01-22,64.858498,66.372498,64.833,66.365501,66.365501,82802000,4230549189.7741966,5791488000,40.09927095331487,84.0,1.9571494571376036,81.26292091852366,92.54558312629604,61.18001880769231,61.81995240596318,-7.454416873703968
2018-01-23,66.904503,68.245003,66.866997,68.126999,68.126999,103386000,4316228501.205352,5894874000,42.23026001129056,72.0,2.1591757646806258,84.84529807409137,98.66360166169838,61.56157642307692,62.2871410425585,-1.336398338301612
2018-01-24,68.740997,69.407997,66.900002,67.875504,67.875504,136150000,4285991469.3731523,5758724000,44.455019181675326,76.0,2.272790213443038,82.42233814648239,83.29706991665948,61.913980384615385,62.70109385422084,-16.702930083340522
2018-01-25,68.400002,68.917,67.880997,68.897499,68.897499,95060000,4377472782.709117,5853784000,46.520866982746895,76.0,2.4174303061948663,84.3750620893209,94.26921674984848,62.29630723076923,63.16008682798226,-5.730783250151506
2018-01-26,69.600502,70.126503,69.045502,70.102501,70.102501,97146000,4470304821.312227,5950930000,48.669975957769466,84.0,2.5993287685366724,86.3066447611789,99.71845167895566,62.70298038461538,63.6743397296132,-0.2815483210443336
2018-01-29,70.459,71.569504,70.022003,70.884003,70.884003,114038000,4483311335.015289,6064968000,50.890992039442935,88.0,2.7745618684507747,87.39498659223865,92.93880595846491,63.145865153846145,64.20838886075296,-7.0611940415350904
2018-01-30,70.158501,71.962502,69.599998,71.890999,71.890999,117438000,4593640632.2880125,6182406000,52.43001738404496,92.0,2.9605639852672283,88.64710241066322,99.29211973227996,63.64624969230769,64.77747109328978,-0.7078802677200438
2018-01-31,72.565002,73.628998,72.501999,72.544502,72.544502,128494000,4474838531.716494,6310900000,54.14995409483673,96.0,3.124684812000723,89.38409439107518,89.96394224095583,64.17726903846155,65.35280671600906,-10.036057759044166
2018-02-01,72.25,72.994003,69.257004,69.5,69.5,182276000,4316267295.296041,6128624000,52.76510541391895,96.0,2.9747943051736883,67.42439229939154,58.54211556805064,64.60349984615385,65.6600062185269,-41.45788443194936
2018-02-02,73.869499,74.900002,70.699997,71.497498,71.497498,222514000,4178255641.1332474,6351138000,52.085596192620855,92.0,2.9828025028998013,72.2427346089273,68.65785685578747,65.09040357692308,66.09241301715454,-31.342143144212535
2018-02-05,70.130997,72.948997,66.036003,69.5,69.5,229900000,4178754484.3262258,6121238000,48.84163515968297,92.0,2.795740110771831,62.31633586556193,50.2579172094923,65.48990361538462,66.34482686773569,-49.7420827905077
2018-02-06,68.072998,72.199501,67.5895,72.141998,72.141998,221336000,4394568800.48798,6342574000,45.82938562909779,92.0,2.828078645591546,68.48446002486332,74.22186696595926,65.98363430769231,66.77424695160713,-25.778133034040735
2018-02-07,72.449997,73.0495,70.7575,70.838997,70.838997,143254000,4261502209.9452243,6199320000,43.3736915118476,88.0,2.717243188306796,63.0069243950422,60.382387051407505,66.45923038461538,67.07533954778438,-39.617612948592495
2018-02-08,71.484001,71.6875,67.497002,67.525002,67.525002,171572000,4092223023.8303523,6027748000,40.84776544322384,84.0,2.3350762837297907,51.6843749264515,26.740850950461734,66.76978815384615,67.10864787757814,-73.25914904953827
2018-02-09,68.6745,69.175003,63.296501,66.980003,66.980003,282830000,4163838721.275041,5744918000,39.78362725683962,80.0,1.9655715091041657,50.09019545444972,31.744746693260915,67.03017292307692,67.09911862738716,-68.25525330673909
2018-02-12,68.233498,69.690498,67.2005,69.311501,69.311501,134778000,4257588208.2674003,5879696000,38.56945663114028,76.0,1.8396622354333232,56.30006855113989,51.83780309063624,67.36986526923077,67.26299880313626,-48.162196909363765
2018-02-13,69.296501,70.986,69.176498,70.725502,70.725502,118358000,4341868299.225023,5998054000,36.88358760202325,72.0,1.8328483573671832,59.584387833740244,64.02378902712212,67.72634607692308,67.51948052142247,-35.97621097287788
2018-02-14,70.3125,72.602997,70.167999,72.552498,72.552498,119184000,4456108826.732643,6117238000,34.670720202938256,64.0,1.9523659587983673,63.41078678282383,79.76900247606304,68.11899992307693,67.89229663094673,-20.23099752393696
2018-02-15,73.344498,73.446999,71.842003,73.087997,73.087997,113054000,4518587483.10811,6230292000,32.294912983457564,64.0,2.06647378944902,64.47251011812011,84.38398031766448,68.52103834615384,68.27716332495068,-15.616019682335521
2018-02-16,72.8685,73.290001,72.328003,72.434502,72.434502,89452000,4448941238.521323,6140840000,30.08880627965406,60.0,2.0801942973439935,62.104152820915914,78.75210249044659,68.8948076923077,68.58511433791729,-21.247897509553415
2018-02-20,72.324501,74.438499,72.324501,73.417503,73.417503,129984000,4453368692.049662,6270824000,28.293585445992495,-19.999999999999993,2.1456540992862614,64.23256998678693,87.22369222875058,69.26340396153847,68.94306905362713,-12.776307771249419
2018-02-21,74.25,75.1745,73.945999,74.146004,74.146004,126088000,4368335978.842266,6396912000,26.908461272978293,28.0,2.2306024102178412,65.76708076762048,91.34116781791285,69.60517326923078,69.32847164224734,-8.658832182087153
2018-02-22,74.767998,75.126999,73.788002,74.266998,74.266998,97162000,4340689010.394988,6494074000,25.54832094389007,28.0,2.28138932721302,66.02777091497758,92.35980740527093,69.95225026923077,69.69428840948828,-7.64019259472908
2018-02-23,74.766998,75.0,74.324997,75.0,75.0,88362000,4429051010.394988,6582436000,24.285333495451,28.0,2.35365400204158,67.6357212257634,98.53089733380182,70.34648103846153,70.08730408285952,-1.469102666198194
2018-02-26,75.459999,76.141998,75.349998,76.097504,76.097504,99100000,4517016274.536402,6681536000,23.598324092449634,40.0,2.470999533579146,69.93059621341762,99.65362181003972,70.78615426923076,70.53250407672178,-0.3463781899602658
2018-02-27,76.224998,76.338997,75.360497,75.598999,75.598999,96176000,4467724624.770435,6585360000,23.042837202103353,43.99999999999999,2.4950105963669387,67.5863658633553,94.32625472915615,71.20423130769231,70.90779999696461,-5.67374527084386
2018-02-28,75.975502,76.434998,75.599998,75.622498,75.622498,90300000,4382291091.836302,6675660000,22.56941197341222,48.0,2.4872640775098915,67.64143228927068,93.8158832018609,71.56026965384615,71.25703688607834,-6.184116798139089
2018-03-01,75.68,75.9245,73.25,74.672501,74.672501,136704000,4391006106.010166,6538956000,21.087881705146,48.0,2.377066741339732,62.982997449316194,86.58524639462186,71.81201973076924,71.51003422785031,-13.414753605378127
2018-03-02,73.455002,75.052498,72.750504,75.012497,75.012497,131752000,4518179282.822964,6670708000,19.954997134682653,48.0,2.290762905407675,63.94016340146367,84.59579502859822,72.08651946153846,71.7694759146762,-15.40420497140179
2018-03-05,74.711998,76.268997,74.050003,76.180496,76.180496,104678000,4614507456.119513,6775386000,18.782054120373697,48.0,2.290214089159946,67.08853875908576,96.49373837569763,72.36663473076923,72.09621814321872,-3.5062616243023776
2018-03-06,76.660004,77.106499,76.400002,76.882004,76.882004,91234000,4647760808.416832,6866620000,18.093510981355315,64.0,2.3196455511976666,68.84778457969998,96.76450241406637,72.62738484615384,72.45072079927658,-3.2354975859336226
2018-03-07,76.325996,77.294998,76.125504,77.25,77.25,83482000,4724818623.194846,6950102000,17.297378822995743,68.0,2.345625488108155,69.76093612551686,99.17480210416466,72.87223088461539,72.80622296229313,-0.8251978958353482
2018-03-08,77.5,77.744003,77.262497,77.593002,77.593002,77252000,4753617938.277107,7027354000,16.78550616063912,72.0,2.366611347646483,70.6252400504329,97.21374768382765,73.0915386923077,73.16079918730846,-2.786252316172366
2018-03-09,78.175003,78.946999,77.954002,78.944504,78.944504,90686000,4843848223.768401,7118040000,16.886925236485116,76.0,2.463895455858591,73.80256503267952,99.9623253944356,73.33769261538461,73.58922176602636,-0.03767460556440103
2018-03-12,79.629997,80.266502,79.334999,79.919502,79.919502,103484000,4870233281.5213,7221524000,17.54164965048213,80.0,2.589814236299901,75.8333997755217,95.38318131537544,73.73844269230769,74.05813141298736,-4.6168186846245645
2018-03-13,80.797997,80.876999,78.900497,79.408997,79.408997,130638000,4806814462.680742,7090886000,18.390591193581436,84.0,2.618230953325991,72.65742689195373,81.93560692524883,74.04273111538461,74.45449182684015,-18.06439307475117
2018-03-14,79.849998,80.321999,79.544502,79.550003,79.550003,85188000,4722831918.619481,7176074000,19.17889405503079,84.0,2.621905715060663,72.9938617768065,83.6707461211753,74.4292696923077,74.83193709892608,-16.3292538788247
2018-03-15,79.75,79.845497,78.905502,79.115997,79.115997,81394000,4677891367.903785,7094680000,19.425749449542597,84.0,2.5602839732281666,70.13344298094258,78.33011648933511,74.69750042307692,75.149274869376,-21.66988351066489
2018-03-16,79.172501,79.472,78.375,78.584,78.584,108500000,4610734120.866411,6986180000,19.26240428610674,84.0,2.440389298308361,66.68389360798147,71.78366565167397,74.99538515384616,75.40369895312594,-28.216334348326026
2018-03-19,77.726501,78.083,76.267502,77.246498,77.246498,131616000,4621064338.968553,6854564000,18.008444579509813,84.0,2.2119487034474474,58.84719869539481,55.32513094513688,75.36928884615385,75.54020258622772,-44.67486905486312
2018-03-20,77.516998,79.349998,77.2705,79.3255,79.3255,91632000,4710537355.660082,6946196000,17.28552916893202,80.0,2.1736099501695634,65.61211731709847,80.90814059443838,75.84411565384616,75.82059498724789,-19.091859405561614
2018-03-21,79.322502,79.5,78.158501,79.093002,79.093002,95016000,4747899459.581143,6851180000,16.692445644332622,76.0,2.100255132642232,64.33837304111216,78.04715316997054,76.22032723076923,76.062995506711,-21.952846830029443
2018-03-22,78.273499,78.692497,77.120003,77.246002,77.246002,126412000,4641745451.774437,6724768000,15.508091041520073,72.0,1.871509846743109,55.17468289449644,46.814133185371766,76.47111569230769,76.150625617325,-53.185866814628234
2018-03-23,76.9505,77.450996,74.767998,74.778,74.778,160120000,4482819280.647959,6564648000,15.576905427181558,68.0,1.4740880546940218,45.78973713337358,0.16372562387860273,76.55671192307692,76.0489496456713,-99.8362743761214
2018-03-26,76.5,77.849503,74.962502,77.792999,77.792999,112494000,4590909845.404258,6677142000,15.396731016399343,60.0,1.3864317212687354,55.702551653303246,49.5171141730046,76.73767353846155,76.17813848673269,-50.4828858269954
2018-03-27,78.620003,78.7985,74.115997,74.852501,74.852501,139992000,4494956116.375147,6537150000,14.664362694328315,60.0,1.067385674040736,46.72802950558781,10.893414910985237,76.8306735,76.07994311734508,-89.10658508901476
2018-03-28,72.349998,72.794998,69.308502,71.570999,71.570999,274106000,4576602139.427517,6263044000,15.856222081988028,-43.99999999999999,0.543484643602369,39.14783336971923,19.55739799215056,76.7596541153846,75.745947256801,-80.44260200784944
2018-03-29,70.300003,72.773499,68.260002,72.366997,72.366997,251622000,4782900149.517254,6514666000,17.261752966146606,-48.0,0.19032573207827852,41.62171160566138,32.55128775888588,76.69123076923077,75.49565464518611,-67.44871224111412
2018-04-02,70.880997,71.068001,67.75,68.599503,68.599503,209272000,4680787364.849618,6305394000,18.709326140103684,-52.0,-0.38907550894006704,34.477377253078444,6.471418181718447,76.47325019230769,74.98482859739455,-93.52858181828155
2018-04-03,69.569,70.699997,67.766502,69.602501,69.602501,204624000,4732301152.284743,6510018000,20.053501230206685,-52.0,-0.7585772047927293,37.550655626468554,14.735134802349275,76.26565407692307,74.58613766425422,-85.26486519765072
2018-04-04,67.912003,70.769501,67.643997,70.528503,70.528503,139646000,4850411805.212399,6649664000,21.339788185807603,-60.0,-0.9655589755628569,40.333186628856,23.640585173954044,76.05146173076923,74.28557213356873,-76.35941482604595
2018-04-05,72.099503,72.977997,71.3535,72.587502,72.587502,128270000,4917014970.924616,6777934000,21.131172988622048,-60.0,-0.9524700270145132,46.085548682748865,41.69621920642228,75.93563492307693,74.1597891607118,-58.30378079357772
2018-04-06,71.498497,72.625,70.013,70.261497,70.261497,117646000,4821753869.900114,6660288000,21.43326976206836,-60.0,-1.1169110499237576,41.24769983202319,22.077423563405024,75.72944257692308,73.87102677843684,-77.92257643659497
2018-04-09,71.251503,71.924004,70.128502,70.304001,70.304001,84164000,4754042870.605209,6744452000,21.71378819455422,-60.0,-1.2296276456512487,41.36882098683567,22.435925496982417,75.56142334615384,73.60680264670079,-77.56407450301758
2018-04-10,71.599503,71.918999,70.785004,71.810997,71.810997,85082000,4822918403.797154,6829534000,21.97426959614823,-60.0,-1.1837093130086629,45.6472436122213,35.14675224019428,75.43828873076924,73.47378000620442,-64.85324775980573
2018-04-11,71.972,72.439003,71.244499,71.352501,71.352501,71650000,4764224983.766748,6757884000,21.861626985404886,-60.0,-1.1708190260321771,44.58134389793141,33.246698665104155,75.2525966153846,73.31664822796705,-66.75330133489584
2018-04-12,71.974998,72.606003,71.752998,72.425003,72.425003,62700000,4800316230.007978,6820584000,21.640863382858406,-60.0,-1.0618214162810062,47.66014441454861,42.86166761531197,75.0811735,73.25060043330282,-57.13833238468802
2018-04-13,72.457001,72.988998,71.225998,71.539497,71.539497,73706000,4752823227.505425,6746878000,21.690530056600632,-60.0,-1.0349625548944204,45.41668078678704,34.923115803545855,74.86153876923078,73.12385203083595,-65.07688419645415
2018-04-16,72.25,72.349998,71.374001,72.074997,72.074997,56172000,4777340711.821463,6803050000,21.736649110789845,-60.0,-0.9594068936383167,47.04021898087734,39.72386757168827,74.64930780769231,73.04615906558884,-60.276132428311726
2018-04-17,73.114998,75.359497,72.850998,75.191498,75.191498,102288000,4865927863.85461,6905338000,20.556643291624503,-60.0,-0.6406676844645887,55.361733380086356,97.82257792754834,74.50496142307692,73.20507306073041,-2.177422072451672
2018-04-18,75.732498,76.690002,75.205498,76.391998,76.391998,104550000,4928502472.478096,7009888000,20.116591108064842,-60.0,-0.2878757948331412,58.09334388240515,96.70568389029184,74.36928819230769,73.44114157475038,-3.29431610970816
2018-04-19,77.161003,78.426003,76.953003,77.845497,77.845497,130474000,4956137450.28665,7140362000,20.44038176615319,-56.00000000000001,0.10775738131495416,61.18999584750372,94.61597405900164,74.30915357692308,73.76739012476887,-5.384025940998363
2018-04-20,78.059998,78.059998,75.804497,76.374496,76.374496,110832000,4901323274.413528,7029530000,20.040955792990726,-52.0,0.29915358050432417,56.62927680800383,80.97286349126497,74.18701869230769,73.96050907848968,-19.027136508735033
2018-04-23,77.334503,77.400002,75.170502,75.892998,75.892998,89308000,4869897914.259234,6940222000,19.30372078009363,-36.0,0.40728861313981213,55.1795139523699,76.5071082319933,74.0630571923077,74.10365640600897,-23.49289176800671
2018-04-24,76.790001,76.974998,72.422501,73.004501,73.004501,149894000,4758329390.585743,6790328000,18.58247677695184,-36.0,0.2569469137728504,47.3484025675147,35.5580641062413,73.84846107692307,74.02223748704535,-64.4419358937587
2018-04-25,72.900002,73.499496,70.750999,73.008499,73.008499,131746000,4843004652.824705,6922074000,18.571141257787026,-36.0,0.13654859188963542,47.35953835084154,35.60558578191401,73.68546111538461,73.94714574726422,-64.394414218086
2018-04-26,74.250504,76.471001,73.925003,75.898003,75.898003,176022000,4939796226.126805,7098096000,17.30517652122805,-36.0,0.2711650566034933,54.80019074038837,69.53299553684907,73.5536343076923,74.0916536919113,-30.467004463150925
2018-04-27,81.7005,81.904999,78.369499,78.630997,78.630997,261064000,4717350647.211233,7359160000,17.84851654735426,68.0,0.5915602120732899,60.488863021797826,70.64728348574496,73.53586488461539,74.42790134436231,-29.35271651425504
2018-04-30,79.125,79.800003,78.046997,78.306503,78.306503,109282000,4640423738.62792,7249878000,18.21675824513569,68.0,0.8099550693550412,59.53085507893546,67.73806706114404,73.57665338461538,74.71520517070586,-32.26193293885596
2018-05-01,78.161003,79.25,77.609001,79.112999,79.112999,91442000,4716597422.8739195,7341320000,18.36669742803249,68.0,1.0361677573181822,61.176618037469325,74.9686211224673,73.74338411538461,75.0409676765795,-25.031378877532713
2018-05-02,79.049004,79.425003,78.318001,78.484001,78.484001,87206000,4655545297.93467,7254114000,18.558947722048668,68.0,1.1514152620492126,59.156046968344526,69.329406490945,73.76996111538462,75.29600718201806,-30.670593509054996
2018-05-03,78.000504,78.739998,77.301003,78.603996,78.603996,85038000,4724509109.940966,7339152000,18.261120786475512,68.0,1.2381596003763775,59.43132909479176,70.40520889367039,73.91424938461539,75.54104339075747,-29.594791106329616
2018-05-04,78.122498,79.245003,78.109497,79.047501,79.047501,68872000,4769422878.555134,7408024000,18.159554457111735,68.0,1.3273909241326862,60.49122654460842,74.38140577371342,74.20180715384616,75.8007809914421,-25.61859422628657
2018-05-07,79.467003,80.347504,79.391502,80.007004,80.007004,76038000,4791295847.519633,7484062000,18.439687626541524,68.0,1.4587160931824315,62.75814979298256,82.98372781065083,74.49565357692308,76.11235306615008,-17.016272189349174
2018-05-08,79.75,79.844002,79.125504,79.619499,79.619499,61358000,4814309815.736664,7422704000,18.55928838291813,68.0,1.51407055790024,61.230146724858415,79.50959297113147,74.91949957692307,76.37214165384266,-20.49040702886854
2018-05-09,80.0,80.400002,79.599998,80.400002,80.400002,72746000,4887055815.736664,7495450000,18.87009024969533,68.0,1.6024474227600365,63.17496579000519,86.50710955710954,75.33478807692308,76.67050167948395,-13.492890442890458
2018-05-10,80.424004,80.779999,80.171997,80.454002,80.454002,56350000,4882978610.069577,7551800000,19.29699803657733,60.0,1.6577347394136126,63.312089290924355,86.9912408104716,75.71653803846154,76.95076096248513,-13.008759189528417
2018-05-11,80.5495,80.555,79.894501,80.1455,80.1455,45278000,4872113176.090116,7506522000,19.520673704112443,60.0,1.6575496030092722,61.894119334778566,84.2253989600143,76.00723026923076,77.18740829859735,-15.774601039985688
2018-05-14,80.199997,80.558998,80.002502,80.077003,80.077003,50190000,4835361566.267223,7456332000,19.730037310844285,56.00000000000001,1.6330509508063358,61.56442728262141,83.61129639591181,76.38474973076923,77.4014523505531,-16.388703604088192
2018-05-15,79.389999,79.389999,78.261002,78.806,78.806,101550000,4831853539.629419,7354782000,18.843961565641933,8.0,1.4938560301253432,55.641731396455576,61.165406599201226,76.71174969230769,77.50549291717878,-38.834593400798774
2018-05-16,78.875,79.721497,78.833504,79.363998,79.363998,51412000,4841869405.677912,7406194000,18.18466932903652,8.0,1.4122888412142913,57.57155432433673,44.80879218835109,77.00224973076924,77.64315996035073,-55.19120781164891
2018-05-17,79.028,79.702003,78.650002,79.087997,79.087997,42952000,4834683077.459593,7363242000,17.458864448234092,8.0,1.3102712904581892,56.267595349945495,51.3652214604444,77.2997688076923,77.75018492625068,-48.6347785395556
2018-05-18,79.066498,79.179497,78.605003,78.718498,78.718498,52852000,4802713585.336089,7310390000,16.755449378484926,8.0,1.1859354396896293,54.488306019631516,40.7443699274158,77.54182630769232,77.8219118206025,-59.2556300725842
2018-05-21,79.25,79.602501,78.75,79.273003,79.273003,58504000,4815993119.92901,7368894000,16.347804240353366,7.9999999999999964,1.1192403949030023,56.70110476733226,56.68302004371385,77.83926884615384,77.92940005611341,-43.31697995628615
2018-05-22,79.494499,79.494499,78.762497,79.07,79.07,42312000,4809230386.012982,7326582000,15.969276612088347,8.0,1.0380375946296851,55.63464154420513,50.847917042732846,78.10830742307692,78.01388894084575,-49.152082957267154
2018-05-23,78.552498,80.093002,78.317001,80.093002,80.093002,67238000,4876468386.012982,7393820000,15.983369583055778,8.000000000000004,1.0441946759582237,59.74373956983345,74.27461203923437,78.2968268076923,78.16789731559791,-25.725387960765634
2018-05-24,79.901497,80.412003,79.418999,80.153503,80.153503,68600000,4909352316.389899,7462420000,16.187902697619315,8.0,1.0419452362474289,59.979815844534706,75.12914862542499,78.44150007692306,78.31497921814622,-24.870851374575015
2018-05-25,80.150002,80.706001,80.022499,80.5075,80.5075,53968000,4931973803.964185,7516388000,16.55610790098712,8.0,1.0565479118444188,61.40595190059225,89.18224197964466,78.54388480769231,78.4773881649502,-10.817758020355349
2018-05-29,80.0355,81.0895,80.0075,80.643501,80.643501,76930000,4945482911.043668,7593318000,17.130701040197422,8.0,1.0667974051258966,61.96670671784732,84.2319492536321,78.7080773076923,78.63784096754648,-15.768050746367898
2018-05-30,80.904999,81.300003,80.6465,81.244499,81.244499,58148000,4993753537.590141,7651466000,17.792952071490003,8.0,1.1106132599176561,64.42648025765098,98.17361034102986,78.91390426923076,78.83092674772821,-1.8263896589701394
2018-05-31,81.150002,81.75,81.067497,81.481003,81.481003,63326000,5007161796.504754,7714792000,18.682027151289958,8.0,1.1511517756671026,65.37547788805257,92.29013602186075,79.23992357692308,79.02722869234094,-7.70986397813926
2018-06-01,81.851501,82.336502,81.754501,82.077003,82.077003,66268000,5014335465.972677,7781060000,19.847427053932943,100.0,1.2173383418449504,67.71301359669187,93.63270764323417,79.5887121923077,79.25313790031569,-6.3672923567658355
2018-06-04,82.445,83.283997,82.274498,83.263496,83.263496,63754000,5075500021.596805,7844814000,21.4220563606007,84.0,1.3499701262652621,71.79526784585906,99.59185704942975,79.87200038461539,79.55020146325528,-0.4081429505702456
2018-06-05,83.649498,84.949997,83.502998,84.817497,84.817497,95644000,5153628003.963068,7940458000,23.57840815754944,88.0,1.5624655342724623,76.06396668985553,98.00241097687993,80.1099426923077,79.94037150301415,-1.9975890231200704
2018-06-06,85.225502,85.724998,84.323502,84.787498,84.787498,109464000,5116644921.702397,7830994000,25.847950489450323,92.0,1.708751582890386,75.82538980932247,87.34475729404318,80.35921173076923,80.29941791019829,-12.655242705956828
2018-06-07,84.928001,84.995003,83.805496,84.464996,84.464996,75314000,5124843810.655552,7755680000,27.370418219884407,92.0,1.7781635516606542,73.16843912220284,82.99132680534291,80.56505776923078,80.6079792501836,-17.008673194657085
2018-06-08,84.056,84.472,83.650497,84.199501,84.199501,59102000,5144736615.07623,7696578000,28.608559038789757,92.0,1.7911030878577492,70.96391415454508,79.40742956564368,80.78488469230768,80.87401789831816,-20.59257043435631
2018-06-11,84.0755,84.711998,84.029503,84.456001,84.456001,46710000,5156405714.0586405,7743288000,29.865289652977047,88.0,1.8012910083784703,71.84646526721582,82.86990396999352,81.0099618076923,81.13934997992422,-17.130096030006488
2018-06-12,84.650002,84.975502,84.575996,84.9375,84.9375,45184000,5192993686.12414,7788472000,31.151552501952228,60.0,1.8271556411695968,73.476247097877,89.36962312484738,81.23650023076924,81.42069442585576,-10.63037687515262
2018-06-13,85.140503,85.6875,85.005997,85.242996,85.242996,66550000,5172730447.73781,7855022000,32.65443806131906,60.0,1.8509677193829361,74.48545175947768,92.3564529585242,81.43788453846153,81.70382787579237,-7.643547041475812
2018-06-14,85.674004,86.239998,85.443497,86.193001,86.193001,63488000,5228726315.183048,7918510000,34.27110728723231,84.0,1.9243141314374412,77.36915220508256,99.24593638056514,81.69071153846154,82.03635921832627,-0.7540636194348489
2018-06-15,85.699997,86.043503,85.426003,85.7985,85.7985,95552000,5248454747.066451,7822958000,35.74786165094311,84.0,1.9283795980734624,73.64675447322702,92.91619507940483,81.89834607692306,82.31503631326507,-7.083804920595165
2018-06-18,85.313004,86.336998,85.127998,86.189499,86.189499,62154000,5295443068.247593,7885112000,36.689174282834706,92.0,1.9407797602746513,74.93397407071416,97.40797729829629,82.11894211538461,82.6020335493195,-2.5920227017037263
2018-06-19,85.452003,86.805496,85.019501,86.738998,86.738998,85802000,5374855731.887748,7970914000,37.788388951985425,96.0,1.9722125168678701,76.65943763763619,98.8410942560288,82.3725381923077,82.90847536048102,-1.1589057439711983
2018-06-20,87.125,88.1465,87.068001,87.503998,87.503998,86652000,5358264088.075375,8057566000,39.35618024399074,100.0,2.0353896051746005,78.84294534444365,89.94834010455872,82.65819184615384,83.24888444488984,-10.05165989544128
2018-06-21,88.0,88.154999,85.877998,86.511002,86.511002,98822000,5314386922.344662,7958744000,39.30015120132557,80.0,1.9824786446721987,69.7248941845533,72.04324937620117,82.95453807692307,83.4905227823054,-27.956750623798825
2018-06-22,87.130997,87.150002,85.595001,85.783501,85.783501,81502000,5252644558.512098,7877242000,38.923263073683415,80.0,1.8603975714048175,63.894801132551095,49.02198000387353,83.20144203846154,83.66037302065315,-50.97801999612647
2018-06-25,85.125504,85.25,82.315498,83.157501,83.157501,150224000,5188628752.387583,7727018000,36.49452082991215,80.0,1.5340674134727692,48.221127649924796,14.419091631288211,83.35796142307693,83.62312324134551,-85.58090836871179
2018-06-26,83.6185,85.078499,83.167,84.554497,84.554497,87732000,5228260550.960326,7814750000,34.23926017498169,80.0,1.3723546639422608,54.60131807100088,38.342300138316496,83.58242292307692,83.69211389013473,-61.657699861683504
2018-06-27,85.405502,85.597504,83.0,83.025497,83.025497,97444000,5132729564.120652,7717306000,31.821568237816496,80.0,1.1080457614446715,47.676861197309044,12.158556013604526,83.7267496153846,83.64273486123587,-87.84144398639548
2018-06-28,83.626999,85.275002,83.058502,85.072502,85.072502,90594000,5206770182.6634,7807900000,29.57656858187739,80.0,1.0516326810098633,55.76493899639727,47.21300672780081,83.95761507692308,83.74864353818135,-52.78699327219919
2018-06-29,85.849998,86.170502,84.716003,84.989998,84.989998,90870000,5150135923.836133,7717030000,28.146487454638958,76.0,0.9888684649312012,55.39327596403474,45.800146279622105,84.14596107692306,83.84059572053829,-54.199853720377895
2018-07-02,84.135002,85.694504,83.903,85.689003,85.689003,63714000,5213458642.863275,7780744000,26.172761692789987,68.0,0.9841861478902985,57.950334338026245,57.77043278184207,84.35886492307692,83.97751477827619,-42.22956721815793
2018-07-03,86.197998,86.25,84.624001,84.697998,84.697998,43546000,5173876081.170432,7737198000,24.746825933716348,68.0,0.890247339406514,53.286552929986584,40.79971901708714,84.52003792307693,84.03088390581128,-59.20028098291286
2018-07-05,85.268997,85.5345,84.107498,84.986504,84.986504,59662000,5187715388.066988,7796860000,23.011438443230194,64.0,0.8295180126524713,54.43620342932197,45.74031239998062,84.6870765,84.10167057945489,-54.25968760001938
2018-07-06,84.800003,85.763496,84.583504,85.531502,85.531502,53006000,5219878748.51689,7849866000,21.579428891121637,60.0,0.8159604830001399,56.60866294233048,55.073267390484204,84.85196123076925,84.20758401801379,-44.926732609515796
2018-07-09,86.202499,86.977997,85.811501,86.950996,86.950996,60240000,5277329985.86361,7910106000,21.12279589844646,56.00000000000001,0.9092757804748004,61.727194878600834,79.38174854324025,85.06234557692308,84.41079972038314,-20.618251456759754
2018-07-10,86.926498,87.5,86.550003,87.153503,87.153503,60058000,5293577496.302064,7970164000,21.032541183275274,52.0,0.9881783436760259,62.40847157033291,82.84963047356267,85.25759557692308,84.61396292628069,-17.150369526437334
2018-07-11,86.899498,87.848,86.699997,87.75,87.75,64196000,5346813232.260942,8034360000,21.166538885512328,-8.000000000000007,1.0863191058003423,64.4176599153119,93.06449301061849,85.43015342307693,84.84626196877842,-6.93550698938152
2018-07-12,88.225502,89.900002,88.109001,89.831001,89.831001,90654000,5430482069.601625,8125014000,22.362528459542148,48.0,1.3168360891649797,70.36798347469646,99.09023714668751,85.62298050000001,85.21550189701705,-0.9097628533124925
2018-07-13,90.196503,90.764999,89.761497,90.651497,90.651497,87664000,5498315437.818131,8212678000,23.833077244786402,52.0,1.5478865565969215,72.33253873279689,98.65670173895481,85.84851892307691,85.61816820094171,-1.3432982610452016
2018-07-16,91.097504,92.097504,90.722504,91.124496,91.124496,109324000,5452914890.047949,8322002000,25.682197210949052,56.0,1.7490013837120273,73.42630234018051,89.30467081960055,86.10465353846153,86.02604433420528,-10.69532918039945
2018-07-17,90.578003,92.584503,89.869003,92.196503,92.196503,113658000,5534093196.437197,8435660000,26.590008897966207,60.0,1.9721545686744406,75.7647308031548,95.95179843962705,86.41223053846154,86.48311534648637,-4.048201560372939
2018-07-18,92.400002,92.944,91.563499,92.146004,92.146004,97238000,5518914711.337948,8338422000,27.579009125772195,64.0,2.120486578902245,75.42800641795887,91.92760951446252,86.70799988461539,86.90258858007998,-8.072390485537479
2018-07-19,91.473,92.050003,90.563499,90.648499,90.648499,93538000,5436073931.123432,8244884000,27.590345967921543,64.0,2.093076939292672,66.05302563335985,74.61009844043798,86.9276536923077,87.18006342599998,-25.38990155956202
2018-07-20,91.250504,91.741997,90.502998,90.684998,90.684998,77688000,5381209542.764764,8322572000,27.547434571770275,64.0,2.0506610229114557,66.16341358331232,75.01380378276728,87.13696146153846,87.43968820925924,-24.98619621723272
2018-07-23,90.610497,90.949997,88.499496,90.099998,90.099998,77770000,5405027781.692232,8244802000,25.94034852543387,64.0,1.947393156539718,62.6471494264869,67.81529614320232,87.28723057692308,87.63674819375856,-32.18470385679768
2018-07-24,91.4505,92.0,90.469002,91.461998,91.461998,85574000,5430459334.545991,8330376000,25.050675724582458,64.0,1.9529423420713812,67.03919934436487,83.22863504133186,87.50505742307693,87.92010003125793,-16.771364958668137
2018-07-25,91.464996,93.192001,91.132004,93.180496,93.180496,74764000,5504388226.708455,8405140000,24.830056783200366,84.0,2.07212240091161,71.5799257235007,99.86635297659976,87.77394192307693,88.3097589919055,-0.1336470234002481
2018-07-26,91.949997,92.234001,90.224998,90.400002,90.400002,198488000,5340480756.406022,8206652000,23.977713678162786,84.0,1.9200773712176442,57.72384393540847,62.170598197954,87.91474976923077,88.4645918073199,-37.829401802046
2018-07-27,93.802498,94.002502,90.3265,90.863503,90.863503,193620000,5203430105.856865,8400272000,24.026161151982386,92.0,1.8160469875973888,59.143628294129805,57.87991383829758,88.04396150000001,88.64228893270361,-42.12008616170242
2018-07-30,91.366501,91.474998,88.301003,88.960999,88.960999,131246000,5126766318.5043335,8269026000,22.80017572635148,92.0,1.5620793082641597,51.49855697246133,30.962005503590913,88.13819215384615,88.66589708583668,-69.03799449640908
2018-07-31,89.324501,90.091499,86.966003,88.872002,88.872002,114774000,5151975943.008092,8154252000,21.383636828816766,92.0,1.338200832339112,51.1653729296129,27.08731998682857,88.25698065384616,88.68116411651543,-72.91268001317142
2018-08-01,89.199997,89.921997,88.801003,89.858498,89.858498,83062000,5225627805.33028,8237314000,20.06827928110596,84.0,1.2262421536817243,54.6665385809318,41.10701927194183,88.51471130769231,88.76837403381059,-58.89298072805817
2018-08-02,89.438499,91.828003,89.300003,91.716499,91.716499,87094000,5305038791.583445,8324408000,19.395051894320545,84.0,1.2727675746346847,60.42192802200082,67.51221026251825,88.79017292307692,88.98675366093573,-32.48778973748175
2018-08-03,91.887001,92.050003,91.074997,91.164497,91.164497,69210000,5248534959.545488,8255198000,18.874019097723533,80.0,1.2506802939039972,58.06341748910348,59.66737151529465,89.10321138461539,89.1480679823479,-40.33262848470535
2018-08-06,91.290497,92.388496,90.945999,92.387497,92.387497,67836000,5316277000.023908,8323034000,18.553975104339198,72.0,1.3166839310078302,61.636416510878455,77.04817409907955,89.38455734615384,89.38802568735916,-22.95182590092046
2018-08-07,92.726501,93.486,92.313499,93.124001,93.124001,67550000,5342116106.045993,8390584000,18.767232791010855,72.0,1.4121436930577431,63.645208008413974,87.51508385064791,89.69740361538463,89.66476459940664,-12.484916149352102
2018-08-08,93.050003,94.5755,92.724998,94.325996,94.325996,79260000,5400002784.601325,8469844000,19.42442453695387,96.0,1.5667269403269586,66.70897088440913,96.72114989992109,90.02959565384614,90.0100409994506,-3.278850100078909
2018-08-09,94.099998,95.7285,93.874001,94.926003,94.926003,97208000,5413081185.851473,8567052000,20.474077064991274,100.0,1.7178485392948346,68.15180578125447,90.84168588017772,90.42298046153846,90.37418633282464,-9.15831411982227
2018-08-10,94.425499,94.974998,93.9105,94.315002,94.315002,72798000,5395608675.6053295,8494254000,21.448754412454573,96.0,1.7679312104030487,65.05958161076903,83.86877621755544,90.78176884615385,90.66609860446727,-16.131223782444554
2018-08-13,94.925003,96.25,94.683502,94.809998,94.809998,110630000,5302845602.317012,8604884000,22.818334865152348,100.0,1.82650926656585,66.3900540094472,84.48941765060883,91.13863407692307,90.97305411524748,-15.510582349391184
2018-08-14,95.969498,96.050499,95.0,95.982498,95.982498,79722000,5372246458.323539,8684606000,24.090088142657425,96.0,1.9451215981285657,69.36570194974297,97.11867636320872,91.48599953846154,91.34412403263656,-2.8813236367912793
2018-08-15,95.477501,95.810501,93.489502,94.130997,94.130997,154014000,5303367532.427404,8530592000,24.071369320069753,92.0,1.868186774160577,60.28864539613615,77.1757466099999,91.75436469230769,91.55055906725607,-22.824253390000088
2018-08-16,95.196999,95.25,94.177498,94.325996,94.325996,79142000,5246141442.544123,8609734000,24.053987556238344,36.0,1.8021758006909465,60.86942268853541,79.27612428138444,92.00728761538461,91.75614698820007,-20.723875718615556
2018-08-17,94.290001,94.400002,92.777496,94.111,94.111,82086000,5298985001.31802,8527648000,23.031533139003383,36.0,1.7127695075088525,59.830460010127666,76.96035446801635,92.17190296153845,91.93058054462969,-23.03964553198365
2018-08-20,94.528503,94.587502,93.303001,93.835503,93.835503,57240000,5289203764.651019,8470408000,22.186199092554183,36.0,1.6012261324230792,58.453620384305964,67.58628040795297,92.29436473076923,92.07168591169416,-32.41371959204703
2018-08-21,94.0,94.887497,93.720497,94.170998,94.170998,62112000,5275046380.09575,8532520000,21.572923257747693,36.0,1.5223501418866618,59.670745080623625,70.0862892458802,92.4115378846154,92.22719051082792,-29.913710754119805
2018-08-22,93.832001,95.290001,93.832001,95.245003,95.245003,61610000,5332853462.70206,8594130000,21.2357142161269,36.0,1.528879606373664,63.37022810092173,81.05209633256096,92.52878788461538,92.45073217669253,-18.947903667439036
2018-08-23,95.358498,95.974998,95.038002,95.144997,95.144997,71260000,5277867734.310476,8522870000,21.305814998118127,36.0,1.5085944676512355,62.79261920196665,79.16661403344388,92.64413376923076,92.65030734878938,-20.833385966556126
2018-08-24,95.525497,95.800499,95.126999,95.269501,95.269501,56018000,5245554788.611888,8578888000,21.370908581395692,36.0,1.485441535972413,63.24182410485698,75.09211860990273,92.82186461538461,92.8443216933235,-24.90788139009727
2018-08-27,95.75,96.385002,95.463997,96.384003,96.384003,71380000,5316779939.029097,8650268000,21.764832175510737,76.0,1.539279808463661,67.07393012026708,99.97270494786363,93.04105711538462,93.10652030863287,-0.027295052136366207
2018-08-28,96.886497,97.088997,96.441002,96.640999,96.640999,62014000,5293045907.109096,8712282000,22.507838020479596,80.0,1.5844202463589312,67.9048388455092,89.60923353606988,93.29263407692308,93.36833354503044,-10.390766463930122
2018-08-29,97.672501,99.934502,97.446999,99.904999,99.904999,130636000,5420583093.633897,8842918000,24.35675815225625,84.0,1.8621066834978564,76.14028518749066,99.58777455265523,93.61736488461537,93.8525309861393,-0.4122254473447583
2018-08-30,99.871002,101.278503,99.345001,100.119003,100.119003,145546000,5391564405.311879,8988464000,26.473471481483227,88.0,2.075518237569696,76.56487664218369,86.36043941617747,93.88423053846154,94.31671409827713,-13.63956058382253
2018-08-31,100.349998,101.119003,100.237,100.635498,100.635498,84088000,5383460046.691784,9072552000,28.438991001479703,88.0,2.2602702729528232,77.600890735425,92.43613139008117,94.27790346153847,94.78477216507142,-7.563868609918827
2018-09-04,101.324997,102.525002,100.650002,101.975502,101.975502,114422000,5430815498.4251175,9186974000,30.64632466700672,96.0,2.486155858817625,80.06338131816922,94.36266056158371,94.70528803846153,95.31741881951058,-5.637339438416295
2018-09-05,101.905502,102.018997,99.494499,99.740997,99.740997,164412000,5298510657.294721,9022562000,31.633792223899516,96.0,2.4565483735684808,66.8629205192439,71.43879675478007,95.11990334615385,95.64509127732461,-28.56120324521993
2018-09-06,100.3255,100.375,96.760498,97.915497,97.915497,149774000,5244455968.129796,8872788000,30.568205333039874,92.0,2.2597328409821955,58.39262857135041,52.7109293392587,95.46773007692308,95.81326947900426,-47.2890706607413
2018-09-07,96.935501,98.760002,96.8675,97.6035,97.6035,97852000,5222713871.316159,8774936000,29.57873179152735,88.0,2.054892046608515,57.062130396075304,46.63303549847804,95.76561476923077,95.94587914722618,-53.36696450152196
2018-09-10,98.550003,98.652,96.575996,96.9505,96.9505,90896000,5164612524.490238,8684040000,28.46647772260701,80.0,1.8188955034769236,54.27471767822524,36.68579891771324,95.9669225,96.0202955066909,-63.31420108228676
2018-09-11,96.413498,99.444,95.849998,99.357498,99.357498,100672000,5260438489.711182,8784712000,27.824200343271524,80.0,1.8052810095307734,61.701236407229324,63.562594781710075,96.28203792307694,96.26749569138046,-36.437405218289925
2018-09-12,99.699997,100.0,98.122002,99.5,99.5,88280000,5301710984.910857,8872992000,27.491596995016334,76.0,1.7854090611737519,62.093763346834535,59.596607452918356,96.55559573076924,96.5069404549819,-40.403392547081644
2018-09-13,100.0,100.438004,99.101501,99.4935,99.4935,72430000,5271768712.315884,8800562000,27.388288465116375,72.0,1.7489748103393623,62.06251758028027,59.02269842280407,96.80057646153844,96.7281670879462,-40.97730157719593
2018-09-14,99.6465,99.682503,97.960999,98.509499,98.509499,72840000,5245344799.644174,8727722000,26.4366898687447,44.0,1.6220023139837423,57.35710918781456,43.13128230329821,96.96148042307692,96.8601175999502,-56.86871769670179
2018-09-17,97.736504,97.841003,94.370499,95.401497,95.401497,141004000,5188118165.693602,8586718000,25.529172458374482,44.0,1.2561062975913444,45.59779037830255,12.64329659330569,96.97976865384615,96.75207162958353,-87.35670340669431
2018-09-18,95.932503,97.910004,95.772003,97.052498,97.052498,85374000,5205008832.669904,8672092000,24.64571150436069,44.0,1.0868248112714838,51.30860258251624,32.88979107616985,97.08505696153846,96.77432543479956,-67.11020892383016
2018-09-19,97.025002,97.041496,95.245003,96.320999,96.320999,81136000,5221064429.248349,8590956000,24.071227711946204,44.00000000000001,0.8834582016331609,48.86124755776873,23.919299557557387,97.14317238461538,96.74074569888849,-76.0807004424426
2018-09-20,96.929001,97.75,96.612503,97.214996,97.214996,63098000,5224808105.866397,8654054000,23.085730198466717,44.0,0.7853734880802676,51.88204076520707,34.882530547845796,97.19057615384615,96.77587535082267,-65.1174694521542
2018-09-21,97.710999,97.865501,95.525002,95.750504,95.750504,137118000,5114112149.401558,8516936000,22.698281050187052,44.0,0.5827507924125541,46.985694294650536,16.92322634500239,97.25286488461539,96.6999219174284,-83.07677365499761
2018-09-24,95.189499,96.844002,93.25,96.718002,96.718002,84274000,5192477124.3091955,8601210000,23.258700428861726,44.0,0.49453911013826257,50.321288204098984,39.54844550636748,97.34486511538464,96.70126118280407,-60.45155449363252
2018-09-25,97.144997,98.795502,96.942497,98.727501,98.727501,90768000,5276583172.756988,8691978000,22.601550464582175,-56.0,0.5800935344517058,56.4502654387975,76.20336605266218,97.52242284615384,96.85135302111489,-23.79663394733783
2018-09-26,98.425003,99.762497,98.075996,98.7425,98.7425,86270000,5258500858.480269,8778248000,21.476983727280864,-56.0,0.641709102965649,56.49341058210444,76.4120331596922,97.7111535,96.99143798251379,-23.587966840307796
2018-09-27,99.662003,100.807999,99.429001,100.649002,100.649002,86588000,5325121850.209046,8864836000,19.975745030079022,-56.0,0.8347561141607116,61.68894428864237,97.89630826889498,97.9603075,97.26236865047574,-2.103691731105012
2018-09-28,100.220497,101.325996,99.822998,100.150002,100.150002,81702000,5278971302.4505,8783134000,18.832358063397873,-56.0,0.9366846145082945,59.680071544970225,85.43840289172998,98.1489613076923,97.47626741710717,-14.561597108270018
2018-10-01,101.099503,101.6595,100.18,100.218002,100.218002,69210000,5213316717.685375,8852344000,17.934286919146654,-56.0,1.0112931590597327,59.87184448951357,82.85869552292056,98.34407688461539,97.67935886769182,-17.141304477079455
2018-10-02,99.999496,100.669502,98.288498,98.565498,98.565498,108014000,5130434870.340306,8744330000,17.171485643642736,-56.0,0.9263987576791095,53.24421390566064,63.20825257149662,98.470846,97.74499880341835,-36.79174742850337
2018-10-03,99.084999,99.485001,97.490501,97.638,97.638,105062000,5040912143.278889,8639268000,16.82505863804591,-56.0,0.7753403548005195,49.905067590241615,52.1790831797373,98.51907665384617,97.7370729661281,-47.8209168202627
2018-10-04,97.449997,97.800003,94.828499,95.471001,95.471001,145140000,4958536817.517928,8494128000,17.53079720369246,-56.0,0.4752879496414977,43.103541114378054,26.41061894286227,98.47407673076924,97.56921578345195,-73.58938105713773
2018-10-05,95.899498,96.454002,93.141502,94.482498,94.482498,136446000,4932565407.837023,8357682000,18.71326784922997,-92.0,0.15593282936430342,40.39875055155326,15.743088927703498,98.26551900000001,97.34057002171477,-84.2569110722965
2018-10-08,93.699997,95.099998,91.532997,93.221001,93.221001,147864000,4924648115.705061,8209818000,20.25244152560426,-96.0,-0.19668342531856808,37.1913340282128,16.669169998764694,98.00021123076922,97.03541676084701,-83.3308300012353
2018-10-09,92.999496,94.834,92.615997,93.515999,93.515999,95458000,4906658352.597436,8305276000,21.68167422509467,-96.0,-0.4471757111775787,38.422528935541806,19.58229805491589,97.72638434615384,96.77471914893242,-80.41770194508412
2018-10-10,92.894501,92.928001,87.720497,87.762497,87.762497,219778000,4690425496.681819,8085498000,24.06934654189452,-100.0,-1.097303152107827,27.216762157301105,0.30131279834003616,97.17973030769232,96.10714713790038,-99.69868720165996
2018-10-11,86.199997,87.769997,84.254997,85.968002,85.968002,278718000,4683369134.001875,7806780000,26.797241547229213,-32.0,-1.737307977314046,24.78847465758203,9.84230920009607,96.64999973076922,95.35609934990775,-90.15769079990393
2018-10-12,90.400002,90.447502,87.126503,89.430496,89.430496,188892000,4756570465.409684,7995672000,27.973928458486693,-32.0,-1.9427275300845963,36.55144134685336,29.736551511985173,96.32365353846154,94.91716576843311,-70.26344848801483
2018-10-15,89.75,89.752502,86.711502,88.047501,88.047501,128744000,4740948369.557004,7866928000,29.144203761393708,-32.0,-2.191853817524944,34.24746923122797,21.79036080490202,95.9561151153846,94.40830171151214,-78.20963919509798
2018-10-16,89.175003,91.194,88.077499,90.998001,90.998001,117198000,4843405035.732949,7984126000,29.54129401503706,-31.999999999999993,-2.1266923183112567,42.56524446543177,38.74287016411788,95.72717284615386,94.15568684399273,-61.25712983588211
2018-10-17,92.139503,92.25,90.349998,91.586502,91.586502,105904000,4875343753.389035,8090030000,29.427810196956433,-32.0,-2.004458103049103,44.08461022026806,42.12418475839268,95.42828838461537,93.96537685554881,-57.87581524160732
2018-10-18,91.074501,91.5075,88.393501,88.536003,88.536003,117480000,4768615930.86886,7972550000,29.790259293329466,-32.0,-2.129192377666513,38.41222876486919,24.59711719432605,95.00659619230768,93.56320101439704,-75.40288280567395
2018-10-19,89.258003,90.455002,87.650002,88.2015,88.2015,118144000,4696929100.003976,7854406000,30.294628401378557,-32.0,-2.22933836059849,37.83730216815935,24.042778018587796,94.57228850000001,93.16603797629355,-75.9572219814122
2018-10-22,89.199997,90.474998,87.800003,89.464996,89.464996,90000000,4718966221.568689,7944406000,30.75282655996894,-32.0,-2.181603043971421,41.40479809612162,34.20878287359608,94.22442299999999,92.89188671879032,-65.79121712640392
2018-10-23,87.112,88.817001,85.699997,88.434998,88.434998,134478000,4820482441.966224,7809928000,31.65318005260871,-32.0,-2.2015070888479897,39.41877650571027,30.860089689144395,93.95648073076924,92.56174681369474,-69.1399103108556
2018-10-24,88.684998,88.885498,82.828003,83.209999,83.209999,138568000,4699391112.348288,7671360000,33.03130142097758,-68.0,-2.6088220631661017,31.234170401714195,2.8034348160454194,93.42407692307694,91.86902475342104,-97.19656518395459
2018-10-25,85.167,89.740501,84.600502,89.108498,89.108498,205714000,4854516828.13189,7877074000,33.866917733062316,-68.0,-2.4276777830658745,45.09391182471942,51.177457291988794,93.14667303846153,91.66454129020467,-48.822542708011206
2018-10-26,82.4795,84.922997,80.150002,82.140503,82.140503,299276000,4804857338.216648,7577798000,35.383349913595445,-76.0,-2.8139412356019875,35.891105535408556,13.555579345625043,92.56688484615384,90.95905697241173,-86.44442065437495
2018-10-29,83.0,83.287003,74.75,76.944,76.944,277322000,4670078211.400599,7300476000,37.422829232300096,-80.0,-3.499037442169012,30.836817827982415,12.069533938302694,91.84355776923076,89.92090460408494,-87.9304660616973
2018-10-30,74.307999,77.0495,73.818001,76.521004,76.521004,249202000,4837768652.714059,7051274000,39.40755517255905,-84.0,-4.029661929454633,30.460786525892416,14.664730613320936,91.06675015384614,88.92831937415272,-85.33526938667906
2018-10-31,78.499496,81.195503,78.254501,79.900497,79.900497,187804000,4860181873.092691,7239078000,39.54369892351294,-84.0,-4.129882106906834,37.063975462942665,32.999654568123646,90.34263461538461,88.25959179088214,-67.00034543187635
2018-11-01,81.176498,83.522499,79.921997,83.276497,83.276497,162710000,5000657759.394102,7401788000,38.85861797520078,-84.0,-3.8920274640912567,42.897300295547794,51.31562778405104,89.74778834615384,87.89047365822421,-48.68437221594897
2018-11-02,83.929497,84.872002,82.591499,83.276497,83.276497,139110000,4945117105.086699,7540898000,37.778682833293786,-84.0,-3.6613205221235887,42.8973002955478,51.31562778405104,89.07961507692309,87.54869760946686,-48.68437221594897
2018-11-05,82.878502,82.904503,79.818001,81.389999,81.389999,112494000,4947212593.777781,7428404000,37.29713573354469,-84.0,-3.5893326385634765,40.46657130303551,41.08072054474398,88.35807650000001,87.09249771246932,-58.91927945525602
2018-11-06,80.917503,83.25,80.727501,82.140503,82.140503,85148000,4957457530.937319,7513552000,36.731352860830135,-80.0,-3.4321585344800383,41.87758610062002,47.04769761992694,87.66278807692308,86.72568328932344,-52.95230238007305
2018-11-07,83.650002,87.961502,83.204002,87.774498,87.774498,163844000,5108421033.459231,7677396000,34.75578742106047,-76.0,-2.820468013793814,51.22363834244001,83.78759388622089,87.24774961538462,86.80337326789207,-16.21240611377912
2018-11-08,87.75,89.199997,86.255501,87.745499,87.745499,130698000,5109996779.868804,7546698000,32.58994799137923,-72.0,-2.3113945287685027,51.17802212110044,83.61349887978005,86.86726880769233,86.87316035915933,-16.38650112021995
2018-11-09,86.625,87.195999,85.093498,85.621498,85.621498,118044000,5051241438.4711075,7428654000,30.860092711382947,-68.0,-2.055643080058985,47.81905139016869,74.1309279321715,86.48844176923077,86.78044462885123,-25.869072067828498
2018-11-12,84.912003,85.427498,81.500504,81.842499,81.842499,136124000,4938827037.915364,7292530000,30.043490230912045,-64.0,-2.133300491126363,42.47727052878239,50.39722405401167,86.00228796153846,86.41467087856596,-49.60277594598833
2018-11-13,82.4645,83.852997,80.6875,81.558502,81.558502,118666000,4885464099.856033,7173864000,29.449597289598724,-60.0,-2.192487106736124,42.09668291840684,48.61360339142728,85.5537303076923,86.05495466533885,-51.38639660857272
2018-11-14,82.816002,83.650002,79.8535,79.9505,79.9505,129738000,4762355668.864558,7044126000,29.06913948491956,-56.00000000000001,-2.342146442535949,39.91595214296709,39.868031431031504,85.03198034615386,85.60277283827672,-60.13196856896849
2018-11-15,79.050499,81.240997,77.3255,80.972,80.972,168546000,4907743245.623779,7212672000,29.20789898322414,-36.0,-2.351222600868752,41.972434539563174,46.508912107375394,84.77080738461538,85.25975262803401,-53.49108789262461
2018-11-16,79.375,80.723999,78.655998,79.670502,79.670502,121322000,4905455669.966901,7091350000,29.33674708879268,-36.0,-2.4353621938546155,40.08970270480666,38.047734507277234,84.52859584615385,84.84573406299445,-61.952265492722766
2018-11-19,78.850502,79.059502,75.167999,75.614502,75.614502,155800000,4785408009.050283,6935550000,30.081459229152,-36.0,-2.797085667631535,34.84412847989405,3.1820343760026684,83.99721146153844,84.16193909536524,-96.81796562399732
2018-11-20,71.875,76.737503,71.0,74.773003,74.773003,217576000,4853989559.025595,6717974000,31.376766924333687,-96.0,-3.115739754862645,33.85440089443064,20.730789131448777,83.48665384615386,83.46646234756041,-79.26921086855121
2018-11-21,77.149498,77.5,75.75,75.836502,75.836502,114336000,4750956750.650737,6832310000,32.294735702727024,-96.0,-3.2450529826948724,36.31636697208201,26.574191193547982,82.90351926923077,82.90128009959298,-73.42580880645203
2018-11-23,75.849998,76.809998,75.0905,75.102997,75.102997,54152000,4697591884.50492,6778158000,33.24452152562397,-92.0,-3.3678993237862898,35.33937575368766,22.54394327647418,82.26953830769232,82.32362949962314,-77.45605672352582
2018-11-26,76.949997,79.240501,76.210999,79.066498,79.066498,125154000,4808369150.994264,6903312000,33.20671357858669,-84.0,-3.1095891200967998,44.091730135213105,44.32142488814694,81.90532657692307,82.08236049965106,-55.67857511185306
2018-11-27,78.7995,79.8825,77.900497,79.070999,79.070999,115664000,4829319417.8021345,7018976000,32.938965052379885,-84.0,-2.8714133637008104,44.10098358965665,44.34615566145424,81.55415346153846,81.8592966848621,-55.65384433854576
2018-11-28,80.695999,84.072502,80.060997,83.887497,83.887497,169174000,4982889281.26485,7188150000,31.329988064471202,-72.0,-2.267863704260037,53.05510995861786,70.81043474897275,81.33963426923076,82.00953374524268,-29.189565251027247
2018-11-29,83.749496,84.499496,82.616501,83.678497,83.678497,132264000,4999817221.704415,7055886000,29.71062969604902,-72.0,-1.7858249260171561,52.66091862768626,78.28166079783033,81.15669192307692,82.13316065300248,-21.718339202169666
2018-11-30,83.974998,84.800003,83.324997,84.508499,84.508499,115236000,5069505264.687291,7171122000,28.11458848168342,-72.0,-1.321596949604455,54.1188324294886,93.63022611404972,81.20663423076924,82.30911164166896,-6.369773885950283
2018-12-03,88.473,88.917,86.5,88.617996,88.617996,137246000,5172794208.018694,7308368000,26.725536953007232,-32.0,-0.6150015156674016,60.590384261216435,98.33117151308815,81.18776876923077,82.77643640895275,-1.6688284869118517
2018-12-04,87.800003,88.516998,83.25,83.419998,83.419998,173890000,5010129179.898312,7134478000,25.07186772184478,-32.0,-0.4690476512931525,50.825110405099544,69.31962940224372,81.23698011538461,82.82410763791921,-30.680370597756294
2018-12-06,80.7435,85.052498,80.4925,84.959503,84.959503,175788000,5178747262.253611,7310266000,24.179130008576834,-31.999999999999996,-0.2265415450022914,53.22938190684148,77.91205558966342,81.54526869230769,82.98228507214742,-22.08794441033657
2018-12-07,85.253502,85.946503,81.273003,81.456497,81.456497,151522000,5039123573.099015,7158744000,23.096406925384596,-32.00000000000001,-0.313404287423964,47.53439714565494,58.36075793938716,81.73509534615384,82.86926373346984,-41.639242060612844
2018-12-10,81.192001,82.899498,79.543503,82.051498,82.051498,149896000,5113267488.843824,7308640000,22.491912481293234,-32.0,-0.33042311653012746,48.541468014241275,61.68163196963774,81.81782615384616,82.80868849395355,-38.31836803036226
2018-12-11,83.900002,83.973503,80.980003,82.162003,82.162003,124894000,5087003659.547015,7433534000,21.606174431487524,-32.0,-0.3311762377212233,48.73826912657613,62.29839258804487,81.774961,82.7607858647718,-37.70160741195514
2018-12-12,83.449997,85.249496,83.013496,83.177002,83.177002,131960000,4974342632.498714,7565494000,20.404298259794157,-32.0,-0.24702362056072502,50.60682243006419,58.48553140708059,81.77113426923077,82.79161668960353,-41.51446859291941
2018-12-13,84.0,84.606003,82.074997,82.918999,82.918999,105426000,4939228401.694046,7460068000,19.53862759264876,-32.0,-0.19885843480180654,50.10684191310423,56.61952771851153,81.82994196153847,82.80105241629957,-43.38047228148847
2018-12-14,81.900002,82.128502,79.25,79.595497,79.595497,127344000,4842453753.369327,7332724000,19.433160075525514,-32.0,-0.42397865183055217,44.06714923804012,26.637004042420532,81.7320571153846,82.56360386694405,-73.36299595757947
2018-12-17,78.300003,78.806503,75.250504,76.045502,76.045502,176596000,4744819230.472103,7156128000,20.153494135790957,-32.0,-0.8787137090259449,38.701068040913825,5.817131179784437,81.28094188461539,82.08078150642967,-94.18286882021556
2018-12-18,77.0,78.377502,76.150497,77.573997,77.573997,130460000,4781139107.481809,7286588000,20.822375763180297,31.999999999999996,-1.1030425577228868,41.97720388665484,17.00138060260655,80.88973026923077,81.74694561706451,-82.99861939739345
2018-12-19,77.152496,79.226501,74.158997,74.753998,74.753998,175844000,4646588555.239916,7110744000,21.81958899323202,32.00000000000001,-1.4911856778390415,37.947595247749604,4.031717570459881,80.4717495,81.22894949728196,-95.96828242954012
2018-12-20,74.199997,75.474998,71.634499,73.041496,73.041496,199836000,4593175534.385073,6910908000,23.17669052128983,32.0,-1.9149026901484092,35.70599911594071,8.141165448218347,80.13324938461538,80.62247146044626,-91.85883455178164
2018-12-21,73.249496,74.0,68.197998,68.872498,68.872498,272806000,4383798553.196165,6638102000,24.94185788991215,-52.0,-2.5576220964859715,30.917849901032454,3.255465683144365,79.64532615384616,79.75210305596876,-96.74453431685563
2018-12-24,67.300003,69.801498,65.349998,67.197998,67.197998,144400000,4359291263.518528,6493702000,26.939573519304368,-56.0,-3.1656088439414845,29.222785345925075,7.9768636422497465,79.15484530769231,78.82216934811923,-92.02313635775025
2018-12-26,68.444504,73.657997,68.150497,73.544998,73.544998,208236000,4558982384.802596,6701938000,27.449055438188704,-56.0,-3.0995630324728296,42.16566064592539,39.78830388942203,78.86919138461539,78.43126776677707,-60.21169611057796
2018-12-27,72.709999,73.449997,69.515503,73.082001,73.082001,194440000,4717050164.008767,6507498000,27.922145791438446,-56.0,-3.049429316564627,41.56849344513642,37.54036425111932,78.6157875,78.03502578405283,-62.459635748880686
2018-12-28,73.667503,75.6735,72.449997,73.901001,73.901001,176580000,4699439016.415605,6684078000,27.632598171425222,-56.0,-2.9100660996386694,43.10350950687198,42.97094831236444,78.54988361538462,77.72880172597485,-57.02905168763556
2018-12-31,75.540001,76.038002,74.349998,75.098503,75.098503,139090000,4683701283.886534,6823168000,27.246429861560415,-56.0,-2.6721880225640433,45.363595585216984,48.98869810685675,78.56240284615384,77.53396478331004,-51.01130189314325
2019-01-02,73.260002,77.667999,73.046501,76.956497,76.956497,159662000,4794201807.5323305,6982830000,26.363878464468286,-56.0,-2.3071479790148146,48.764270871848,58.325586906765196,78.60547957692307,77.49118939195374,-41.674413093234804
2019-01-03,76.000504,76.900002,74.855499,75.014,75.014,139512000,4676321266.632171,6843318000,25.544366452882738,-56.0,-2.1498126858749487,45.57074859426023,50.186952070276234,78.60205661538461,77.30769388143865,-49.813047929723766
2019-01-04,76.5,79.699997,75.915497,78.769501,78.769501,183652000,4769664136.5531645,7026970000,23.906967127139986,-56.0,-1.7024608785901592,52.101753875613355,79.98033078515229,78.59063365384615,77.41597589022098,-20.019669214847717
2019-01-07,80.115501,81.727997,79.459503,81.475502,81.475502,159864000,4893940772.707372,7186834000,22.5757797888875,-56.0,-1.1167069796793925,56.181644344089534,98.45832815107634,78.68311453846154,77.71668152798239,-1.541671848923645
2019-01-08,83.234497,83.830498,80.830498,82.829002,82.829002,177628000,4952972951.715371,7364462000,21.874664143717546,-56.0,-0.5370854693683356,58.10392680307095,94.58079597413489,78.6424031923077,78.09537193331703,-5.419204025865116
2019-01-09,82.649002,83.389999,82.07,82.971001,82.971001,126976000,4999338754.210676,7491438000,21.2236281874883,-56.0,-0.06551786477284338,58.310559433131026,95.34916804199018,78.61519180769231,78.4565296419602,-4.650831958009817
2019-01-10,82.050499,83.162498,81.081001,82.810997,82.810997,130154000,5085534717.130632,7361284000,20.286050505674957,-56.00000000000001,0.2919267241811383,57.96365362296547,94.4833689564676,78.54990326923077,78.77908277959278,-5.516631043532398
2019-01-11,82.027496,83.014503,81.810997,82.028,82.028,93724000,5025609284.270307,7267560000,19.415442658276856,-52.0,0.5061878041401684,56.20156905500175,90.24648683747733,78.29644188461538,79.01974331443776,-9.753513162522655
2019-01-14,80.75,82.410004,79.7575,80.860497,80.860497,120118000,5005389187.267625,7147442000,18.14943631665105,-44.0,0.5751535071947984,53.5857775643714,83.92900083872185,78.19799953846154,79.15609543929422,-16.070999161278156
2019-01-15,81.599998,83.758003,81.300499,83.727997,83.727997,119970000,5122429531.958824,7267412000,17.1692610100656,-44.0,0.8513784482524756,58.67339572091347,99.3462946845475,78.15063392307692,79.49475481416131,-0.6537053154524908
2019-01-16,84.210999,85.25,83.793999,84.189003,84.189003,127338000,5064183544.05497,7394750000,16.71591300702006,60.0,1.0948670892720003,59.443086285467736,93.25687373419055,78.2557303076923,79.84247690200121,-6.743126265809451
2019-01-17,84.0,85.008499,83.875,84.661003,84.661003,84178000,5096748762.238664,7478928000,16.29494700419206,60.0,1.3108098468881764,60.25918614305957,95.39846201598542,78.35609588461539,80.19940476111222,-4.601537984014582
2019-01-18,85.599998,85.809998,84.577003,84.809998,84.809998,120410000,5021845723.661863,7599338000,16.158983187221754,68.0,1.4769434051699193,60.52918929199665,92.16515661812745,78.45794184615384,80.54093018621502,-7.834843381872546
2019-01-22,84.050003,84.093498,80.510002,81.608498,81.608498,128336000,4972190756.182061,7471002000,15.443107155948764,68.0,1.3348834476394416,52.3058398238373,67.08190553106253,78.39761476923077,80.62000928353243,-32.91809446893747
2019-01-23,82.800003,82.871498,80.599998,82.000999,82.000999,104504000,4996597351.3869915,7575506000,14.778365126909563,68.0,1.2396811852136977,53.146266896392476,65.22890731926672,78.36230707692309,80.72230481808558,-34.77109268073328
2019-01-24,82.053497,82.862999,81.588997,82.746498,82.746498,81798000,5063435329.663321,7657304000,14.161104671373161,68.0,1.210435102854916,54.77628361115527,69.0383577706446,78.48349942307692,80.87224505378293,-30.96164222935541
2019-01-25,83.525002,84.174004,83.080498,83.528503,83.528503,98918000,5045569941.336233,7756222000,13.222096959462673,68.0,1.236109538581161,56.48637860344816,64.07374543244276,78.77130715384615,81.06900490165087,-35.926254567557244
2019-01-28,82.179497,82.25,80.704498,81.894501,81.894501,96754000,5097812901.886269,7659468000,13.043789590480461,68.0,1.1117903809469425,52.05683027739158,35.30775227021987,78.93748038461537,81.13015276078785,-64.69224772978014
2019-01-29,81.563499,81.619003,79.536003,79.694,79.694,92656000,5019212946.084061,7566812000,13.2479881297237,68.0,0.8261808143566469,46.74104094209429,2.518283804816689,79.12748046153845,81.02377107480356,-97.48171619518331
2019-01-30,81.150002,83.847504,80.984001,83.5215,83.5215,115676000,5108549990.82262,7682488000,12.55655028084676,68.0,0.8983251047561822,55.292640792531,63.52407038896285,79.53055753846154,81.20878803222553,-36.47592961103715
2019-01-31,84.642502,86.820503,83.954002,85.936501,85.936501,218206000,5192170626.706578,7900694000,12.385896033766459,100.0,1.1372607384908235,59.69056925740847,87.86461665179499,80.18686534615384,81.5589889928014,-12.135383348205014
2019-02-01,81.944,83.653,81.100502,81.311501,81.311501,230124000,5000092442.120341,7670570000,11.723611618574424,96.0,0.9425549160493745,49.62287204673128,24.37364266593467,80.72969238461539,81.5406565488902,-75.62635733406533
2019-02-04,81.150002,82.481499,80.675003,81.665497,81.665497,98582000,5009614616.730194,7769152000,11.24006461038776,92.0,0.8075052498511042,50.313641139466576,29.23322122314511,81.04201926923078,81.54990398971314,-70.76677877685489
2019-02-05,82.167,83.263,82.125,82.940498,82.940498,89062000,5048197402.10102,7858214000,10.519639772242241,88.0,0.7942042492701233,52.82280192313641,46.7361521037821,81.42119223076924,81.6529109534381,-53.2638478962179
2019-02-06,83.537498,83.612999,81.667,82.013,82.013,78798000,4997420082.481637,7779416000,10.008400593606487,80.0,0.7007440322990419,50.812554616088406,34.0036653167686,81.7331921923077,81.67958421614638,-65.9963346832314
2019-02-07,81.25,81.277,79.6455,80.718498,80.718498,92532000,5026600189.053503,7686884000,10.196288704247593,80.0,0.5162694117969124,48.06329338219102,16.23302903425083,81.94934584615385,81.60839264457998,-83.76697096574918
2019-02-08,79.300003,79.429497,78.337997,79.411003,79.411003,113150000,5135915839.809342,7573734000,10.76184418789165,76.0,0.26155300642575696,45.391856495101734,12.649634435861199,82.0437499230769,81.44562304127776,-87.3503655641388
2019-02-11,80.049004,80.4645,79.300003,79.550003,79.550003,66346000,5098056817.448615,7640080000,10.859108612577467,72.0,0.0700965292098914,45.737153973975445,14.28830112233345,82.21821157692308,81.30520674192385,-85.71169887766655
2019-02-12,80.199997,81.970001,79.944,81.900497,81.900497,97172000,5188561651.25472,7737252000,10.359966382196228,-24.0,0.1067999897477705,51.34032905533524,41.99820194645309,82.3386345,81.34930231659617,-58.00179805354691
2019-02-13,82.349998,82.819,81.855499,82.0,82.0,71206000,5138713881.72049,7808458000,9.660907560191339,-24.0,0.14227672960225846,51.56832275473287,43.1712397256188,82.35880750000001,81.39750214499645,-56.8287602743812
2019-02-14,81.224998,81.894997,80.303001,81.1325,81.1325,82410000,5142182254.015395,7726048000,9.488161273524167,-24.0,0.09924822972071468,49.395333438198016,32.94430914637716,82.29355742307692,81.37787235647819,-67.05569085362283
2019-02-15,81.392998,81.445503,80.224998,80.397499,80.397499,86878000,5079862190.079565,7639170000,9.355496422874376,-23.999999999999993,0.005772849702751159,47.56648070706735,24.279405166350543,82.19457657692307,81.30525210785018,-75.72059483364946
2019-02-19,80.050003,81.699997,80.028,81.378998,81.378998,73634000,5125222885.323635,7712804000,9.120842271883108,-24.0,0.010767582170686296,50.21717107832751,35.85026641890963,82.1394996923077,81.31071476652794,-64.14973358109037
2019-02-20,81.5,81.746498,80.505997,81.105003,81.105003,66752000,5122936530.271926,7646052000,8.881395063559843,-24.0,-0.007299024382021457,49.46539426494243,32.6201478666799,82.1039998076923,81.29547685789625,-67.3798521333201
2019-02-21,80.9925,81.178001,80.045502,80.972,80.972,69668000,5167259381.7676,7576384000,8.85724861277358,-24.0,-0.031980519266525675,49.081283852388204,49.55788359856035,82.10828838461538,81.27151560916319,-50.44211640143965
2019-02-22,81.175003,81.747002,81.058502,81.578003,81.578003,61924000,5198783689.462589,7638308000,8.542488450866378,-24.0,-0.0026113027883951645,50.950200208647274,61.42189140402209,82.02559630769231,81.2942183788548,-38.57810859597791
2019-02-25,82.072502,82.730003,81.519501,81.650002,81.650002,63690000,5148826188.35974,7701998000,8.103483717888116,-24.0,0.026172035509731018,51.17947233709498,62.78680083912762,81.92794242307693,81.32057272116184,-37.21319916087238
2019-02-26,81.299004,81.999496,80.806503,81.82,81.82,53316000,5186098491.982645,7755314000,7.709760757123652,-24.000000000000007,0.06198592123605806,51.75291125939227,66.00951051772097,81.81867307692308,81.35756733440911,-33.99048948227903
2019-02-27,81.408997,82.0905,80.754997,82.054497,82.054497,62976000,5245679029.856389,7818290000,7.295423235268331,-23.999999999999996,0.10804515454032071,52.58032257525455,82.93902057195666,81.71269226923076,81.40919175408251,-17.060979428043332
2019-02-28,81.762497,82.588501,81.691498,81.991501,81.991501,60518000,5225641566.8311825,7757772000,6.912513174416742,-24.0,0.13787484268993921,52.320734616713274,81.53317460398927,81.72742315384616,81.45232577229862,-18.466825396010734
2019-03-01,82.7565,83.712997,82.550003,83.586502,83.586502,99498000,5303495431.934526,7857270000,7.14542936153169,-24.0,0.28691100471381503,57.97758822253526,97.133578699631,81.78840403846154,81.6104129002765,-2.866421300368993
2019-03-04,84.25,85.471497,83.718002,84.808502,84.808502,123348000,5333567879.668909,7980618000,8.156983412530701,-24.0,0.4978890689238398,61.724403493534616,88.00551135532058,81.86771188461537,81.8473083891449,-11.994488644679418
2019-03-05,85.147499,85.389999,84.4505,84.621498,84.621498,73630000,5286740638.884192,7906988000,9.09628360274407,-24.0,0.6425936255678693,60.830547804419844,84.38505615048565,81.90975015384615,82.0528039158749,-15.614943849514344
2019-03-06,84.7985,84.887497,83.414001,83.447502,83.447502,79920000,5210454717.18505,7827068000,9.291671524338508,-24.0,0.6549910346129906,55.405952578206005,62.818111225192155,81.96948096153847,82.15611488506936,-37.181888774807845
2019-03-07,83.3685,83.487503,81.025497,81.297501,81.297501,99140000,5133220818.599912,7727928000,9.07987275384588,-24.000000000000004,0.4857297678008905,47.11894240332598,23.32142370979524,82.03115407692309,82.09251385654571,-76.67857629020476
2019-03-08,80.2005,81.136002,79.328499,81.040001,81.040001,93340000,5216645777.418791,7634588000,9.622601970235854,-24.0,0.32704097166264035,46.2271539253264,27.861021605411697,81.93571180769231,82.01454994124602,-72.1389783945883
2019-03-11,81.306,83.614502,81.300499,83.530998,83.530998,77528000,5288578367.117249,7712116000,8.978066310155713,60.0,0.39769719153537153,55.0834711469786,68.41120573374758,81.84319246153846,82.12687942707964,-31.58879426625242
2019-03-12,83.449997,84.213501,83.049004,83.654999,83.654999,72290000,5291526652.05916,7784406000,8.643047190254281,60.0,0.45841428469451273,55.47658224244231,70.42978037759423,81.93332699999999,82.2400734695182,-29.57021962240577
2019-03-13,84.150002,85.0,83.967499,84.540497,84.540497,71040000,5299335540.186145,7855446000,8.672811262105165,60.0,0.5713985795092924,58.284313825955685,84.84453356488156,82.04390392307693,82.41047521251684,-15.15546643511843
2019-03-14,84.559998,85.099998,84.217003,84.310997,84.310997,58932000,5252950053.831182,7796514000,8.744492587372664,60.0,0.6350996813783212,57.276173750642116,81.10857271970465,82.09661542307693,82.55125460418226,-18.891427280295353
2019-03-15,85.150002,85.940002,84.656502,85.617996,85.617996,151018000,5328192904.461489,7947532000,9.1839139662514,96.0,0.7820323773568703,61.37376657486156,95.12960971204276,82.23526911538463,82.7784206335021,-4.870390287957234
2019-03-18,85.635002,87.5,85.6315,87.107498,87.107498,108582000,5391156866.287553,8056114000,10.221769382900504,100.0,1.007059208937136,65.44159703092654,95.19669642089019,82.48099988461537,83.09909303102046,-4.803303579109798
2019-03-19,87.675499,89.208,87.675499,88.092499,88.092499,127284000,5333141895.149525,8183398000,11.77869988067853,100.0,1.2504614022386136,67.85264573395031,88.70893378116978,82.81490357692309,83.46897495464857,-11.291066218830224
2019-03-20,88.497002,89.974998,88.351501,89.863503,89.863503,125312000,5441242084.545624,8308710000,13.467282208559665,32.0,1.5681875263096998,71.67855976901004,98.952754327972,83.21157665384615,83.94264369874868,-1.0472456720280061
2019-03-21,89.813004,91.1875,89.363998,90.962997,90.962997,115356000,5528193653.875408,8424066000,15.397210393366622,36.0,1.8869560904530545,73.76599306022251,98.10689787444997,83.56013434615383,84.46266986921174,-1.8931021255500227
2019-03-22,90.508499,90.948997,88.155502,88.238503,88.238503,127260000,5408496013.75792,8296806000,16.409786171281468,36.0,1.8978612151755954,61.64186030505707,75.1328379177976,83.80007676923076,84.74236121223308,-24.867162082202405
2019-03-25,87.889503,89.134003,87.375,88.712997,88.712997,102076000,5461709551.947451,8398882000,16.87561953333164,35.99999999999999,1.922628441494652,62.788946384670574,79.13396752390865,84.09163434615385,85.0364823816973,-20.866032476091345
2019-03-26,89.650002,90.288498,88.667999,89.188004,89.188004,97318000,5426848667.428547,8496200000,17.723740563954443,36.0,1.958014964206214,63.95115423518181,83.13942295813962,84.42973069230769,85.34400250157158,-16.860577041860378
2019-03-27,89.206497,89.375,87.283997,88.285004,88.285004,86496000,5423167566.7586775,8409704000,17.694615188588504,36.0,1.8913916989322956,60.10776107387849,75.52495357745565,84.69534630769229,85.56185446441813,-24.47504642254434
2019-03-28,88.5,88.8965,87.6735,88.670998,88.670998,60860000,5461584309.653198,8470564000,17.667570197177273,36.0,1.848431206778315,61.181702022748844,74.54736780141923,84.98634611538462,85.79216139297975,-25.452632198580776
2019-03-29,89.329002,89.642998,88.831497,89.037498,89.037498,66416000,5428887953.661031,8536980000,17.953273091858787,36.0,1.8229444256687515,62.22165342659721,73.58231791230223,85.29655757692308,86.03255669720346,-26.417682087697774
2019-04-01,90.005501,90.783501,89.936501,90.709503,90.709503,84776000,5498851074.208846,8621756000,18.66444209364123,36.0,1.9155811706607437,66.61572191336074,93.37954385324875,85.64776911538462,86.37899716407728,-6.620456146751257
2019-04-02,90.551003,91.0,90.255997,90.698997,90.698997,68962000,5512012845.215147,8552794000,19.407354837895628,36.0,1.9654917467010762,66.56333251149556,92.99184835744144,85.99580738461539,86.6989971519234,-7.008151642558554
2019-04-03,91.335999,91.5,90.481003,91.035004,91.035004,78522000,5518871403.78794,8631316000,20.291458724033223,72.0,2.009000685231811,67.44514862481711,93.20528770520573,86.3502306153846,87.02018284437351,-6.794712294794263
2019-04-04,91.032501,91.4375,90.209999,90.943001,90.943001,72478000,5532953852.954172,8558838000,20.906368355619612,72.0,2.0128550195766053,66.92469767059595,90.5086649058532,86.69209615384617,87.31076196701251,-9.4913350941468
2019-04-05,91.449997,91.929001,91.259499,91.863998,91.863998,72810000,5591625378.595618,8631648000,21.685572477413054,80.0,2.0664061246094008,69.46490561473671,98.60058247527873,87.07180757692308,87.64803871019677,-1.3994175247212781
2019-04-08,91.661499,92.510002,91.255501,92.492996,92.492996,75056000,5664646462.18503,8706704000,22.650707578021052,84.0,2.134989809468621,71.09749391880493,99.6745889068228,87.41436503846154,88.00692443536738,-0.32541109317719685
2019-04-09,92.274498,92.654503,91.588997,91.792,91.792,74288000,5618665551.706816,8632416000,23.60759587774584,88.0,2.108473188666366,66.8103123687473,83.94000490828978,87.68296111538461,88.28730040311794,-16.05999509171022
2019-04-10,92.050003,92.400002,91.440498,92.366501,92.366501,59280000,5673806039.45882,8691696000,24.357138060104834,88.0,2.1094990135231058,68.48742198337601,94.63733957284461,87.98084584615384,88.58946341029439,-5.362660427155384
2019-04-11,92.434998,92.497498,92.015503,92.203499,92.203499,53096000,5662128874.160425,8638600000,25.10026868081514,88.0,2.073259839111458,67.44606005486852,91.60220657047937,88.31761496153845,88.85716975027258,-8.39779342952063
2019-04-12,92.419998,92.574997,92.065002,92.153,92.153,62288000,5621336063.030905,8576312000,25.82991796823006,88.0,2.0172120205369595,67.10563275391601,90.66190411108377,88.73513415384615,89.10130532432646,-9.338095888916222
2019-04-15,92.099998,92.342499,90.945,92.2435,92.2435,74488000,5685270584.979041,8650800000,25.378456971968642,84.0,1.9575311140123404,67.42297631051156,92.34703396663168,89.16603796153846,89.33406048548747,-7.652966033368318
2019-04-16,92.567497,93.488503,92.400002,93.152,93.152,60892000,5708513853.970067,8711692000,25.614870572488545,100.0,1.9609374566040287,70.49974568311546,94.21319301125048,89.53607650000001,89.61687081989581,-5.786806988749514
2019-04-17,93.649498,93.823502,93.022003,93.240997,93.240997,57870000,5682267556.008371,8769562000,26.01091915467034,100.0,1.9483588537159875,70.79077629603641,88.33124165540677,89.90476873076923,89.88532461101464,-11.668758344593227
2019-04-18,93.439499,93.541,92.973999,93.084503,93.084503,54998000,5648706904.415163,8714564000,26.32884302548121,96.0,1.9038164514109468,69.49252720515,80.98793903063037,90.23338434615385,90.12230078797651,-19.01206096936963
2019-04-22,92.769997,94.420998,92.281998,94.365501,94.365501,67476000,5712681534.081362,8782040000,27.09610213343714,100.0,1.9494105185347763,73.73815594241347,98.68209420139965,90.62009603846153,90.43661191479306,-1.3179057986003453
2019-04-23,94.559998,96.462997,94.478996,96.188499,96.188499,92808000,5779808488.170598,8874848000,28.671199076069804,100.0,2.1083412033920865,78.35474232019777,95.61013772913395,91.02665384615385,90.86267762480838,-4.389862270866041
2019-04-24,96.25,96.484497,94.907997,95.087502,95.087502,73516000,5723033990.967935,8801332000,30.14167610422169,76.0,2.1210040453356385,70.315228821173,77.73535030212773,91.33357707692309,91.17562757852629,-22.26464969787228
2019-04-25,95.849998,96.122498,95.015503,95.112503,95.112503,121982000,5622429240.187671,8923314000,31.50711905893416,76.0,2.108748470843153,70.3895248816207,75.23251659852875,91.60357723076922,91.46724798011694,-24.767483401471253
2019-04-26,96.449997,97.550003,94.900002,97.531502,97.531502,168652000,5788726350.018195,9091966000,33.294226717088705,84.0,2.268083784607242,76.51439434050243,99.7198941469065,91.89850026923077,91.91645198158976,-0.2801058530934886
2019-04-29,97.449997,97.817001,96.704498,96.921501,96.921501,80426000,5739675875.797452,9011540000,35.040769687508416,88.0,2.3184109873043894,72.44491445356586,86.96886103479908,92.1276735,92.28719635332385,-13.03113896520092
2019-04-30,96.504997,96.7855,95.347504,96.325996,96.325996,70120000,5764982927.11053,8941420000,35.16315313576891,88.0,2.283915821471041,68.60860276502115,78.30319000244617,92.43873092307693,92.58636669752208,-21.696809997553824
2019-05-01,96.654503,97.181999,95.527496,95.575996,95.575996,62340000,5706297789.023746,8879080000,35.45835797387976,88.0,2.171033103835569,64.01110190728748,67.38933827279715,92.70269242307693,92.80782071992785,-32.61066172720285
2019-05-02,95.666496,96.077499,94.093498,95.041,95.041,79258000,5702742486.266337,8799822000,34.38579172361427,88.0,2.0151733666130696,60.877292855920395,59.604182246189964,92.92780765384616,92.9732414073406,-40.395817753810036
2019-05-03,97.449997,98.220001,96.800003,98.123001,98.123001,127632000,5812937413.819757,8927454000,34.406082077580365,100.0,2.1159537278591074,69.9916536249385,98.66666684994277,93.30619215384617,93.35470508087091,-1.3333331500572188
2019-05-06,95.899002,97.949997,95.525002,97.527496,97.527496,108356000,5883536207.428817,8819098000,33.43582673316989,96.0,2.123294595184518,66.75555287705296,88.3377458718024,93.64682669230768,93.66380070451011,-11.662254128197604
2019-05-07,96.999496,97.455002,95.168999,96.050003,96.050003,118042000,5856478754.840173,8701056000,32.27604250378345,92.0,1.9869862081012002,59.41548420114736,63.455761137203964,93.91653842307693,93.84055643010196,-36.544238862796036
2019-05-08,95.943497,96.768501,95.5,95.888496,95.888496,81572000,5824871864.386007,8619484000,31.199100005067468,80.0,1.8446644209777787,58.65624679234262,60.73587365988204,94.11573046153846,93.99225565750181,-39.26412634011796
2019-05-09,95.0,95.470001,93.800003,94.9935,94.9935,106166000,5870453114.983912,8513318000,29.006676873472447,80.0,1.6407412382346251,54.50011061570645,45.663533682957016,94.28090365384615,94.06642190509427,-54.336466317042984
2019-05-10,94.900002,95.189499,92.800003,94.499001,94.499001,114360000,5918719385.360595,8398958000,27.492851112499718,80.0,1.4228272433419988,52.29532010653138,31.346838135364727,94.41413430769231,94.09846480101322,-68.65316186463528
2019-05-13,91.828003,92.327003,90.900002,91.134003,91.134003,115668000,5840986085.711892,8283290000,27.040788123005715,-24.0,0.9674494610945885,40.336841907476966,3.196735409390172,94.42148053846154,93.8788750379752,-96.80326459060983
2019-05-14,91.974998,92.622002,90.787498,92.005997,92.005997,92582000,5871392178.861866,8375872000,26.41639659010017,-28.0,0.6692077062159143,43.91588038085344,16.39419452639299,94.42694203846155,93.74014333145853,-83.605805473607
2019-05-15,91.397499,93.721497,91.150002,93.557503,93.557503,93852000,5953273582.078282,8469724000,25.10422212362136,-28.0,0.55168307539968,49.69779647987098,37.2688043314614,94.46788461538463,93.72661441801715,-62.7311956685386
2019-05-16,94.296997,95.875504,94.114502,95.378502,95.378502,94156000,5994282884.559483,8563880000,23.929430327446266,-28.0,0.5985832640718627,55.49692613630493,61.76928552871085,94.605827,93.848976461127,-38.23071447128915
2019-05-17,94.652496,95.526497,93.366501,93.449997,93.449997,94732000,5906874734.299945,8469148000,22.414373125845497,-28.0,0.47466610973728507,49.04792841759121,35.82237370102639,94.64749992307692,93.81942242696944,-64.1776262989736
2019-05-20,92.634499,93.389,91.777,92.948502,92.948502,75964000,5941322617.585305,8393184000,21.434807021894137,-27.999999999999993,0.33216542061774135,47.50208159682318,29.07505049106615,94.67615388461539,93.7549098027495,-70.92494950893386
2019-05-21,93.739502,93.949997,92.300003,92.875999,92.875999,80102000,5917146192.577699,8313082000,20.21043799266103,-28.0,0.21095050554554007,47.27012507268716,28.0995648437679,94.70396153846153,93.68980529884213,-71.90043515623209
2019-05-22,92.588997,93.574501,92.550003,92.984001,92.984001,58732000,5908174310.286079,8371814000,19.07352389408743,-28.0,0.1221931047847562,47.67997269239302,29.552668865387716,94.73244234615383,93.63752349892789,-70.44733113461228
2019-05-23,91.829498,92.199997,90.209999,90.774002,90.774002,88486000,5869845515.9295025,8283328000,19.138691841756184,-56.0,-0.12503489985444105,40.70752401313517,7.286862348026442,94.64098088461537,93.4254107953036,-92.71313765197355
2019-05-24,91.794502,92.087997,90.892502,91.164001,91.164001,67394000,5833062105.862543,8350722000,19.199204936020028,-56.0,-0.2861961240036237,42.3107700315419,13.167724016125364,94.56109642307692,93.25789895861445,-86.83227598387464
2019-05-28,91.637497,92.463501,91.3675,91.821503,91.821503,64000000,5822084305.659806,8414722000,19.001614633945568,-56.0,-0.3567502440748598,45.01037139197556,24.571220684235662,94.5125195,93.15149925797634,-75.42877931576433
2019-05-29,91.155998,91.5,90.376503,90.959503,90.959503,85580000,5825321881.496679,8329142000,19.281492774475602,-56.0,-0.47672569149165156,42.22086781358711,13.229253173371136,94.38151957692308,92.9891291647929,-86.77074682662887
2019-05-30,91.274498,91.473503,90.391502,90.816002,90.816002,62938000,5811768643.617971,8266204000,19.54137961925349,-56.0,-0.5767381509607503,41.756913664304406,10.696363342720554,94.17488507692309,92.82815678221564,-89.30363665727944
2019-05-31,89.500504,89.779503,88.635002,88.753502,88.753502,92376000,5738521602.002455,8173828000,20.5403536744336,-76.0,-0.8130528909896952,35.68701018257718,1.6366268526684653,93.9312696923077,92.52633050205152,-98.36337314733153
2019-06-03,88.000504,88.314499,83.599998,84.634499,84.634499,181974000,5636408560.765217,7991854000,22.883610962204678,-80.0,-1.317515642966896,27.187326987705276,8.427359328405732,93.52826953846154,91.94175039078844,-91.57264067159426
2019-06-04,84.961998,86.541,84.044502,86.477997,86.477997,113582000,5744257724.811813,8105436000,25.05949272942068,-80.0,-1.550675900009253,34.6852207593261,23.445053914681814,93.10313473076923,91.53702791739671,-76.55494608531819
2019-06-05,87.480003,87.599998,85.762497,86.925003,86.925003,84796000,5766755118.149831,8190232000,26.337354766455757,-80.0,-1.6800211965523033,36.39553256775027,27.086500548327724,92.71865403846154,91.195396442034,-72.91349945167228
2019-06-06,86.885498,88.0,86.306503,87.718002,87.718002,73786000,5815967700.626209,8264018000,27.249908401787586,-80.0,-1.6989553839116525,39.42589655538797,34.528188029026765,92.38757734615385,90.93781166855,-65.47181197097323
2019-06-07,88.184998,90.3125,87.974503,90.2015,90.2015,96164000,5903000633.306619,8360182000,26.674665537264534,-80.0,-1.4963147457013122,47.81189140616444,63.782634181897,92.18086596153846,90.88327006347222,-36.21736581810299
2019-06-10,91.099998,94.2435,90.900002,93.031502,93.031502,107420000,5932542420.034172,8467602000,25.166216010167847,-80.0,-1.0947435477222598,55.39069518612836,88.61278928683441,92.10357757692306,91.04239835506688,-11.387210713165596
2019-06-11,94.162498,94.684998,92.900002,93.184998,93.184998,80854000,5877507039.889902,8548456000,23.93080176764509,-76.0,-0.7554018336620487,55.765911053663075,86.46820027063598,91.91365438461538,91.20110943987673,-13.531799729364012
2019-06-12,92.698997,93.25,92.219002,92.765999,92.765999,53566000,5880780027.554281,8494890000,22.482295720056946,-72.0,-0.5143516721201564,54.42030685291246,82.68832656743346,91.7305198846154,91.31702718507104,-17.311673432566536
2019-06-13,93.335999,94.154503,93.111,93.514999,93.514999,55916000,5868160516.561021,8550806000,21.501840777918197,-68.0,-0.259883862682841,56.443578693162,89.44520523229599,91.63301973076923,91.47983991210282,-10.55479476770402
2019-06-14,93.199997,93.800003,92.949997,93.483498,93.483498,57024000,5882718037.218522,8493782000,20.51332213341393,-44.0,-0.06006575713868756,56.330325018166974,89.16102841677946,91.54051980769229,91.62825902972483,-10.838971583220536
2019-06-17,93.824997,94.7845,93.772499,94.301498,94.301498,52686000,5885112696.850282,8546468000,20.004936925217844,-44.0,0.1624249609615731,58.65050471013859,95.68150642737604,91.51390434615384,91.8262767312267,-4.318493572623969
2019-06-18,95.067497,96.083504,94.989502,95.068497,95.068497,77914000,5818450625.877832,8624382000,20.034400146666737,43.99999999999999,0.396075159348257,60.75593941109025,91.86921526692893,91.53580803846154,92.06644119558027,-8.130784733071069
2019-06-19,95.391998,95.978996,94.623497,95.439499,95.439499,57906000,5830262732.3640785,8682288000,19.8552403883866,44.0,0.6042163556985258,61.76995017261353,94.84115279793988,91.70140403846153,92.316297329241,-5.158847202060117
2019-06-20,96.666496,96.760002,95.290001,95.9095,95.9095,64344000,5820151407.928244,8746632000,19.996921872771626,52.0,0.7978972433724039,63.07172208464303,93.53722080935533,91.85153876923076,92.58246049003796,-6.462779190644667
2019-06-21,95.805,96.297501,95.378998,95.565002,95.565002,78672000,5773342791.472992,8667960000,20.12848325112915,52.0,0.9130673605713469,61.42083135273261,90.60202115528298,91.92875026923076,92.80338949077588,-9.39797884471702
2019-06-24,95.633003,95.843002,95.065002,95.695,95.695,45660000,5801630628.696642,8713620000,20.043509487187237,52.0,1.0032652431565907,61.82687803805397,90.31596712163343,91.94092326923078,93.01758286182952,-9.684032878366562
2019-06-25,95.592003,95.819504,93.621002,93.913498,93.913498,60246000,5757415284.130205,8653374000,19.06876326958556,52.0,0.9203857580805561,53.51444006973619,72.76984481464055,91.95875023076923,93.08394694613845,-27.230155185359443
2019-06-26,94.624001,95.190002,94.365997,94.891502,94.891502,48838000,5770869656.603673,8702212000,18.163641781812576,52.0,0.9229803750941699,56.93731627578957,78.73199917272773,92.033481,93.21783991309115,-21.26800082727227
2019-06-27,95.099998,95.561996,94.902,95.213997,95.213997,42834000,5768533112.642801,8745046000,17.5273757649344,52.0,0.9402209966849568,58.034631008281174,73.61766211604106,92.12340400000001,93.36570340101032,-26.382337883958943
2019-06-28,95.455002,95.647003,94.199997,94.681503,94.681503,60748000,5748214145.401478,8684298000,16.480464045343254,52.0,0.9005356831542457,55.518993184144136,54.22816560229035,92.18869253846154,93.46317003797253,-45.77183439770965
2019-07-01,96.149002,96.490997,95.733002,96.109497,96.109497,63842000,5747792600.127434,8748140000,15.996383071911472,52.0,0.9730947374176111,60.46787817279692,85.67485135432733,92.39390388461538,93.65919425738197,-14.32514864567267
2019-07-02,95.969002,96.739502,95.331497,96.7155,96.7155,52918000,5798906433.471776,8801058000,15.274298913655912,52.0,1.0671957202459765,62.38070845934976,98.83197003678488,92.60742307692308,93.88558727535367,-1.1680299632151196
2019-07-03,96.794502,97.079498,96.525002,96.949997,96.949997,33806000,5816921838.747918,8834864000,14.810486266619515,88.0,1.1474661002938689,63.12426533868403,96.86400366533378,92.80467284615384,94.11258058829044,-3.135996334666213
2019-07-05,96.43,97.294998,96.264999,97.1455,97.1455,52568000,5854229997.012149,8887432000,14.18790923583801,92.0,1.2128751433480005,63.767257399618465,95.9309155480842,93.0425958076923,94.33724128545411,-4.069084451915796
2019-07-08,96.706001,97.800003,96.412498,97.615997,97.615997,57668000,5896602545.092335,8945100000,13.939280606693002,96.0,1.287832129862224,65.33385892588845,95.59689026157183,93.30413407692306,94.58011207912418,-4.403109738428174
2019-07-09,97.389999,99.500504,97.174004,99.415001,99.415001,86914000,5977128057.886661,9032014000,14.672742893875592,100.0,1.4753932545686723,70.57303263341687,98.5457441803744,93.71419173076923,94.93825199918905,-1.4542558196255864
2019-07-10,99.8255,101.247002,99.769997,100.870499,100.870499,98638000,6025478478.746441,9130652000,16.12944376593901,100.0,1.721637357919093,73.99710662210188,95.06290322580645,94.33865326923076,95.37767770295282,-4.937096774193549
2019-07-11,101.280998,101.790001,99.764999,100.053497,100.053497,86356000,5963728413.247246,9044296000,17.694401513951668,100.0,1.8297699020492502,69.134295885216,78.7427566094694,94.86078788461539,95.72403468791929,-21.2572433905306
2019-07-12,100.413498,100.849998,100.193497,100.550003,100.550003,50186000,5968048377.795664,9094482000,19.147576565677706,96.0,1.9332443693643455,70.40705686617864,84.8206861085428,95.38482634615386,96.0815138221475,-15.179313891457204
2019-07-15,101.07,101.144997,100.077499,101.0495,101.0495,59626000,6017006247.04132,9154108000,20.621020802917915,92.0,2.032128748379151,71.67258185145282,90.9352296407429,95.89757626923077,96.44951279828472,-9.064770359257102
2019-07-16,100.528999,101.316002,100.060997,100.495003,100.495003,52364000,6000859298.2626295,9101744000,22.063204728643363,88.0,2.0422107234092266,68.18654289333165,82.93811175857081,96.29348023076923,96.74917873915251,-17.061888241429195
2019-07-17,100.352501,100.599998,99.601501,99.601501,99.601501,51176000,5949683298.2626295,9050568000,22.925528718785888,80.0,1.9555601371973523,62.87931202875048,71.16602310091005,96.54617250000001,96.96046186958566,-28.833976899089944
2019-07-18,99.000504,99.375,97.577499,98.894997,98.894997,69738000,5982175756.575587,8980830000,21.967121744770473,80.0,1.8090266222199887,58.97081136114673,61.85767491031629,96.76578784615384,97.10376076813486,-38.14232508968371
2019-07-19,99.560501,99.800003,98.111504,98.225998,98.225998,63712000,5927104142.774218,8917118000,21.334842774431507,72.0,1.620238032169695,55.4556616434387,44.81689567738911,96.9757878076923,97.18688945197673,-55.18310432261089
2019-07-22,98.556999,99.449997,97.913002,99.281502,99.281502,58000000,5972387497.6322365,8975118000,20.588904781837325,72.0,1.5380622418776397,59.552231705194885,61.15975154617852,97.19757638461539,97.34204593701548,-38.84024845382148
2019-07-23,99.7995,99.889503,98.656502,99.724503,99.724503,54070000,6011986219.831163,9029188000,20.181217818132676,44.0,1.4914908364707173,61.16645788443163,62.615434347354,97.43761503846153,97.5185242379773,-37.384565652646
2019-07-24,98.464996,100.065002,98.293503,100.040497,100.040497,52626000,6063156277.569836,9081814000,19.488386490943082,44.0,1.4632137201380004,62.32156301752855,68.33478069329203,97.65834576923076,97.70533703516416,-31.66521930670797
2019-07-25,100.050003,100.059998,98.636002,98.691002,98.691002,82730000,5986816955.633537,8999084000,18.845043115695606,44.0,1.3167324612432765,54.821839717825476,42.37104098314769,97.7976728846154,97.77834925478163,-57.62895901685231
2019-07-26,97.099998,97.544998,96.225502,97.152496,97.152496,98542000,6026733644.023649,8900542000,18.54772729121717,44.00000000000001,1.064232620670552,47.76473057845061,16.659073889670818,97.8635573846154,97.73198975442745,-83.34092611032918
2019-07-29,96.5,96.611504,94.527,95.622498,95.622498,89864000,6031324566.894509,8810678000,19.169715156915288,44.0,0.7322259806700373,41.97755428370666,15.083269298737418,97.85251884615384,97.57573110595133,-84.91673070126258
2019-07-30,94.556,95.494499,94.174004,94.926498,94.926498,58218000,6039458496.575424,8752460000,19.913182922870984,44.0,0.40824099513493195,39.625551866998265,9.880439816349691,97.82796100000002,97.3794916166216,-90.11956018365031
2019-07-31,94.905502,94.977501,92.472,93.338997,93.338997,89414000,6011925669.0499115,8663046000,21.318909210682957,-56.0,0.023116029315289666,34.83169859989211,9.803220306825029,97.7373455,97.08019571909408,-90.19677969317497
2019-08-01,93.585999,94.896004,92.2005,92.765999,92.765999,94266000,5957212441.914651,8568780000,22.727126607831643,-60.0,-0.3245927277150713,33.26728853995084,6.203706608807599,97.69321092307692,96.76062559175378,-93.7962933911924
2019-08-02,92.253502,92.318001,90.401001,91.162003,91.162003,99124000,5936788037.374224,8469656000,24.647431741995995,-64.0,-0.7212691529928179,29.300123602771436,6.97207448721264,97.54976865384616,96.34591280717942,-93.02792551278736
2019-08-05,88.511002,89.433502,87.439003,88.2565,88.2565,121164000,5914948435.639653,8348492000,27.168387846209704,-68.0,-1.2556139516806155,23.770413961918848,6.211513643155423,97.28217261538461,95.74669704368465,-93.78848635684459
2019-08-06,89.611504,89.688499,87.669998,89.391502,89.391502,101406000,5986513204.16937,8449898000,29.296200247999092,-68.0,-1.5694097004909082,29.37748474024704,15.464114958349054,97.07871103846153,95.27594185526355,-84.53588504165094
2019-08-07,88.699501,89.946503,87.849998,89.669998,89.669998,90538000,6053169353.47977,8540436000,31.048722624243826,-68.0,-1.7751598546814193,30.72397268685434,17.669849332318226,96.831038,94.86068675487365,-82.33015066768176
2019-08-08,90.300003,91.712997,89.905502,91.644501,91.644501,74024000,6121582994.497864,8614460000,31.268990808264512,-68.0,-1.7586201651761968,39.52721716213903,33.30823960939648,96.63599957692307,94.62245077303116,-66.69176039060352
2019-08-09,91.447502,91.554497,90.111,90.378998,90.378998,57596000,6085373409.305792,8556864000,31.473525550569438,-68.0,-1.8265722698068458,36.33984400244879,23.285246577320294,96.38326884615384,94.30812093799182,-76.7147534226797
2019-08-12,89.7995,90.049004,88.849998,89.246002,89.246002,58110000,6065648192.100874,8498754000,32.11442768639498,-68.0,-1.9493769071122529,33.71832760630795,14.311730897491783,96.079442,93.93314916480723,-85.68826910250822
2019-08-13,89.150002,91.586998,89.0,91.217003,91.217003,79880000,6122679159.670235,8578634000,31.58775050209511,-68.0,-1.8661453960881573,41.6097134370288,29.93424844871587,95.83332684615385,93.7319531525993,-70.06575155128412
2019-08-14,89.650497,89.782501,87.861,88.148003,88.148003,97872000,6054044258.808877,8480762000,31.538859649119782,-68.0,-2.024489421398755,34.68507389835355,7.015637747693351,95.39998076923077,93.31832721536973,-92.98436225230665
2019-08-15,89.099503,89.400002,88.098,88.806,88.806,75182000,6060626888.970736,8555944000,31.493460999928406,-68.0,-2.072987236996539,37.101933648526874,14.903209059339414,94.93596157692308,92.98408075497198,-85.09679094066058
2019-08-16,89.644501,90.1455,89.227501,89.628502,89.628502,60360000,6052999888.374874,8616304000,30.904146948051988,-56.0,-2.021747619735592,40.08637035129778,27.180188532152414,94.53500023076923,92.73551936571481,-72.81981146784757
2019-08-19,90.903999,91.300003,90.630501,90.806,90.806,56326000,6026203767.819595,8672630000,29.57418889623208,-56.0,-1.8646312971552277,44.170475421277004,44.664029890304356,94.1602308846154,92.5925920052915,-55.335970109695644
2019-08-20,90.724998,90.841003,89.994003,90.069,90.069,38590000,5994447614.879807,8634040000,28.65340391586428,-56.00000000000001,-1.7790771265050296,42.23010164860057,35.268829922377655,93.73790396153846,92.40565926415879,-64.73117007762234
2019-08-21,90.969498,91.478996,90.75,91.177002,91.177002,40636000,6001415863.111623,8674676000,27.37041659577746,-52.0,-1.6033854984855793,46.06605444499075,76.61407116789155,93.3795193076923,92.31464761496183,-23.38592883210845
2019-08-22,91.400002,91.470497,90.004997,90.233002,90.233002,53070000,5964859306.100364,8621606000,26.56601759438552,-32.0,-1.5227680064648155,43.42069578325518,65.37208522052202,93.01919242307692,92.16045164348319,-34.62791477947797
2019-08-23,89.651497,90.245003,87.261497,87.481003,87.481003,105416000,5874954885.092328,8516190000,26.981031224562365,-88.0,-1.661785355947515,36.78825093755166,4.931056947096389,92.58019265384615,91.81382581803999,-95.0689430529036
2019-08-26,88.345497,88.5,87.175499,88.443497,88.443497,61600000,5931299192.873144,8577790000,27.39781386915553,-92.0,-1.6749842097479473,40.227118898424536,27.944871821430922,92.20394261538462,91.56417183151851,-72.05512817856908
2019-08-27,88.786499,88.970001,87.334,88.091499,88.091499,60394000,5926832291.458047,8517396000,27.435090394575855,-92.0,-1.6943166654634325,39.38328592762834,20.18733672169105,91.77355788461539,91.30693680696159,-79.81266327830895
2019-08-28,87.75,88.392998,87.202499,88.212502,88.212502,48394000,5960551901.267042,8565790000,27.526266213886895,-92.0,-1.6805020633548793,39.85038717043048,23.506817070569447,91.33078861538462,91.07771941385332,-76.49318292943056
2019-08-29,89.150002,89.927498,88.862503,89.32,89.32,60302000,5952058565.334008,8626092000,26.49565070472091,-88.0,-1.5621802176760582,44.09647816809755,48.61161704898936,90.9184618076923,90.9475179757901,-51.38838295101064
2019-08-30,89.874496,89.987,88.2285,88.814499,88.814499,61174000,5931655566.557778,8564918000,25.856539731920883,-84.0,-1.4920001594641406,42.617676337030204,37.15290426224734,90.5385963076923,90.78951657017602,-62.84709573775266
2019-09-03,88.5,90.040001,88.400002,89.491997,89.491997,70860000,5955159972.511684,8635778000,25.224545951589374,-80.0,-1.3659675080506446,45.266947579366935,53.82827035780435,90.24396173076921,90.69340400942224,-46.17172964219565
2019-09-04,90.25,90.3815,89.811501,90.030998,90.030998,46482000,5944476840.769346,8682260000,24.379755391599645,-76.0,-1.2086601656833693,47.349597282320836,66.35299153223528,90.02890403846155,90.64433689761319,-33.64700846776472
2019-09-05,91.097504,92.099998,90.778999,92.036003,92.036003,66216000,6004277252.3851,8748476000,22.84198122433033,-72.0,-0.9116963485502367,54.31367149136416,98.70047694191824,89.91773115384613,90.74742327556777,-1.2995230580817583
2019-09-06,91.911003,92.032501,91.32,91.675499,91.675499,49938000,6004171909.636108,8698538000,21.41404806900882,-68.0,-0.6974008411262531,52.95733597583818,91.3798540724651,89.85375046153845,90.8161696255257,-8.620145927534914
2019-09-09,92.050003,92.5,91.230499,91.567497,91.567497,59990000,5976031447.399372,8638548000,20.38824493921559,36.0,-0.5301734567783996,52.53407768093486,82.48656540772558,89.80765423076923,90.8718235051164,-17.513434592274418
2019-09-10,91.137497,91.290497,90.266998,91.027496,91.027496,52278000,6001442462.130212,8586270000,19.09793450737109,36.0,-0.4361899909015534,50.36652918980061,72.34475117950018,89.80248088461538,90.8833548010337,-27.65524882049982
2019-09-11,90.607002,91.670998,90.454002,91.149498,91.149498,48656000,6008398893.684629,8634926000,17.830289176962452,35.99999999999999,-0.3478530419564123,50.859840802183946,74.63608326864797,89.91375003846154,90.90306911206824,-25.363916731352035
2019-09-12,91.8815,92.682999,91.713997,92.177498,92.177498,56470000,6005951282.637387,8691396000,17.310407514191844,48.0,-0.19267334643578238,54.925134958067126,90.82158874262377,90.02090373076923,90.99747125191503,-9.178411257376231
2019-09-13,92.100502,92.306,91.758499,91.967003,91.967003,39426000,5996554373.740418,8651970000,16.827660255904853,48.0,-0.08568972918816087,53.94110435915507,86.99961870177049,90.10925007692308,91.06928841843984,-13.000381298229518
2019-09-16,91.200996,91.2845,90.010002,90.391998,90.391998,73510000,5967109607.204888,8578460000,16.115410261347414,48.0,-0.12653555921708914,47.13627053283437,58.1972265304261,90.06107688461537,91.01911875781467,-41.8027734695739
2019-09-17,90.353996,91.199501,90.205002,91.127502,91.127502,39648000,6001016794.289039,8618108000,15.454035266401222,48.0,-0.09842259346520166,50.29003279856055,71.61760788249265,90.0898655,91.02714714612469,-28.382392117507354
2019-09-18,90.851997,91.102997,89.775002,90.873001,90.873001,50112000,6033770958.526103,8567996000,15.125860914433076,48.0,-0.09557721467423619,49.19634558449002,59.36696809225923,90.15244238461538,91.01572891307842,-40.63303190774077
2019-09-19,91.051003,91.628502,90.894997,91.074997,91.074997,40630000,6013081926.8903265,8608626000,14.39717296875958,48.0,-0.07614508924342545,50.12348548572392,63.90161946382748,90.14698061538462,91.02011914173927,-36.09838053617252
2019-09-20,91.085503,91.531502,89.045998,89.708,89.708,106838000,5963155498.689044,8501788000,14.865893121977772,48.0,-0.16910093297435935,44.23951899497257,30.539316277830675,90.2069805,90.92292513124008,-69.46068372216932
2019-09-23,88.849998,89.635002,88.365997,89.264999,89.264999,58446000,5987519370.82036,8443342000,15.654640686585749,48.0,-0.27534162042195476,42.49841971008067,20.824683426137156,90.2246343076923,90.80011578818525,-79.17531657386284
2019-09-24,89.530502,89.7855,86.777496,87.080498,87.080498,92320000,5913798511.40661,8351022000,17.107244817520844,-32.0,-0.5297030180470443,35.15172480098805,5.13084152188233,90.12663415384615,90.52458854461598,-94.86915847811767
2019-09-25,87.367996,88.650002,86.150002,88.416496,88.416496,69864000,5970611580.859409,8420886000,18.70629147330566,-36.0,-0.6163771726758398,41.78039924848759,34.6930206764215,90.03473015384614,90.36843354131109,-65.3069793235785
2019-09-26,88.139503,88.168503,86.574997,86.991997,86.991997,70736000,5936896981.469134,8350150000,20.191120510820134,-36.0,-0.7908952804599352,37.39162154237024,12.888342058017138,89.91638388461539,90.11832713084361,-87.11165794198286
2019-09-27,87.400002,87.456001,85.691002,86.272499,86.272499,78144000,5910243663.97717,8272006000,21.924592965127832,-43.99999999999999,-0.9760087919094786,35.37062373426201,8.316608259414284,89.72774915384615,89.83345097300335,-91.68339174058572
2019-09-30,86.349503,86.873001,85.460999,86.795502,86.795502,52894000,5957331394.430809,8324900000,23.623425947805806,-48.0,-1.0681971009721138,37.99413878116604,18.478302409304888,89.5955376153846,89.60841771574384,-81.52169759069511
2019-10-01,87.300003,87.779999,86.420502,86.782501,86.782501,61690000,5928494307.397884,8263210000,24.29392359664792,-48.0,-1.1292883391155186,37.95289525694007,18.298283024093,89.56867215384615,89.39909055161466,-81.701716975907
2019-10-02,86.387001,86.444504,85.25,85.661499,85.661499,66022000,5907960622.176237,8197188000,25.433452069303378,-56.0,-1.2537071229701269,34.47760875794336,5.831901927437733,89.46167223076924,89.12223191816172,-94.16809807256227
2019-10-03,85.650002,86.25,84.252998,86.221001,86.221001,69364000,5975310115.795172,8266552000,26.876398191669562,-60.0,-1.292266328292456,37.551224471841124,26.68296295412487,89.38973,88.90732592422381,-73.31703704587513
2019-10-04,86.301003,87.028999,85.961502,86.982498,86.982498,49438000,6020441000.294146,8315990000,27.48273606387324,-60.0,-1.2470036506584847,41.56872921031612,37.00764042701359,89.34242215384614,88.76474607798501,-62.99235957298641
2019-10-07,86.581497,87.391502,86.184998,86.633003,86.633003,43094000,6009350752.407691,8272896000,27.715741847382382,-60.0,-1.2252105140431553,40.28769037815008,32.26904900329522,89.23907611538462,88.60683918331945,-67.73095099670478
2019-10-08,86.124496,86.349998,85.25,85.275497,85.275497,50840000,5960867606.656517,8222056000,28.360489314947245,-60.0,-1.302464683201606,35.68729975391052,13.863445806550947,89.10296065384615,88.36007309566617,-86.13655419344906
2019-10-09,85.980499,86.497498,85.718002,86.099503,86.099503,40870000,5960002804.55362,8262926000,28.817568907777535,-60.0,-1.2824158791724471,40.15442072620787,25.369292920633058,88.97248011538461,88.19262345895015,-74.63070707936696
2019-10-10,86.262001,86.914497,85.6875,86.013,86.013,51504000,5935824954.495308,8211422000,28.835057920161372,-60.0,-1.2589942249710049,39.841558760642,31.81204453247377,88.81794173076923,88.0311698693983,-68.18795546752622
2019-10-11,87.146004,87.272499,86.492996,86.596001,86.596001,65100000,5887929828.626645,8276522000,28.504516399617255,-60.0,-1.1797892112807347,43.0615020592746,42.349790384169744,88.60871088461539,87.92486106425768,-57.650209615830256
2019-10-14,86.445503,87.094498,86.099998,86.821503,86.821503,38204000,5905159467.681447,8314726000,28.428087466382784,-60.0,-1.0863003462951326,44.30328870006127,58.41488886523652,88.42201873076925,87.84313083727564,-41.58511113476348
2019-10-15,87.107002,88.822502,87.030998,88.369003,88.369003,62234000,5935885799.525529,8376960000,26.829864256920843,-60.0,-0.8772272999811292,52.03430611809431,90.07553117362423,88.29899973076924,87.88208433081078,-9.924468826375776
2019-10-16,88.666496,89.311996,88.526001,88.871498,88.871498,55268000,5929205712.161107,8432228000,24.976945260080754,-60.0,-0.6633416676840369,54.25474548298238,91.29278169313386,88.21607673076923,87.95537423223222,-8.707218306866142
2019-10-17,89.824501,89.942497,89.100998,89.374001,89.374001,52948000,5910612982.563092,8485176000,23.585324175727067,-60.0,-0.4481222957397648,56.42703114586649,90.00797785534374,88.14778838461538,88.0604576965113,-9.992022144656257
2019-10-18,89.389999,89.698997,87.459999,87.875504,87.875504,67250000,5868322997.042784,8417926000,22.643233629437333,-56.00000000000001,-0.3939345451197198,48.96050368213327,63.67003491871609,87.98232707692308,88.04675742269565,-36.32996508128391
2019-10-21,88.483002,89.293999,88.25,89.282997,89.282997,42608000,5910032963.201755,8460534000,21.768435265025435,-40.0,-0.2347118283078089,54.98552642727482,88.40846970884417,87.87909607692308,88.1383307247182,-11.591530291155841
2019-10-22,89.407501,89.488998,88.099998,88.286499,88.286499,42234000,5879140479.737392,8418300000,20.795761251916502,-40.0,-0.1867826247849962,50.44520045468857,70.89378168446822,87.79811534615384,88.14930615251686,-29.106218315531777
2019-10-23,88.065002,88.502502,87.099998,88.108498,88.108498,42764000,5897877187.043753,8375536000,20.555003074528283,-40.0,-0.1613021875544547,49.65644037024129,60.91635221077382,87.6819998076923,88.14628332640449,-39.08364778922618
2019-10-24,88.554497,89.417,88.013496,89.039001,89.039001,88922000,5938901315.604839,8464458000,19.572815385201995,-40.0,-0.06527252092020319,53.72940101024367,80.74594400380003,87.61146134615385,88.21241056148563,-19.254055996199966
2019-10-25,84.877502,88.210503,84.75,88.066498,88.066498,192528000,6115405636.596325,8271930000,20.377847600954244,-36.0,-0.06687034311936202,49.24517177791194,63.87096612670154,87.49574984615386,88.2016022235978,-36.12903387329846
2019-10-28,87.403,88.934998,87.125,88.853996,88.853996,74178000,6182944329.41919,8346108000,20.582513892603345,40.0,-0.004539789650095827,52.68855391522385,79.03704133098185,87.46290353846153,88.24992768851648,-20.96295866901815
2019-10-29,88.740501,88.849998,87.790497,88.135498,88.135498,45538000,6167063036.752171,8300570000,20.772561163420367,40.0,-0.012969654713799628,49.39580429234604,65.19980656705235,87.4194611923077,88.24145141529304,-34.80019343294765
2019-10-30,88.012001,89.119003,87.956001,88.999496,88.999496,48988000,6205983282.928874,8349558000,20.734217297596206,40.0,0.04949646986267453,53.18461482015163,81.83916138998234,87.49326880769232,88.29760286601207,-18.160838610017667
2019-10-31,88.7995,89.599998,88.573997,88.833,88.833,55624000,6178442652.968473,8293934000,20.313168763388354,40.0,0.08459137122756033,52.37088169254137,78.63268866597315,87.5092881923077,88.33726191297414,-21.367311334026848
2019-11-01,89.400497,89.872498,89.260498,89.571999,89.571999,55808000,6179445920.31488,8349742000,19.703571428124,40.00000000000001,0.17007485951940282,55.616812078983436,92.86474310914387,87.60851903846152,88.4287239194205,-7.135256890856125
2019-11-04,90.050499,90.752998,90.050499,90.233002,90.233002,55438000,6152812520.218937,8405180000,18.459883447109775,88.0,0.2878405114914102,58.3509240299192,91.33772824845177,87.76084607692309,88.56237414761159,-8.662271751548237
2019-11-05,90.458,90.512497,89.699997,90.085503,90.085503,37710000,6150886966.397399,8367470000,17.55004428929595,88.0,0.36506051219322444,57.499719637731125,88.88063930722613,87.88738457692308,88.67519850704778,-11.119360692773874
2019-11-06,90.050003,90.125,89.429001,89.788498,89.788498,40596000,6152228211.169303,8326874000,16.896449322159544,88.0,0.3977075724331911,55.73658356562314,83.93302813027756,88.00299984615384,88.75766513615535,-16.066971869722433
2019-11-07,90.188004,90.294998,89.174004,89.410004,89.410004,53022000,6121531383.293329,8273852000,16.472575418698863,88.0,0.3885602199438978,53.48577619580226,77.62794523669668,88.14717311538462,88.80598653347718,-22.372054763303325
2019-11-08,89.394501,89.494003,88.702003,89.293999,89.293999,42466000,6142549479.596359,8231386000,16.414900442962058,24.0,0.36771149397714,52.78223720667425,75.69549415142227,88.26536534615386,88.84213560507146,-24.304505848577733
2019-11-11,88.900002,89.0,88.356499,88.582497,88.582497,38920000,6130966941.8846855,8192466000,16.60214135761798,23.999999999999993,0.29042858338804933,48.56295054065169,63.84304975613852,88.32690376923077,88.82290311580691,-36.15695024386148
2019-11-12,88.733002,89.310997,88.595497,88.900002,88.900002,40752000,6124901700.123679,8233218000,16.458832808765322,24.0,0.25189760120699134,50.4658467859657,69.1321569655695,88.41409603846154,88.82861414426566,-30.86784303443051
2019-11-13,88.669502,88.75,87.365997,87.655502,87.655502,59790000,6090125379.935067,8173428000,17.161825470015607,24.0,0.11956252854427873,43.64955875305603,48.4008490424284,88.5056346923077,88.74171694839411,-51.5991509575716
2019-11-14,87.571503,88.329498,87.477997,87.730003,87.730003,45296000,6071640537.587259,8218724000,17.814604369748015,24.0,0.020461767585800317,44.13600431909199,16.675946348371625,88.56834623076924,88.666775174439,-83.32405365162838
2019-11-15,88.002502,88.084,86.642998,86.974503,86.974503,78552000,6029230584.246458,8140172000,18.933654618503077,24.0,-0.11768226755359024,40.33357863481936,8.065815085157977,88.60532711538461,88.54142168003611,-91.93418491484202
2019-11-18,86.915001,87.684998,86.135498,87.626503,87.626503,56790000,6081732838.457495,8196962000,20.25761077684859,24.0,-0.1725622692433717,44.756853604731035,32.29030860855439,88.6449618076923,88.47364992595935,-67.7096913914456
2019-11-19,87.849503,88.033997,87.151497,87.639503,87.639503,45416000,6086545236.182141,8242378000,21.06958525180974,24.000000000000007,-0.21255586294059015,44.844651079182555,32.5718462371414,88.67642334615383,88.41186126477719,-67.4281537628586
2019-11-20,87.457001,88.125999,86.706001,87.276497,87.276497,55800000,6075581463.8388,8186578000,22.093208908684783,23.999999999999996,-0.2704253296498962,42.79917614907627,24.710319436924877,88.6344038846154,88.32776020812702,-75.28968056307512
2019-11-21,87.150002,87.343498,86.517998,86.735497,86.735497,53258000,6050387816.938739,8133320000,23.156663321973124,24.0,-0.3558395804375465,39.879708719981515,12.994022739577606,88.55224999999999,88.2098147853028,-87.0059772604224
2019-11-22,86.950996,87.321503,86.550003,87.286003,87.286003,49582000,6095406859.064466,8182902000,24.14415670574087,24.0,-0.3747894170325594,44.06119686769359,26.28524703798187,88.47194238461537,88.14138428268777,-73.71475296201812
2019-11-25,87.662498,88.871002,87.662003,88.692001,88.692001,69724000,6144484579.416593,8252626000,23.205895032661882,24.0,-0.2732056660225908,53.04393638161517,61.46178627238854,88.5033461153846,88.18217070619238,-38.53821372761146
2019-11-26,88.996002,89.851501,88.917503,89.847,89.847,63624000,6207495362.634543,8316250000,21.669317887831504,24.0,-0.0983671298635187,58.884830218705304,89.22952277917992,88.52503853846154,88.30549139462258,-10.77047722082009
2019-11-27,90.050003,91.224998,89.865501,90.925499,90.925499,60512000,6241345614.226125,8376762000,21.27617862506617,92.0,0.12576973043049122,63.455992351122134,94.11535514294141,88.62653853846155,88.49956603205794,-5.884644857058595
2019-11-29,90.889,91.234497,90.039497,90.040001,90.040001,38468000,6202910062.547464,8338294000,20.917678999035992,96.0,0.22930424227986634,57.77627651138676,76.57391185995527,88.70082711538461,88.61367232597958,-23.42608814004473
2019-12-02,90.220001,90.277496,88.134003,89.080002,89.080002,78512000,6193698287.449528,8259782000,19.85114002415534,96.0,0.23122675450055397,52.30982939479273,57.74670675558068,88.70240407692307,88.64821526479591,-42.25329324441932
2019-12-03,88.0,88.643501,87.361504,88.498001,88.498001,67618000,6245967703.950502,8192164000,19.378480743164285,32.0,0.18367050334012447,49.266526502243224,46.33268215977294,88.71900034615383,88.63708828221843,-53.66731784022706
2019-12-04,88.7005,89.454498,88.011002,88.0345,88.0345,53402000,6194304316.590924,8138762000,18.291136912928817,31.999999999999993,0.10734378230739594,46.92510934484113,37.242643114854374,88.68748126923077,88.59245211316522,-62.757356885145626
2019-12-05,88.175003,88.175003,87.0,87.024002,87.024002,56476000,6140135607.639543,8082286000,17.94671148549639,32.0,-0.03428917328584191,42.2146865712956,17.425067155337672,88.64473142307692,88.47627062330113,-82.57493284466233
2019-12-06,87.559998,87.720001,87.0065,87.580002,87.580002,62348000,6178016486.634806,8144634000,17.626887874309137,32.0,-0.10051112797243889,45.45885125492752,28.32916813672631,88.5901355,88.40988035490845,-71.67083186327369
2019-12-09,87.532997,88.344498,87.280502,87.475502,87.475502,48856000,6147068298.318309,8095778000,16.80241452960647,32.0,-0.15958518218022277,44.948084304717,20.30115982214775,88.53792403846154,88.34066714343376,-79.69884017785225
2019-12-10,87.370003,87.533501,86.75,86.960503,86.960503,50286000,6123802950.131134,8045492000,16.4137981421427,32.0,-0.24513217983951563,42.41858102831096,9.382064959623593,88.4374818846154,88.23843276243866,-90.61793504037641
2019-12-11,87.083504,87.5,86.7855,87.435997,87.435997,41952000,6158239054.103143,8087444000,16.052940068069198,32.0,-0.27143150644050706,45.46987393898335,19.463568210233795,88.32990476923077,88.17899307633209,-80.5364317897662
2019-12-12,87.5,88.199997,87.272003,88.016502,88.016502,61918000,6195670595.332936,8149362000,15.087987592324733,32.0,-0.24263506424537695,49.021553230551554,31.305387518908095,88.2503278076923,88.1669567003075,-68.69461248109191
2019-12-13,88.25,88.449501,87.75,88.046997,88.046997,54914000,6187387817.46986,8204276000,14.044653572470372,31.999999999999996,-0.21487602760538493,49.20870497686869,28.921794350626243,88.183347,88.15807079658101,-71.07820564937376
2019-12-16,88.349998,88.474998,87.852501,88.460503,88.460503,62904000,6247362346.388072,8267180000,13.098845649387771,32.00000000000001,-0.15769253134776307,51.79307432767367,38.14258321501834,88.14682773076923,88.18047318201945,-61.85741678498166
2019-12-17,88.900497,89.599998,88.869499,89.532997,89.532997,72888000,6306879845.160828,8340068000,13.164863643300622,32.0,-0.02553850400806823,57.79181045920605,62.0581750863027,88.15601996153845,88.2806601314995,-37.9418249136973
2019-12-18,89.750999,89.910004,89.117996,89.2015,89.2015,67028000,6253985808.736952,8273040000,13.45980094694402,32.0,0.05184780805588218,55.49322984200763,54.66610859590258,88.17982776923077,88.34887049212917,-45.33389140409742
2019-12-19,89.025002,89.649498,88.703003,89.613998,89.613998,53056000,6303061887.025797,8326096000,13.298060917958638,32.0,0.14479307468086233,57.74536634191356,81.1906803012674,88.20728915384615,88.44258364086033,-18.809319698732594
2019-12-20,89.981003,90.148499,89.122498,89.324997,89.324997,103016000,6240709857.1076975,8223080000,13.548007474859261,32.0,0.19290916591488383,55.62175281641604,75.76865551527293,88.2715005,88.5079475933892,-24.231344484727067
2019-12-23,89.413002,89.650002,89.225502,89.650002,89.650002,42728000,6283437857.1076975,8265808000,13.780100706266987,32.0,0.2543348879254239,57.51400708851141,85.3318479717075,88.34534661538461,88.59254421610112,-14.668152028292498
2019-12-24,89.690498,89.778503,89.378998,89.460503,89.460503,17626000,6273003792.7780905,8248182000,14.105510329253379,32.0,0.2844453209772553,56.0142886260281,79.75588634864985,88.440962,88.65683745935289,-20.24411365135014
2019-12-26,90.050499,93.523003,89.974998,93.438499,93.438499,120108000,6387390489.43607,8368290000,16.549618170856597,92.0,0.6221275882289632,72.32719626350406,98.7523407268532,88.66450030769231,89.01103461051193,-1.2476592731467806
2019-12-27,94.146004,95.07,93.300499,93.489998,93.489998,123732000,6290159848.031516,8492022000,19.33750989762023,96.0,0.8837118763808149,72.46954456529726,81.00959134615393,88.88951934615385,89.34280967639994,-18.99040865384609
2019-12-30,93.699997,94.199997,92.030998,92.344498,92.344498,73494000,6237911011.353399,8418528000,20.69935881845326,96.0,0.9872071234925954,64.51947493052592,67.24156250000007,89.08444246153846,89.56515695962958,-32.75843749999993
2019-12-31,92.099998,92.663002,91.611504,92.391998,92.391998,50130000,6262200866.112989,8468658000,21.590213172411513,92.0,1.060832093469159,64.69244313111741,67.67454885629797,89.3020001923077,89.7745525922496,-32.325451143702026
2020-01-02,93.75,94.900497,93.207497,94.900497,94.900497,80580000,6342780866.112989,8549238000,23.269045635516985,48.0,1.3065344022146803,72.3567147890123,97.82632642715825,89.59486534615385,90.15425217800889,-2.173673572841742
2020-01-03,93.224998,94.309998,93.224998,93.748497,93.748497,75288000,6340143912.586722,8473950000,24.827961494114923,48.0,1.392249494226519,65.34187079138772,81.94668032786893,89.78934596153847,90.42049253519342,-18.053319672131064
2020-01-06,93.0,95.184502,93.0,95.143997,95.143997,81236000,6418367359.446465,8555186000,26.568950162350422,68.0,1.5548610393158526,69.23308527534046,99.44755872237339,89.99307661538461,90.77038175480871,-0.5524412776266133
2020-01-07,95.224998,95.694504,94.601997,95.343002,95.343002,80898000,6447209292.444606,8636084000,28.34842792895393,72.0,1.6804190756187012,69.75459013315684,94.97243867947674,90.16298057692308,91.10909436556362,-5.027561320523253
2020-01-08,94.902,95.550003,94.321999,94.598503,94.598503,70160000,6408644500.017219,8565924000,29.721107431571276,72.0,1.7002504479286955,65.29553627984585,84.32380972269043,90.33830757692309,91.36756907922558,-15.676190277309567
2020-01-09,95.494499,95.890999,94.790001,95.052498,95.052498,63346000,6375504067.98737,8629270000,31.118548530048514,80.0,1.7326278997621358,66.69373065474781,88.33470413728674,90.56801896153846,91.64052677706071,-11.66529586271325
2020-01-10,95.268501,95.347,94.0,94.157997,94.157997,57074000,6331819111.458787,8572196000,31.609774571483577,80.0,1.6668935967853429,61.44133648295391,74.39607381309393,90.78571111538461,91.827006052834,-25.603926186906065
2020-01-13,94.565498,94.900002,94.040001,94.565002,94.565002,55616000,6344106417.654943,8627812000,32.06591303853042,80.0,1.6288640591620833,62.87403130428884,80.1065546950214,91.03688426923077,92.02982056743889,-19.893445304978595
2020-01-14,94.293999,94.355499,92.927498,93.472,93.472,68818000,6327769527.452485,8558994000,31.40588315946847,80.0,1.4933152412616835,56.77330183664078,62.853215163818305,91.2848841923077,92.13664867355453,-37.146784836181695
2020-01-15,93.612503,93.943001,92.754501,93.100998,93.100998,57932000,6303616684.716263,8501062000,30.634404461774093,80.0,1.3405025863110893,54.8285802376773,52.83974766062426,91.4972301923077,92.20808195699493,-47.16025233937574
2020-01-16,94.149498,94.279503,93.301003,93.897003,93.897003,53190000,6315222269.795465,8554252000,30.1249416231883,80.0,1.26900016335766,58.14157250527253,53.40581073234115,91.74421099999998,92.33318721943975,-46.59418926765885
2020-01-17,94.294502,94.332001,92.862503,93.236,93.236,79946000,6275915442.032516,8474306000,29.222189999230977,76.0,1.1457886221450622,54.562865295648514,37.95999294309279,91.98557626923078,92.40006224022198,-62.04000705690721
2020-01-21,93.25,94.713501,93.0,94.599998,94.599998,74156000,6340247195.104151,8548462000,28.641152582074177,72.0,1.1450069004298342,60.030096948607074,69.83286579374447,92.26111476923076,92.56302044464998,-30.167134206255533
2020-01-22,94.804497,95.125,94.167,94.373001,94.373001,64326000,6303585538.164694,8484136000,28.37359071129571,68.0,1.1132379059186945,58.762880838561706,51.60213716061681,92.50559550000001,92.69709307837961,-48.39786283938319
2020-01-23,94.255501,94.499001,93.638,94.228996,94.228996,49692000,6322111282.933863,8434444000,27.566522212050394,64.0,1.0641736178439345,57.92745438704049,47.01087008504375,92.7433646923077,92.81056736887001,-52.98912991495625
2020-01-24,94.568497,94.749496,92.372002,93.082001,93.082001,75324000,6291775799.982487,8359120000,25.655069134538717,52.0,0.9221074249894343,51.63115177381547,20.176175199922326,92.9211146153846,92.83067356376853,-79.82382480007767
2020-01-27,91.0,92.050003,90.766998,91.417,91.417,70570000,6292710807.585731,8288550000,24.913202030537068,52.00000000000001,0.667473063921193,44.13229116094724,12.685438585980009,92.99357626923077,92.72595700348938,-87.31456141401999
2020-01-28,92.025002,92.905502,91.500999,92.662498,92.662498,56160000,6329437449.821454,8344710000,23.533861886808317,52.0,0.559722643552405,49.98427665733656,36.99257669934102,93.12669157692306,92.72125633656424,-63.00742330065898
2020-01-29,93.199997,93.737503,92.750999,92.900002,92.900002,41760000,6300292432.183412,8386470000,22.061715600784407,48.0,0.4878703809437752,51.03749540837262,41.62770460036996,93.25307634615386,92.734496756078,-58.37229539963004
2020-01-30,92.900002,93.643501,92.530502,93.533997,93.533997,126548000,6401939219.887623,8513018000,20.529129772391908,44.0,0.4765911964960452,53.83229033635,60.414798945502696,93.41496096153847,92.79371899636853,-39.585201054497304
2020-01-31,102.573502,102.786003,100.113503,100.435997,100.435997,311346000,6165734261.551984,8824364000,22.666037844515557,100.0,1.012909884504296,72.34152234271257,80.44758280739549,93.82980692307693,93.3598136633042,-19.5524171926045
2020-02-03,100.529999,102.425003,100.012497,100.209999,100.209999,117834000,6067193436.920667,8706530000,24.58657811128303,96.0,1.4035311257129877,71.33307016155459,78.56724412711368,94.24324907692306,93.86723479935574,-21.432755872886307
2020-02-04,101.494003,102.989998,100.768501,102.483498,102.483498,105786000,6124741146.254507,8812316000,26.494228438188163,24.0,1.8749404955977127,75.09438578265261,95.85617278900432,94.59113365384616,94.50547651792199,-4.143827210995686
2020-02-05,103.551003,103.551003,101.599998,101.9935,101.9935,87524000,6072522918.457039,8724792000,28.38937592805286,28.0,2.183823318207132,72.87505660694433,87.8167835510077,94.91819142307692,95.06014492400185,-12.183216448992297
2020-02-06,102.051003,102.815002,101.239998,102.511497,102.511497,63660000,6111648214.672159,8788452000,29.88689880896765,28.0,2.4422603522377955,73.75799202158056,91.86869842432017,95.30922984615384,95.61209692963133,-8.131301575679839
2020-02-07,102.099503,104.926498,101.904999,103.963997,103.963997,101906000,6148629733.872397,8890358000,31.753545731123296,36.0,2.732776429016951,76.1066054062325,93.20243652671358,95.75430673076923,96.23075619410308,-6.797563473286411
2020-02-10,104.250504,106.779999,104.248001,106.695503,106.695503,101124000,6243004460.370602,8991482000,33.83445048240621,40.0,3.1471439030858903,79.77283877311434,99.47232876585717,96.20796080769232,97.00592262416951,-0.5276712341428158
2020-02-11,107.544998,109.297501,106.800003,107.540001,107.540001,114920000,6196185071.59031,9106402000,36.15590268451179,43.99999999999999,3.503293258517857,80.75598708935408,90.51563791873328,96.73840326923076,97.78622472608288,-9.48436208126673
2020-02-12,108.160004,109.012497,107.764503,108.0,108.0,66686000,6154666424.866047,9173088000,38.31153687218125,44.0,3.779099160824728,81.28946119399853,92.99802601149037,97.23286492307693,98.54280067229897,-7.001973988509633
2020-02-13,107.249496,108.514,107.099998,107.4935,107.4935,60636000,6127779156.865011,9112452000,39.827271703645444,44.0,3.911715190713892,78.70236410535111,90.2646949195065,97.70019176923077,99.20581543731386,-9.735305080493497
2020-02-14,107.783997,107.952003,106.294502,106.7435,106.7435,52124000,6103894743.751535,9060328000,40.65718344873327,44.0,3.9112096279123705,74.90105726306943,85.64885953430624,98.16730703846154,99.76416244195727,-14.351140465693758
2020-02-18,106.250999,108.303497,106.205498,107.783501,107.783501,58912000,6133603675.159034,9119240000,41.50849987916443,44.0,3.949204384943485,76.58959674821267,90.97035790364157,98.656961,100.35818752033082,-9.029642096358424
2020-02-19,108.389999,109.254997,108.056,108.511002,108.511002,51224000,6121257207.709991,9170464000,42.514158265769545,44.0,3.992001446606693,77.71881675594939,95.30924406925776,99.20899965384616,100.96209970401001,-4.69075593074224
2020-02-20,108.653503,108.8395,106.372498,107.654999,107.654999,62626000,6123744983.561005,9107838000,42.248231611871425,44.0,3.9117538744441873,73.24212704446414,82.31016378668234,99.71246107692308,101.45787002223149,-17.68983621331766
2020-02-21,107.107498,107.227501,104.400002,104.7985,104.7985,92926000,6057012326.262806,9014912000,40.81278643908707,44.0,3.576434587143723,60.68103815690205,51.545513604517645,100.14809569230769,101.70532409465878,-48.454486395482355
2020-02-24,100.158997,101.964996,99.398499,100.4645,100.4645,130940000,6034844844.555249,8883972000,38.46719004797416,44.0,2.927230762767067,47.398753696759655,10.768772447970012,100.43130730769232,101.61341119875813,-89.23122755202999
2020-02-25,101.320999,101.730003,97.920998,98.637001,98.637001,124382000,5957224602.623826,8759590000,36.76736396160489,44.0,2.239453136685441,43.11341525910267,6.293700269757768,100.61361492307694,101.3929363692205,-93.70629973024224
2020-02-26,98.514,100.733498,98.022499,98.9795,98.9795,104492000,5926505369.409797,8864082000,35.18895402426201,44.0,1.7023970463173868,44.13285492010083,9.304282695657921,100.83451876923075,101.21416330483379,-90.69571730434207
2020-02-27,96.719002,98.75,94.138,94.214996,94.214996,162880000,5769063837.961401,8701202000,34.829895620215396,44.00000000000001,0.8821516758430619,34.792211880499934,0.5079059000688354,100.81971100000001,100.6957064674387,-99.49209409993115
2020-02-28,90.731499,94.487999,90.556503,94.1875,94.1875,189620000,5929697100.912704,8511582000,35.25840991355074,-48.0,0.2272628679119748,34.74650701743563,19.374619217183607,100.81257634615385,100.21361709948027,-80.62538078281639
2020-03-02,95.324501,97.725502,93.5,97.697502,97.697502,135234000,6063138863.20935,8646816000,34.35422391584137,-48.0,-0.008416384659810205,44.728244801762926,38.10362180285168,100.94598042307692,100.02723820322248,-61.89637819714832
2020-03-03,98.768501,99.816498,94.404503,95.449501,95.449501,150690000,5970642098.2807045,8496126000,32.79130860266592,-48.0,-0.37229717360169445,40.459530837726895,26.167872129167154,101.03703811538463,99.68814655853933,-73.83212787083285
2020-03-04,97.328499,98.900002,96.099998,98.791496,98.791496,95458000,6058701704.744123,8591584000,31.34003009757444,-48.0,-0.3865483652387667,48.35120855961314,44.040942548635144,101.32067257692307,99.62172799864753,-55.95905745136485
2020-03-05,96.650002,98.036003,95.5,96.2015,96.2015,94964000,6016274902.846807,8496620000,30.159664543770855,-48.0,-0.5999180867180769,43.5353161846741,30.189581043264717,101.45678803846155,99.36837777652549,-69.81041895673528
2020-03-06,93.75,95.543503,93.474998,95.054497,95.054497,105472000,6071878576.850978,8391148000,29.60281290979834,-48.0,-0.8517502378859945,41.561048321526116,24.05538114459909,101.53965323076923,99.04883105233841,-75.94461885540092
2020-03-09,88.693001,93.138496,88.064499,90.030502,90.030502,156264000,6036708654.2783,8234884000,30.212443470533433,-72.0,-1.4401226043236903,34.2373028044523,9.277757417499108,101.40490342307693,98.38080667809113,-90.72224258250088
2020-03-10,93.543999,94.713501,90.908501,94.591003,94.591003,142666000,6170188688.61838,8377550000,30.18768783880497,-72.0,-1.5208858019107794,43.901125248601005,31.415180196621897,101.18009596153846,98.10008047971401,-68.5848198033781
2020-03-11,92.892502,93.566002,90.074997,91.042999,91.042999,112496000,6120079510.173777,8265054000,30.330020215787293,-72.0,-1.849861437605398,39.088573866554924,15.542971816211239,100.82751903846155,97.5773337034389,-84.45702818378876
2020-03-12,86.098999,88.25,83.75,83.830498,83.830498,226924000,5901274144.907999,8038130000,31.491129198730146,-84.0,-2.6618810446298937,31.52339528699187,0.44193257028442795,100.11009596153846,96.55904957725824,-99.55806742971558
2020-03-13,87.75,89.315498,84.030998,89.25,89.25,176194000,6073100520.870909,8214324000,32.180808688766916,-84.0,-2.8354189698527392,40.79557248031112,30.58953883378107,99.61996134615384,96.01763849746133,-69.41046116621894
2020-03-16,82.0755,87.972504,81.301498,84.457497,84.457497,178346000,6063502622.028066,8035978000,33.211575797212,-92.0,-3.3213771965104684,36.135798464510536,16.241246397694567,98.92557673076924,95.1613317198716,-83.75875360230543
2020-03-17,88.773499,92.889,84.461998,90.391998,90.391998,218342000,6152450939.509894,8254320000,32.570330665464056,-92.0,-3.190855759316264,44.57774357567395,49.098028625438864,98.40357676923078,94.80804774062184,-50.901971374561136
2020-03-18,87.5,92.083,87.25,91.5,91.5,192904000,6298815302.845297,8447224000,31.974888757412394,-92.0,-2.963844721522335,46.012632260126544,55.08237645152582,97.81913434615385,94.56300716724245,-44.91762354847418
2020-03-19,93.0,97.25,91.6325,94.046501,94.046501,207998000,6269582725.185485,8655222000,30.03007451204218,-72.0,-2.5490713816949295,49.26380392004613,68.83609505806109,97.30015357692308,94.52474745115042,-31.16390494193891
2020-03-20,96.315498,97.849998,91.036499,92.304497,92.304497,196358000,6146309509.166226,8458864000,28.080238839279946,-72.0,-2.33402054984505,47.17107257595871,59.427485822306245,96.69648038461538,94.36028445476892,-40.57251417769375
2020-03-23,91.387497,95.970001,90.599998,95.141502,95.141502,156170000,6254290825.16363,8615034000,26.372839087736214,-72.0,-1.9126211169159717,50.834139217756146,78.64307102467349,96.22140353846154,94.41815242108233,-21.35692897532652
2020-03-24,97.574997,97.75,95.016998,97.004997,97.004997,142942000,6319302242.730101,8757976000,24.646252269268533,-72.0,-1.4120137422061134,53.132900719516684,93.8390409516147,95.84684573076923,94.60977053803919,-6.160959048385302
2020-03-25,96.0345,97.513,94.289001,94.292,94.292,129582000,6189961319.987259,8628394000,22.920277467590125,-72.0,-1.220130075499469,49.50399035858294,78.49957397951478,95.32794184615385,94.58623197966591,-21.50042602048522
2020-03-26,95.099998,97.824501,94.4645,97.774498,97.774498,124426000,6310683944.138264,8752820000,21.33443739457815,-68.0,-0.7780831448831549,53.86025403563159,99.54376529594825,94.91499938461538,94.822399833024,-0.45623470405175826
2020-03-27,96.542999,96.989502,94.996002,95.004997,95.004997,107758000,6203898387.7901325,8645062000,19.861871612495598,-64.0,-0.6438118899001921,50.15461324247634,82.80810345348524,94.42846084615385,94.83592554909629,-17.191896546514762
2020-03-30,96.141502,98.681503,95.616997,98.197502,98.197502,122522000,6287718704.372315,8767584000,18.991100120366706,-60.0,-0.2766039620371856,54.076912645409564,97.21518492083284,94.17457630769232,95.0849312121262,-2.784815079167158
2020-03-31,98.217499,99.651001,97.2005,97.486,97.486,102472000,6209124071.490305,8665112000,18.455703629425386,-56.00000000000001,-0.04251125545462742,53.0745354090535,88.20130986653976,94.06001861538462,95.2627881593761,-11.798690133460234
2020-04-01,96.648499,97.248001,94.650002,95.385002,95.385002,82438000,6173331147.181251,8582674000,17.1527706774444,-52.0,-0.026221810064271267,50.12015824884134,76.751419370868,93.93494173076922,95.27184103645936,-23.248580629131993
2020-04-02,95.082001,96.376503,94.5,95.941498,95.941498,86720000,6219844834.055185,8669394000,15.990004544476601,-36.0,0.031232243276505756,50.899780562225615,79.78417726082282,93.81809550000001,95.32144525598089,-20.215822739177177
2020-04-03,95.557503,96.316498,94.457497,95.329498,95.329498,72198000,6215378619.243036,8597196000,14.92454184341033,-36.0,0.027069666910691126,49.97469186034746,71.54847490648338,93.86096096153847,95.32204175553787,-28.451525093516626
2020-04-06,96.800003,99.926003,96.500999,99.879501,99.879501,115464000,6327707261.194988,8712660000,14.904020184536991,60.0,0.3864631051778389,56.32947614337182,99.63314934526294,94.07988407692308,95.65963132920172,-0.3668506547370621
2020-04-07,100.855499,101.786003,99.880997,100.580002,100.580002,102280000,6300486585.312603,8814940000,15.369155120293513,64.0,0.7195154445019085,57.23027790868422,89.21866206925529,94.19074946153845,96.02410323074233,-10.781337930744723
2020-04-08,101.050003,102.199997,100.557503,102.150002,102.150002,79546000,6375190068.664141,8894486000,15.905913991197611,68.0,1.0974964460292966,59.25866865213849,99.56900858353526,94.44846103846155,96.47787350994659,-0.4309914164647392
2020-04-09,102.214996,102.650002,100.883003,102.138,102.138,92930000,6414265656.907258,8801556000,16.522197947559313,72.0,1.3801709008324679,59.235540752052934,95.75102215733708,94.57717273076923,96.89714213883944,-4.248977842662918
2020-04-13,102.0,109.0,101.900002,108.443497,108.443497,134334000,6527541263.932499,8935890000,18.41716062163342,76.0,2.0889136571502576,66.60890039847041,96.21709579342635,95.04801876923077,97.7524276841106,-3.7829042065736416
2020-04-14,110.023499,114.599998,109.310501,114.166,114.166,161744000,6662743393.31153,9097634000,20.945564180857314,80.0,3.076887125408902,71.62504750331095,97.86323635417797,95.78307657692307,98.96824785565796,-2.136763645822027
2020-04-15,112.884003,116.668503,112.25,115.384003,115.384003,137332000,6720228008.801437,9234966000,23.52404439289639,84.0,3.9130388042393918,72.56958443295989,94.21683106114152,96.75821123076922,100.1842297182018,-5.783168938858484
2020-04-16,117.300003,123.050003,116.75,120.4095,120.4095,240764000,6759170497.195172,9475730000,26.49677755576696,88.0,4.924444708687901,76.10404779366314,90.76505221333167,97.75123034615385,101.68239788722389,-9.23494778666833
2020-04-17,118.616501,120.0,115.801003,118.75,118.75,158600000,6823343185.148986,9317130000,28.911474451944603,88.0,5.52835594768672,72.76959938053567,84.9610838588265,98.81688423076922,102.94666471039248,-15.038916141173509
2020-04-20,119.497498,122.249001,119.302498,119.680496,119.680496,115414000,6737541414.406516,9432544000,31.35101936864158,88.0,6.012732172569713,73.47146103506128,88.2154191031734,100.19573030769233,104.18620776888193,-11.784580896826597
2020-04-21,120.830498,121.415497,113.983002,116.405998,116.405998,149534000,6685503688.232196,9283010000,31.862528586023224,88.0,6.062494534827678,66.93331355348471,76.76312457536947,101.24019176923078,105.09137741563141,-23.23687542463052
2020-04-22,118.449997,119.699997,117.550003,118.1745,118.1745,84244000,6650199476.220441,9367254000,32.33750143073475,84.0,6.173470966399279,68.5605707433435,82.94831869581488,102.53699957692308,106.06049760706611,-17.05168130418512
2020-04-23,119.999001,121.210999,119.103996,119.972504,119.972504,101332000,6632405708.16031,9468586000,32.98610729658195,80.0,6.333495886104657,70.16795014873286,89.23669369869152,103.67471134615383,107.09101659913529,-10.763306301308473
2020-04-24,120.849998,121.0215,119.099998,120.511002,120.511002,76498000,6668256260.4824,9545084000,33.58702409903259,68.0,6.42965204956495,70.65190164459571,90.4365489567895,104.79051911538461,108.08508959179193,-9.563451043210502
2020-04-27,122.160004,122.244003,118.150002,118.800003,118.800003,112912000,6591198141.764793,9432172000,34.322729028809114,68.0,6.295225738320852,66.93628669940367,81.65652855370664,105.74257688461537,108.87878688128882,-18.34347144629337
2020-04-28,118.605003,118.675003,115.300003,115.704002,115.704002,105388000,6511040747.164497,9326784000,34.015913043214844,68.0,5.871191075798308,60.71423789492423,67.34022007335778,106.64255784615384,109.38435837156372,-32.65977992664221
2020-04-29,116.500504,119.594498,115.5,118.635498,118.635498,91832000,6559855562.640289,9418616000,33.89286607132007,60.0,5.705913558713135,64.11558221823327,80.08523931970946,107.54617307692307,110.06962797367011,-19.914760680290545
2020-04-30,120.991997,123.75,119.800499,123.699997,123.699997,190692000,6745719017.426096,9609308000,34.437057911786866,100.0,5.915403588817767,69.09398760214475,99.77115329713071,108.57290384615385,111.07928493858343,-0.2288467028692808
2020-05-01,116.839996,118.122002,112.9095,114.302002,114.302002,195452000,6654695677.944212,9413856000,32.96538735854494,72.0,5.2624243407365725,54.0960021680272,34.568380800469605,109.34251930769231,111.31800472091058,-65.43161919953039
2020-05-04,112.819,116.348999,112.819,115.7995,115.7995,97318000,6721715570.957779,9511174000,31.576405833594883,72.0,4.810318794909605,55.74445340067305,30.865217391304302,110.03578861538462,111.64996733417645,-69.1347826086957
2020-05-05,117.0,117.550003,115.356499,115.889999,115.889999,64850000,6688410965.905771,9576024000,30.52093555365725,72.0,4.408505893821115,55.84764436834531,28.094401244167972,110.83905792307692,111.96404375386709,-71.90559875583203
2020-05-06,116.472,117.872498,116.0,117.563004,117.563004,62356000,6730154064.995865,9638380000,29.605332519825073,72.0,4.176914921243863,57.8063070812295,43.399542585307884,111.58388492307692,112.37878154987693,-56.600457414692116
2020-05-07,118.738998,118.800003,117.155502,118.380501,118.380501,67928000,6763426042.462585,9706308000,28.94624171424797,72.0,4.013082268412745,58.76881693646307,50.87824535724082,112.38751957692307,112.82335336099716,-49.121754642759186
2020-05-08,118.607002,119.362,117.849998,118.980499,118.980499,64132000,6795195093.032624,9770440000,28.452374959476913,72.0,3.886853309432098,59.49906599284706,56.36720336657208,113.2950386923077,113.27943822314552,-43.63279663342792
2020-05-11,118.735001,120.983498,118.605499,120.449997,120.449997,65184000,6831131200.84764,9835624000,28.33146373355252,72.0,3.860886263969377,61.30659802825918,69.81060287256422,114.23767326923077,113.81059072513474,-30.189397127435775
2020-05-12,120.592499,120.949997,117.75,117.847504,117.847504,61498000,6773380892.481101,9774126000,27.917647334189066,68.0,3.588936729615753,56.4975834787675,46.002232183697735,115.10375042307692,114.10962133808773,-53.99776781630226
2020-05-13,118.339996,120.385002,116.889999,118.396004,118.396004,95658000,6760161406.147614,9869784000,27.228796953689,64.0,3.378726277006905,57.25855743716095,51.02007135669201,115.8159236153846,114.42713116489605,-48.97992864330799
2020-05-14,118.050499,119.568497,117.6605,119.442497,119.442497,72962000,6823486900.429838,9942746000,26.589150171796074,60.0,3.2590083978745383,58.74146669638466,60.59369682554205,116.5414041923077,114.79863974527412,-39.406303174457946
2020-05-15,118.426003,120.550003,117.818497,120.488998,120.488998,84700000,6904403549.0478525,10027446000,26.252241323182584,56.00000000000001,3.2115542031369273,60.227525571048744,70.16739548074278,117.24675019230769,115.2201477641427,-29.83260451925721
2020-05-18,120.217499,121.650002,119.2005,121.313004,121.313004,87144000,6967569325.13785,10114590000,26.221011294697757,52.0,3.2035087548024705,61.40625614989055,77.70564449730131,117.98425034615386,115.67147044828027,-22.294355502698693
2020-05-19,121.491501,124.25,121.448502,122.466499,122.466499,86410000,6943957956.991237,10201000000,26.795193163981146,100.0,3.252714813744973,63.05683422996886,84.39768174262967,118.52359657692308,116.17480589655581,-15.602318257370323
2020-05-20,123.893501,125.000504,123.363503,124.897003,124.897003,79962000,7013808604.631647,10280962000,27.488844312417193,100.0,3.4480849532156697,66.32491767190422,99.15034301183162,118.93632746153845,116.820894570885,-0.8496569881683614
2020-05-21,125.0,126.272499,122.126999,122.336998,122.336998,102288000,6921883831.123988,10178674000,28.399243660433733,52.0,3.3576413878070497,60.276570400485795,70.74737954787818,119.20375034615384,117.22949482489352,-29.252620452121818
2020-05-22,122.750504,123.4925,121.5065,121.844002,121.844002,57342000,6884031297.069608,10121332000,28.94488244574112,52.0,3.2091900087797143,59.15775370272836,59.43113777940643,119.25892350000001,117.5713101711977,-40.56886222059357
2020-05-26,122.900002,123.099998,120.703003,121.093002,121.093002,71364000,6835889613.875442,10049968000,29.062311411572917,52.0,2.9964011504673493,57.40961352861476,49.57899728196615,119.34903896153847,117.83217623259046,-50.42100271803385
2020-05-27,120.249496,120.679001,116.5,120.519501,120.519501,101138000,6929307342.451721,9948830000,27.454034362226253,52.0,2.7497898438070365,56.04754150837929,41.13073841194567,119.38130838461538,118.03123732647265,-58.86926158805433
2020-05-28,119.216499,121.848503,118.911499,120.055,120.055,63804000,6915186582.790516,9885026000,26.309649323311312,52.0,2.488185009884475,54.91118803020325,36.37759389896083,119.52165461538462,118.18114567265987,-63.62240610103916
2020-05-29,120.796997,122.1185,119.910004,122.1185,122.1185,70198000,6985384582.790516,9955224000,25.32818728049859,52.0,2.419478259547617,58.897971405764444,57.49297083581179,119.67334692307692,118.47280154875914,-42.507029164188204
2020-06-01,122.400002,123.846497,122.208504,123.552002,123.552002,58578000,7022899088.489869,10013802000,24.924297110871798,52.0,2.4524292185766114,61.44818848296186,72.16170602831481,119.81101992307693,118.84903861922142,-27.838293971685193
2020-06-02,123.349998,123.676498,122.265503,123.620499,123.620499,50598000,7069480862.490486,10064400000,24.549256239075486,52.0,2.4557617338434596,61.57088499210861,72.86262193529002,119.93061596153846,119.20248012890872,-27.137378064709978
2020-06-03,123.400497,124.400002,123.058502,123.919998,123.919998,53420000,7084672291.964955,10117820000,24.418805812772206,52.0,2.454278448267999,62.13829384368522,75.92733445150529,120.12753884615384,119.55192589713769,-24.072665548494715
2020-06-04,123.871498,125.376999,122.500504,123.029999,123.029999,58974000,7047409741.579851,10058846000,24.586445239636767,52.0,2.3541502735491093,59.33464944040945,66.82015521311392,120.40930796153847,119.80956094179416,-33.17984478688607
2020-06-05,122.225502,124.432503,121.856499,124.150002,124.150002,66128000,7099033706.54885,10124974000,24.417882220001427,52.0,2.3382193187289317,61.67794335277529,78.28091872918077,120.62140426923078,120.13107509425384,-21.719081270819228
2020-06-08,125.010002,126.5,124.366997,126.203003,126.203003,79414000,7156332669.900518,10204388000,24.873331775168037,96.0,2.4628635869612054,65.59191280849348,97.03002999999995,120.71767373076923,120.58084753171651,-2.969970000000046
2020-06-09,126.472,131.321503,126.25,130.042999,130.042999,103520000,7207658780.207463,10307908000,26.367495155247294,100.0,2.8387769984029063,71.46282849440348,91.37399223277156,121.32309669230769,121.28174764047826,-8.62600776722845
2020-06-10,132.25,136.117493,131.313004,132.372498,132.372498,98920000,7152366789.962507,10406828000,28.48444463119366,100.0,3.2867742979836834,74.32486096772578,80.90992054897131,121.9605196923077,122.10328470414653,-19.09007945102868
2020-06-11,130.175003,133.569,126.811501,127.898003,127.898003,116002000,7073667468.069896,10290826000,28.667556626822037,96.0,3.2433734438320556,61.55483000804347,58.101221190699576,122.422366,122.53252309643197,-41.89877880930043
2020-06-12,130.060501,131.074005,125.167503,127.250999,127.250999,108722000,7041648007.783587,10182104000,28.283497848969606,40.0,3.1207955501938187,59.95084330711565,54.80312392618157,122.79498119230769,122.8820398300296,-45.19687607381842
2020-06-15,126.330002,129.199997,125.400002,128.634003,128.634003,77302000,7095922362.648265,10259406000,27.926871840963777,40.0,3.0995192226972392,62.21722785230539,61.85297479142727,123.18934665384616,123.30811117595334,-38.14702520857273
2020-06-16,131.0,131.0,128.800003,130.763504,130.763504,71712000,7152216522.394847,10331118000,27.97877719824975,40.0,3.2174023026050946,65.45853422357766,68.88300088910884,123.64253915384614,123.8603624962531,-31.116999110891168
2020-06-17,132.375,132.75,131.591003,132.048996,132.048996,59186000,7139806784.45247,10390304000,28.374558541875388,40.0,3.375641658058754,67.28316008432043,74.8974255049625,124.0886545,124.4669279409751,-25.102574495037505
2020-06-18,132.350494,132.981995,131.805496,132.699005,132.699005,49756000,7165626596.763402,10440060000,28.78786251478343,40.0,3.5130020800460073,68.19795304157724,76.02910428263277,124.65986607692307,125.0767114268288,-23.970895717367227
2020-06-19,133.904007,134.871506,132.949997,133.750504,133.750504,115540000,7146355288.484337,10555600000,29.5384034964683,40.0,3.6644666946508693,69.67510426085022,83.40235610505137,125.25042376923078,125.71921458039704,-16.59764389494863
2020-06-22,134.225006,135.75,133.449997,135.690994,135.690994,64176000,7207238450.121951,10619776000,30.398284951938,40.0,3.896172171111644,72.23787532279366,97.00933188808574,125.87536596153846,126.45786490777503,-2.9906681119142675
2020-06-23,136.300995,139.155502,135.901993,138.220505,138.220505,84634000,7243228025.841581,10704410000,31.762667503831867,76.0,4.235091331630926,75.18218741349604,94.59508157782267,126.55734700000001,127.32917158127317,-5.404918422177331
2020-06-24,139.0,139.800003,136.050003,136.720001,136.720001,90532000,7185046030.607448,10613878000,33.12661189904089,80.0,4.332664812589002,70.41171557298928,82.83500257251869,127.1499238076923,128.02478857525293,-17.164997427481314
2020-06-25,136.977493,137.811493,135.606995,137.729004,137.729004,59374000,7239976659.022624,10673252000,34.18278495295425,80.0,4.440226442255977,71.71157140207443,86.58071538363946,127.73694323076924,128.74361934745642,-13.419284616360544
2020-06-26,138.753006,139.128494,134.399994,134.643494,134.643494,130016000,7123351330.905886,10543236000,35.38235801328735,80.0,4.227759953336886,62.64795558860319,64.75989065436531,128.11180826923078,129.1806470994967,-35.2401093456347
2020-06-29,134.500504,134.839996,131.503998,134.018997,134.018997,84468000,7166243680.361731,10458768000,35.177773508165686,80.0,3.9633005793594123,60.968359554155306,60.492014351614635,128.56111592307693,129.53904338842287,-39.50798564838536
2020-06-30,134.253494,138.481506,133.751495,137.940994,137.940994,75394000,7224406700.675636,10534162000,35.67247230277932,80.0,4.023803103116535,66.95946066849427,87.29534255937116,129.180231,130.16141010039155,-12.70465744062883
2020-07-01,137.899506,144.75,137.699997,143.934998,143.934998,127268000,7322249557.300237,10661430000,36.99381785258795,100.0,4.50350422454315,73.62305798042335,95.83810992030284,130.0587693076923,131.18167587073293,-4.1618900796971525
2020-07-02,145.600494,147.778,143.554993,144.514999,144.514999,131868000,7250336026.335216,10793298000,38.54100476703753,100.0,4.874284337062079,74.16599536550096,85.4187090373321,130.98167307692307,132.16932943586383,-14.581290962667902
2020-07-06,146.748505,152.994003,146.5,152.852005,152.852005,137612000,7381929972.8246155,10930910000,40.43129334575851,100.0,5.774294484054849,80.40850187896459,99.41308588906341,132.24309634615386,133.7013794776517,-0.5869141109366001
2020-07-07,152.927505,153.477493,149.5,150.005997,150.005997,105150000,7303533299.37981,10825760000,42.22430895723179,84.0,6.18659473615395,73.84828259137169,84.20143905191232,133.31569238461537,134.90912892375158,-15.798560948087683
2020-07-08,151.130493,154.198502,150.621506,154.055496,154.055496,100752000,7396229299.030915,10926512000,43.947544493667806,88.0,6.762156452343817,76.7543634396406,99.36986505631502,134.4889036923077,136.32737833680702,-0.6301349436849801
2020-07-09,155.7995,159.694,153.699997,159.1315,159.1315,127774000,7500021704.427109,11054286000,45.93882380480302,92.0,7.5409569028931855,79.7865338916233,98.00461170595165,135.8547114230769,138.01657253408058,-1.9953882940483656
2020-07-10,159.587997,160.75,156.785004,160.0,160.0,109720000,7568233465.831156,11164006000,47.85343022157519,96.0,8.134473416538498,80.26096230911718,97.43554691680592,137.2424038076923,139.64497456859314,-2.564453083194072
2020-07-13,162.552994,167.214493,153.419495,155.199997,155.199997,154408000,7453683935.229411,11009598000,49.97549028197866,100.0,8.123872458094922,70.42308663936491,66.35584020887975,138.4797114230769,140.79719845240106,-33.644159791120245
2020-07-14,154.449997,156.369003,147.5,154.199997,154.199997,144638000,7527576511.007997,10864960000,50.06301479754614,96.0,7.943215040988491,68.53825237549614,63.55554298533245,139.63548046153846,141.7899983448158,-36.44445701466755
2020-07-15,154.011505,154.917496,148.658997,150.443497,150.443497,115778000,7477822597.933632,10749182000,50.14428756200166,80.0,7.411489542788445,61.84230743575353,53.03622646507702,140.56780715384613,142.43099824519982,-46.96377353492297
2020-07-16,148.552994,151.600006,145.911499,149.994995,149.994995,127884000,7533541712.938676,10621298000,49.420517051534304,80.0,6.874656134879132,61.07510714417638,51.78028755972156,141.33519161538462,142.99129430111094,-48.21971244027845
2020-07-17,150.449997,151.199997,147.422501,148.098495,148.098495,95226000,7472397657.509365,10526072000,48.74844443467176,80.0,6.224428751076914,57.80927582790017,46.469523875264166,141.94003765384616,143.3696054639916,-53.53047612473584
2020-07-20,150.009995,160.067993,149.701004,159.841995,159.841995,151964000,7617736096.303117,10678036000,49.05387945998474,80.0,6.580861099937522,68.89923546185675,77.96820834762023,143.16865273076922,144.5897824666589,-22.031791652379763
2020-07-21,161.624496,162.029007,155.285995,156.914505,156.914505,122426000,7554444490.624229,10555610000,49.50232090396856,76.0,6.551589679814782,64.35776503063994,65.10193499492586,144.3095568076923,145.50272487653604,-34.898065005074145
2020-07-22,156.25,157.5,153.263,154.995499,154.995499,82084000,7539488386.737516,10473526000,49.34457375208849,72.0,6.300911140632451,61.496248199450086,48.35480885056741,145.3234605,146.20589333012595,-51.6451911494326
2020-07-23,154.913498,154.913498,148.5,149.327499,149.327499,113138000,7455545556.631387,10360388000,47.977752862680894,36.0,5.580557172433942,53.87661838811059,16.035304708812266,146.03746030769233,146.43712337974623,-83.96469529118774
2020-07-24,146.5,151.578995,144.399994,150.445496,150.445496,112648000,7532621366.196534,10473036000,45.805593432443615,36.0,5.04176613555552,55.05943989404257,26.49850868958374,146.74501800000002,146.73403987013538,-73.50149131041626
2020-07-27,153.100006,154.899994,150.788498,152.760498,152.760498,83410000,7529223371.55906,10556446000,44.248308177705596,36.0,4.746852905687206,57.49041415712598,36.64557350130728,147.5166138846154,147.18044417605125,-63.35442649869271
2020-07-28,152.713501,153.854507,149.787994,150.016495,150.016495,62534000,7473717054.2611685,10493912000,42.58343113684056,36.00000000000001,4.242805515839478,53.777136310163925,24.618121134283932,148.1422289230769,147.39052201486228,-75.38187886571606
2020-07-29,151.5495,151.957993,149.838501,151.676498,151.676498,59482000,7517399149.765186,10553394000,41.037473884608744,36.0,3.9319674238979587,55.64363187760542,31.894209029091602,148.757056,147.70800171746507,-68.1057909709084
2020-07-30,150.699997,154.600006,150.25,152.593994,152.593994,122566000,7526922148.54082,10675960000,39.999162728161615,36.0,3.7168151248110064,56.68472875293775,35.915756905290856,149.3098825,148.06992707172694,-64.08424309470915
2020-07-31,162.199997,162.341003,157.550003,158.233994,158.233994,161710000,7411385467.100619,10837670000,39.98858099479957,36.0,3.9558061711125845,62.509931035878814,77.10826074497815,150.13734376923077,148.82282091826568,-22.89173925502185
2020-08-03,159.025497,159.199997,155.199997,155.594498,155.594498,101494000,7329911209.347619,10736176000,39.41881817323688,36.0,3.887411370680894,58.54199999757251,62.396178498098905,150.82447815384614,149.3244266280238,-37.603821501901095
2020-08-04,155.060501,158.362,155.060501,156.941498,156.941498,93886000,7343006483.212612,10830062000,38.85608521550909,36.0,3.896977707998758,59.93953393914009,69.90411743286009,151.6820936923077,149.88865413705906,-30.09588256713991
2020-08-05,157.188507,160.679504,156.365005,160.251495,160.251495,78330000,7405795422.723318,10908392000,38.627164623727545,32.0,4.1241080439828295,63.22051933628659,88.3534532533817,152.6910359230769,150.65627197875838,-11.646546746618288
2020-08-06,159.718002,162.373505,158.2715,161.25,161.25,78812000,7441435522.123489,10987204000,38.62204345639695,28.000000000000004,4.334713600164292,64.17374780818162,93.74910667147897,153.58753615384614,151.44099257292444,-6.250893328521035
2020-08-07,161.2005,162.040497,157.033493,158.373001,158.373001,78722000,7404834019.241527,10908482000,38.27779778750476,24.0,4.220815313979813,59.39702279421362,77.74222298581503,154.14284396153846,151.95447467863374,-22.257777014184963
2020-08-10,158.515503,158.625504,155.076004,157.408005,157.408005,63346000,7424723931.536779,10845136000,37.43069881148745,-36.00000000000001,4.006498567664579,57.84182612117043,72.37323303165424,154.6387288076923,152.35843988762383,-27.626766968345756
2020-08-11,155.660004,157.960999,153.649994,154.033493,154.033493,74362000,7363592142.421712,10770774000,36.26937458700014,-36.0,3.523736643142229,52.65033704772562,53.598314764433056,154.68417065384614,152.48251789594798,-46.401685235566944
2020-08-12,155.399994,158.719498,155.070999,158.112,158.112,70442000,7410576071.518581,10841216000,35.321740909711494,-36.0,3.4306988089079766,57.60321669176345,76.29008044115588,154.99594,152.8995165703222,-23.70991955884412
2020-08-13,159.149506,160.876007,157.75,158.050995,158.050995,62980000,7359724428.940686,10778236000,34.806847430445565,-36.0,3.313843140389281,57.506320799051586,65.65487090671174,155.14961303846155,153.28110756511316,-34.345129093288264
2020-08-14,158.908997,158.912003,156.0,157.401001,157.401001,55034000,7357645517.952614,10723202000,33.8270191539834,-36.0,3.132673586531183,56.41739014459763,60.490249462258724,155.0830553846154,153.58628485658627,-39.509750537741276
2020-08-17,158.656006,159.748505,157.709,159.120499,159.120499,53824000,7378322460.265577,10777026000,33.07189052419049,-36.0,3.0921995761120797,58.64816839860702,74.04862415680121,155.04922842307693,153.9962266449873,-25.951375843198797
2020-08-18,160.600006,166.0,160.291,165.624496,165.624496,106920000,7471177339.340721,10883946000,33.36256804726939,68.0,3.544087795001815,65.78252030765435,97.61584761904759,155.4501706923077,154.8575799305438,-2.3841523809524223
2020-08-19,165.150497,165.794998,162.800003,163.024002,163.024002,83702000,7399995670.291524,10800244000,33.632482890128365,68.0,3.65029599162483,61.233585876620296,75.90286190954076,155.78955549999998,155.46250008383686,-24.097138090459246
2020-08-20,162.600006,165.630997,161.899994,164.8685,164.8685,66650000,7439403438.082115,10866894000,33.595855007609586,68.0,3.8390481685616464,63.1785307572372,90.83806113130645,156.3443633076923,156.15924081836746,-9.161938868693568
2020-08-21,164.75,165.720001,163.769501,164.235992,164.235992,71518000,7402094618.638897,10795376000,33.57671654406728,68.0,3.8927246129587445,62.02926408293578,85.71654135228769,156.89209396153845,156.75751868367357,-14.283458647712306
2020-08-24,165.507507,169.016006,162.878006,165.373001,165.373001,93326000,7384639554.895006,10888702000,34.08494039410576,84.0,3.9811188458857316,63.32093565941274,76.29179906927045,157.55649803846154,157.395702558957,-23.708200930729546
2020-08-25,164.749496,167.869995,163.350006,167.324493,167.324493,79856000,7445220460.326413,10968558000,34.55686254057006,84.0,4.160679286544934,65.49076687724138,88.99185422997188,157.84428642307694,158.13116851755277,-11.00814577002812
2020-08-26,167.555496,172.587006,167.2285,172.092499,172.092499,130174000,7551368377.601863,11098732000,35.65136885593855,92.0,4.634299149892797,70.13880414883931,97.38867462300811,158.42805542307693,159.1653411458822,-2.6113253769918847
2020-08-27,172.502502,172.649994,168.899994,170.0,170.0,85296000,7516112970.549064,11013436000,36.675654149225615,96.0,4.785633320323257,65.94117447886798,86.05266315789477,159.0051516153846,159.96790846840943,-13.947336842105223
2020-08-28,171.149994,171.668503,169.324997,170.089996,170.089996,57940000,7496000091.162368,11071376000,37.626776207277885,96.0,4.85684201430351,66.03532351484478,86.52632631578959,159.8037091923077,160.71769273000876,-13.473673684210416
2020-08-31,170.449493,174.75,170.25,172.548004,172.548004,83718000,7497786223.994368,11155094000,38.91002086731963,96.0,5.0533640849227766,68.58925485348325,88.81042792771844,160.65380565384615,161.59401208334145,-11.189572072281557
2020-09-01,174.479004,175.693497,173.350006,174.955994,174.955994,68644000,7523225316.502084,11223738000,40.21457269921546,100.0,5.341836543841879,70.89792437876102,96.25509374998254,161.5074785769231,162.58378852161246,-3.744906250017473
2020-09-02,177.350006,177.612503,174.334503,176.572495,176.572495,78630000,7551961583.10367,11302368000,41.647304026764125,100.0,5.635923746199126,72.3662723452731,95.18793357715208,162.52886319230768,163.61998900149302,-4.8120664228479235
2020-09-03,174.25,174.420502,165.149994,168.399994,168.399994,163222000,7503182394.651861,11139146000,39.867752767046106,96.0,5.150169494528001,56.7709354823536,53.71413263283347,163.17207457692305,163.97406344582689,-46.28586736716653
2020-09-04,165.899994,169.074997,155.556503,164.731003,164.731003,175636000,7565941659.982451,10963510000,37.77639743220091,64.0,4.418218368637184,51.414001312183416,41.59639100471522,163.6388826153846,164.0301330424323,-58.40360899528478
2020-09-08,157.199997,162.542496,156.5,157.492004,157.492004,121884000,7484077352.353287,10841626000,35.83442462127323,64.0,3.216932314236857,42.827281030926365,8.775394450489733,163.61034453846153,163.54582718743734,-91.22460554951027
2020-09-09,160.149506,165.158997,159.25,163.430496,163.430496,103774000,7527139369.330111,10945400000,33.48666060866487,64.0,2.712819441823626,50.1782889777699,35.70000453391371,163.9117290769231,163.53728413651606,-64.29999546608629
2020-09-10,165.360992,167.494507,158.527496,158.755493,158.755493,106614000,7425946946.7449255,10838786000,31.33996884539369,64.0,1.9140091806244186,45.24620353062995,14.50394450489666,163.98149811538462,163.183077385663,-85.49605549510333
2020-09-11,160.434494,160.867004,154.199005,155.811005,155.811005,101880000,7373326270.269119,10736906000,29.67143662948789,64.0,1.0314606833244682,42.41820238036379,6.884917409607033,163.81071003846154,162.63699794968798,-93.11508259039297
2020-09-14,158.647003,159.369507,154.800003,155.148499,155.148499,90592000,7296552378.156539,10646314000,28.12208528614678,64.0,0.2754012887638453,41.78537329165652,4.055327401313495,163.5760369230769,162.08229432378516,-95.94467259868651
2020-09-15,156.807999,158.751007,155.445999,157.806503,157.806503,80430000,7331011865.092728,10726744000,26.683401895901472,64.0,-0.10805690684648539,45.31060593721744,15.407770338289442,163.55424853846154,161.7655690405418,-84.59222966171056
2020-09-16,158.999496,159.362,153.707504,153.904999,153.904999,90244000,7247071782.817667,10636500000,25.692231442019995,64.0,-0.7184867876597707,41.352241039825536,0.8261661086034913,163.41951753846155,161.18330459309428,-99.1738338913965
2020-09-17,150.462494,151.471497,148.627502,150.436493,150.436493,128982000,7282173951.152704,10507518000,25.654196294400634,-40.0,-1.4652458704888716,38.16051734714892,6.241127954420356,163.2811713846154,160.3872444750873,-93.75887204557965
2020-09-18,151.587006,151.889999,145.276993,147.745499,147.745499,177852000,7237099308.11019,10329666000,26.107620358490806,-43.99999999999999,-2.248281757372183,35.84869453652563,7.634040718702105,162.8824598076923,159.4508188843401,-92.36595928129789
2020-09-21,145.324997,148.100006,143.550003,148.023499,148.023499,122358000,7355342478.512934,10452024000,26.76324419678526,-48.0,-2.813973329632688,36.27817680056149,13.133199266054996,162.49678688461537,158.60435074475936,-86.86680073394501
2020-09-22,151.692001,156.699493,150.009995,156.449493,156.449493,138976000,7483930853.01398,10591000000,25.38409564428518,-48.0,-2.5529518397554796,47.70576501144395,37.87006238532106,162.4601904230769,158.44473165255496,-62.12993761467894
2020-09-23,156.0215,156.350006,149.619003,149.992996,149.992996,113054000,7383440034.05015,10477946000,24.169379522609074,-48.0,-2.8344025489427622,41.55597413614724,20.871036130643702,162.10913261538462,157.8186771597731,-79.1289638693563
2020-09-24,148.889496,153.464996,148.25,150.989502,150.989502,110588000,7389038526.686385,10588534000,23.27860240982796,-48.0,-2.9431181239590956,42.78197283838327,29.1459382909159,161.5462482307692,157.31281233312325,-70.8540617090841
2020-09-25,152.742996,155.076996,149.949997,154.7565,154.7565,92304000,7469802418.024768,10680838000,22.10090528432656,-48.0,-2.694253071633341,47.28385081805179,46.8019592303937,161.22826738461538,157.123455864003,-53.198040769606315
2020-09-28,157.442505,158.751999,155.858505,158.702499,158.702499,84484000,7551395824.16143,10765322000,20.77992206248522,-48.0,-2.153789044066059,51.581386157484275,63.281728450086035,160.9911135,157.240422022225,-36.718271549913965
2020-09-29,158.769501,159.412994,156.626999,157.244003,157.244003,69916000,7512447899.598751,10695406000,19.6807455910862,-48.0,-1.8221512213957851,49.96019994707327,57.190577010908186,160.72219084615384,157.24068727983797,-42.80942298909181
2020-09-30,157.057007,160.643997,156.699493,157.436493,157.436493,97922000,7451117833.083925,10793328000,18.90198538636148,-48.0,-1.5262004347293612,50.182739569392986,80.18992434082556,160.41694053846155,157.25519140725737,-19.81007565917444
2020-10-01,160.399994,161.199997,158.600006,161.063004,161.063004,99438000,7540077096.862146,10892766000,18.290361166152024,-48.0,-0.9876432379425353,54.305788409628285,99.22383543019907,160.17611403846152,157.53725159931238,-0.776164569800929
2020-10-02,157.681503,159.789993,156.149994,156.25,156.25,112262000,7433983710.409568,10780504000,17.13043646782224,-48.0,-0.9383848616799924,48.56142428590046,71.95468168431107,159.56678715384612,157.44189962899296,-28.045318315688938
2020-10-05,157.292007,160.126495,157.042496,159.960007,159.960007,75506000,7501337410.147472,10856010000,16.130238812459016,-48.0,-0.5931432978084388,52.71359609335038,92.97455851826348,159.18063357692307,157.6284261009194,-7.025441481736517
2020-10-06,158.25,159.100006,154.5,154.998001,154.998001,101738000,7421627914.344206,10754272000,15.35922182180858,-48.00000000000001,-0.7117249637460361,47.2231393413401,64.86120051938822,158.60017223076923,157.43357979714762,-35.13879948061178
2020-10-07,156.75,160.0,156.619507,159.7845,159.7845,86188000,7496827272.155034,10840460000,14.415024052750615,-48.0,-0.41469102151771153,52.37609284884912,91.98018424255562,158.10926823076923,157.60772203439595,-8.019815757444384
2020-10-08,161.249496,161.664505,158.749496,159.527496,159.527496,63482000,7467231271.134798,10776978000,13.648199032108353,-48.0,-0.19774804089416875,52.08205221324555,88.20277256311005,157.51586446153846,157.7499275133296,-11.797227436889953
2020-10-09,160.5,164.449493,159.891495,164.332504,164.332504,98158000,7560350477.233617,10875136000,13.576748781610428,-44.0,0.35778055122850105,56.948393190054205,99.27782307754946,157.04509557692307,158.23752577160147,-0.7221769224505338
2020-10-12,167.496994,174.811996,166.977493,172.1465,172.1465,167284000,7613805984.765365,11042420000,15.205781620494633,60.0,1.4122851911966166,63.44917084590259,89.96500112416255,157.18919196153846,159.26782015889026,-10.03499887583746
2020-10-13,173.399506,174.619003,171.210999,172.181503,172.181503,114894000,7564349165.341444,11157314000,16.71845497088711,60.0,2.225161884149486,63.475776485614894,90.09677962454327,157.47574965384615,160.22438925823172,-9.903220375456732
2020-10-14,172.350006,173.244003,167.0,168.185501,168.185501,116254000,7492239677.525054,11041060000,17.017189210004222,60.0,2.5179037275268,58.26183951107424,73.34689378758318,157.887038,160.81410123910345,-26.653106212416816
2020-10-15,164.600494,167.794006,164.0,166.932495,166.932495,104468000,7549264246.41398,10936592000,16.602701584017684,60.0,2.618610918463162,56.689407734437026,61.20764793376286,158.02173026923077,161.26731559176244,-38.79235206623715
2020-10-16,168.161499,169.983002,158.0,163.635498,163.635498,129488000,7541570328.568686,10807104000,15.784846879851182,60.0,2.404662536222787,52.66191856638007,44.97587533987313,158.20942276923077,161.44273651089117,-55.02412466012687
2020-10-19,164.980499,166.449997,159.636993,160.360504,160.360504,104472000,7459287260.555809,10702632000,15.025410368839431,60.0,1.9483825155362524,48.94233924640557,28.852427895318577,158.38440350000002,161.36257113971402,-71.14757210468143
2020-10-20,161.113998,163.300003,159.600494,160.850494,160.850494,90194000,7430043240.674792,10792826000,14.327246096898632,60.0,1.6077819008611698,49.5168589236069,31.264746212041395,158.603711,161.3246394997352,-68.7352537879586
2020-10-21,160.625,161.694,158.0,159.246994,159.246994,91854000,7400204068.436568,10700972000,13.994957152971546,60.0,1.1946927366472266,47.62811191001796,23.3703964888532,158.65911450000002,161.17073983308816,-76.6296035111468
2020-10-22,159.4935,159.9375,156.097,158.820007,158.820007,84240000,7435420446.345695,10616732000,14.05038433362357,60.0,0.8233710070021516,47.112776747441565,21.268254483705125,158.84815326923078,160.99661147508164,-78.73174551629488
2020-10-23,159.550003,160.266495,157.0,160.220001,160.220001,69334000,7502780700.789066,10686066000,14.016640336128377,60.0,0.6347467116163727,49.058988886241245,28.160703655120837,159.22444203846152,160.93908477322375,-71.83929634487916
2020-10-26,159.936996,164.149002,157.664993,160.352005,160.352005,118024000,7482576399.770977,10804090000,13.03866413423999,60.0,0.49026079686549906,49.24863012380982,22.73580501967506,159.70930765384614,160.8955973826146,-77.26419498032494
2020-10-27,161.246994,164.582993,160.565002,164.316498,164.316498,85820000,7557012302.14607,10889910000,12.183383593890701,48.00000000000001,0.6877284158286159,54.70272337731013,43.91931475700018,160.33596146153846,161.14899742834686,-56.08068524299982
2020-10-28,162.464996,163.201004,158.123505,158.139008,158.139008,111766000,7445928806.779945,10778144000,11.796008369601946,48.0,0.34181092737148333,46.34502017264278,10.911079008512655,160.4009428076923,160.9260352484693,-89.08892099148736
2020-10-29,160.063507,162.862503,158.199997,160.550507,160.550507,131930000,7447018596.6954975,10910074000,11.436302804190959,48.0,0.2592679614592157,49.583284278673226,23.796462473195323,160.8070009230769,160.8982183411753,-76.20353752680468
2020-10-30,157.887497,158.350006,150.949997,151.807495,151.807495,167728000,7318162556.052303,10742346000,12.504291243587744,44.0,-0.5058053247849443,40.12740397830202,3.622872882790231,160.83846219230767,160.22483142701415,-96.37712711720977
2020-11-02,153.087006,153.985504,147.505997,150.223999,150.223999,145148000,7294786954.568424,10597198000,14.007188005720968,-60.0,-1.225776323126837,38.68831684120485,10.560266401367635,160.66413523076923,159.4840290250131,-89.43973359863236
2020-11-03,150.926498,153.744995,149.048996,152.420502,152.420502,97958000,7337487410.734195,10695156000,15.40273499913039,-60.0,-1.6006675916496818,41.80594394688757,21.864590055481116,160.42251996153846,158.96080480093804,-78.13540994451888
2020-11-04,157.999496,162.242493,156.986496,162.057999,162.057999,136780000,7464665012.057027,10831936000,14.622435814331897,-60.0,-1.107341416371014,53.07949521432734,64.74173049300828,160.60767365384618,159.19022659346115,-35.25826950699173
2020-11-05,165.998505,168.339996,164.444,166.100006,166.100006,115786000,7447309457.425041,10947722000,14.332545964197653,-60.0,-0.38577372444188995,56.85464071521411,89.24839153539364,160.9408856923077,159.70206210505663,-10.751608464606365
2020-11-06,165.231995,166.100006,161.600006,165.568497,165.568497,92946000,7518299174.974375,10854776000,13.530743862103947,-60.0,0.1415537917355607,56.21414697624724,86.69722985011181,161.11417388461538,160.1366128380154,-13.302770149888195
2020-11-09,161.551498,164.449997,155.605499,157.186996,157.186996,143808000,7425920192.330928,10710968000,13.320086949296039,-60.0,-0.11552078438452895,47.18670888350971,46.46731047649558,161.1502121923077,159.9181227018661,-53.53268952350442
2020-11-10,154.751007,155.699997,150.973999,151.751007,151.751007,131820000,7337445616.751336,10579148000,13.759843626490396,-60.0,-0.7492561612947384,42.42776582306122,20.37539696531606,160.8344814230769,159.31315116839454,-79.62460303468394
2020-11-11,153.089005,156.957504,152.5,156.869507,156.869507,87338000,7421335282.443167,10666486000,13.926975527660119,-60.0,-0.8289205601697347,47.76929416850562,44.94341196810074,160.9064624230769,159.1321404892542,-55.05658803189927
2020-11-12,157.997498,158.794006,154.302505,155.514008,155.514008,87240000,7381158178.218988,10579246000,13.72920904348542,-60.0,-0.9900202737023847,46.537890826652834,38.43722465379776,160.74221273076924,158.86413067523537,-61.562775346202244
2020-11-13,156.100006,157.085999,154.269501,156.440506,156.440506,75124000,7421847915.434496,10654370000,13.550791667970945,-60.0,-1.031047043293995,47.5334430278032,42.88427296171027,160.62348234615385,158.68460292151423,-57.11572703828973
2020-11-16,154.660004,157.134995,153.634506,156.552994,156.552994,76174000,7472692114.841494,10730544000,13.491435050692944,-60.0,-1.04246729817865,47.66087862799078,43.424198110022,160.32427042307694,158.52670596436502,-56.57580188997801
2020-11-17,159.177002,159.462494,156.763,156.783005,156.783005,68894000,7404819213.217708,10799438000,12.936499575598697,-56.00000000000001,-1.0211863662714507,47.93932725039614,44.528215634454014,159.7333667692308,158.3975429299676,-55.47178436554599
2020-11-18,156.699997,157.0,155.255005,155.272995,155.272995,58336000,7347686041.466499,10741102000,12.700778922457967,-52.0,-1.1133324581815032,46.201561627579565,37.28039921668422,159.08303953846155,158.1660949351552,-62.71960078331578
2020-11-19,155.265503,156.25,154.046005,155.850998,155.850998,60206000,7386093158.60878,10801308000,12.705253541161042,-44.0,-1.12673063892953,46.993629300267166,40.05472497142768,158.60863557692306,157.99460627329188,-59.94527502857232
2020-11-20,155.850998,156.644501,154.902496,154.970001,154.970001,67488000,7323835657.304247,10733820000,12.612640121676472,-44.0,-1.1946665168497077,45.88473570794545,30.693095225752945,158.14853965384614,157.77056143823324,-69.30690477424706
2020-11-23,155.835007,156.987503,153.272995,154.919495,154.919495,94178000,7313148702.147871,10639642000,12.847665671384243,12.0,-1.2383071674498751,45.81798742102545,22.719663028848935,157.8133087692308,157.55937133169746,-77.28033697115107
2020-11-24,155.024994,156.712494,154.313004,155.903,155.903,72042000,7336582400.59379,10711684000,13.065903681827175,12.0,-1.1799305584619617,47.42195148353917,28.383057995460863,157.6418663076923,157.43667715897914,-71.61694200453914
2020-11-25,157.093506,159.899994,157.013,159.253494,159.253494,75808000,7378438219.189879,10787492000,12.414085989992984,12.0,-0.8534715222638454,52.57285525074679,54.73681851396729,157.58044323076922,157.57125618423993,-45.26318148603271
2020-11-27,160.563004,160.809494,159.502502,159.766998,159.766998,47858000,7349950268.230731,10835350000,11.580601927708964,11.999999999999996,-0.5470093198606207,53.32752933170197,65.24933440922153,157.60044338461537,157.73390372614807,-34.75066559077846
2020-11-30,160.423996,161.419495,156.277496,158.401993,158.401993,81278000,7335834812.278678,10754072000,11.551449996864383,12.0,-0.40955916903348566,51.004186112488824,71.11193187953926,157.58436592307692,157.7833918205075,-28.88806812046074
2020-12-01,159.425003,162.447495,157.858994,161.003998,161.003998,90740000,7369483000.473472,10844812000,11.247975560432035,12.0,-0.08963561304031487,55.02651024264199,85.48883914995677,157.61451965384614,158.02195524121063,-14.511160850043225
2020-12-02,161.082504,161.600006,158.662994,160.176498,160.176498,62586000,7371400762.353913,10782226000,10.966177869459141,12.000000000000004,0.09602683810007306,53.52166357489215,75.2466401438771,157.60776938461538,158.18155100112097,-24.7533598561229
2020-12-03,160.272995,161.432007,159.065506,159.336502,159.336502,57840000,7326807668.769756,10724386000,10.70450858498431,12.0,0.17338632160780776,51.96802362659229,66.09087143713543,157.41623107692308,158.26710292696384,-33.90912856286457
2020-12-04,159.910507,159.910507,157.938004,158.128998,158.128998,58272000,7279820419.533633,10666114000,10.762874716143163,12.0,0.13569458564822412,49.73310165784408,52.929347648373096,157.41584607692306,158.25687293237394,-47.070652351626904
2020-12-07,157.824005,159.037994,157.084503,157.899994,157.899994,55026000,7270735975.206016,10611088000,11.043163267746845,12.0,0.08634952088618775,49.300076695824266,50.433255218267874,157.31390326923076,158.2304374559018,-49.566744781732126
2020-12-08,157.945007,159.206497,156.001007,158.864502,158.864502,65726000,7322437309.167438,10676814000,11.587571667356936,12.0,0.12364562660383172,51.22627399914404,60.946176903373285,157.58532661538462,158.27740519990908,-39.053823096626715
2020-12-09,158.394501,158.721497,154.399994,155.210007,155.210007,82016000,7271167105.807171,10594798000,12.494388102969191,8.0,-0.14006951138495083,44.350820513825695,21.11299798354115,157.77709615384614,158.05019051843433,-78.88700201645885
2020-12-10,154.449493,157.104996,153.800003,155.074493,155.074493,60604000,7257304016.88323,10534194000,13.483112205283886,-12.0,-0.35589793560538396,44.114375482833836,19.6359256635237,157.87917273076923,157.8297684800318,-80.36407433647629
2020-12-11,154.832993,155.933502,153.641006,155.820999,155.820999,61294000,7312582077.1546545,10595488000,14.441625212283258,-12.0,-0.4613881262555424,45.827699997514365,27.77267426017759,157.6392881153846,157.6809707407702,-72.2273257398224
2020-12-14,157.149994,159.523499,156.300003,157.848495,157.848495,83116000,7309320037.619939,10678604000,13.905223871388811,-8.0,-0.3770415790297932,50.28562625478024,47.777144784942216,157.32192230769232,157.69337994515757,-52.222855215057784
2020-12-15,159.050507,159.425003,156.524506,158.255997,158.255997,66390000,7322194858.43513,10744994000,13.407136911986825,-4.0,-0.27415404967598533,51.15563672600424,52.404437228048586,157.04067230769232,157.73505528255333,-47.595562771951414
2020-12-16,158.800507,162.350006,158.184006,162.048004,162.048004,88552000,7397908221.323272,10833546000,12.943096197860616,56.00000000000001,0.11207638556905408,58.443575991093134,95.46367456996754,157.22763415384617,158.05453296532716,-4.536325430032466
2020-12-17,162.5,163.175507,161.050003,161.804001,161.804001,69486000,7377720933.560933,10764060000,12.763909746057722,100.0,0.393936727877076,57.84548061490788,85.61533529651935,157.61428776923077,158.33227133826588,-14.384664703480654
2020-12-18,162.199493,162.470993,158.580002,160.082504,160.082504,119914000,7350416258.449117,10644146000,11.964474389292814,68.0,0.47295077694599286,53.67218876201819,67.55988593425069,157.73786457692307,158.46191820209805,-32.440114065749306
2020-12-21,160.000504,161.348495,158.300003,160.309006,160.309006,76736000,7374820661.119027,10720882000,11.31423183419362,68.0,0.5475351541145699,54.14098540869423,69.93549006917092,157.92228757692308,158.59873952046115,-30.06450993082908
2020-12-22,160.141998,161.100006,159.003998,160.326004,160.326004,47388000,7387210314.95241,10768270000,10.710435175887225,68.0,0.6010864564077281,54.17845878927679,70.11376893242765,158.07172980769232,158.72668503746402,-29.886231067572353
2020-12-23,160.25,160.5065,159.208496,159.263504,159.263504,41876000,7348883633.764988,10726394000,10.149766850317002,68.0,0.5514347820629553,51.35367334426705,58.9700289506499,158.1759801923077,158.7664494050593,-41.0299710493501
2020-12-24,159.695007,160.100006,158.449997,158.634506,158.634506,29038000,7326339867.847347,10697356000,9.923593588733413,68.0,0.4560732619117971,49.701582050872254,52.37295585788895,158.2471917692308,158.75667581949935,-47.62704414211105
2020-12-28,159.699997,165.199997,158.634506,164.197998,164.197998,113736000,7405360000.210335,10811092000,10.512174349682807,92.0,0.8199737317430902,61.49963335331458,91.33143195630151,158.5904611153846,159.15973672175866,-8.668568043698489
2020-12-29,165.496994,167.532501,164.061005,166.100006,166.100006,97458000,7422386913.6067505,10908550000,11.665241327039071,96.0,1.2474636413631401,64.56016711775176,89.68797094913118,158.98465373076922,159.67383074236912,-10.31202905086882
2020-12-30,167.050003,167.104996,164.123505,164.292496,164.292496,64186000,7365477042.446985,10844364000,12.735946377441318,96.0,1.4239866914487607,59.70301581750885,76.67634045147769,159.3432112307692,160.01595409478622,-23.323659548522304
2020-12-31,163.75,164.145996,162.059998,162.846497,162.846497,59144000,7350932027.542848,10785220000,12.85972060392709,44.0,1.4307101102742479,56.06880392641377,66.26710084119816,159.64809592307694,160.2256239396169,-33.73289915880184
2021-01-04,163.5,163.600006,157.201004,159.331497,159.331497,88228000,7321453543.921808,10696992000,12.51136076961197,44.0,1.1392744969862747,48.36221522952496,26.98860039859354,159.7799611923077,160.1593923144601,-73.01139960140647
2021-01-05,158.300507,161.169006,158.253006,160.925507,160.925507,53110000,7365693700.375855,10750102000,12.187883780605071,44.0,1.0251160592593749,51.610418162798034,39.980041778725464,159.84426938461536,160.21614155042602,-60.019958221274536
2021-01-06,157.324005,159.875504,156.557999,156.919006,156.919006,87896000,7296927179.470536,10662206000,12.370716853066869,44.0,0.6043865361484677,44.101345777414025,3.2895068951648168,159.73473123076923,159.9719092874315,-96.71049310483518
2021-01-07,157.850006,160.427002,157.75,158.108002,158.108002,70290000,7245437285.3949995,10732496000,12.334656844276036,44.0,0.36271623130485864,46.58511385721252,14.123675042384644,159.72342388461539,159.8338420809551,-85.87632495761535
2021-01-08,159.0,159.531998,157.110001,159.134995,159.134995,70754000,7292995922.01346,10803250000,12.492737549819719,44.0,0.251165249090576,48.70520607483028,23.481666867435152,159.65153915384616,159.782075630514,-76.51833313256485
2021-01-11,157.400497,157.819,155.5,155.710495,155.710495,73668000,7232701570.706863,10729582000,13.104388270500914,44.0,-0.11227401331763076,42.62925144865061,1.7493869312789487,159.4797698076923,159.48047706529073,-98.25061306872105
2021-01-12,156.0,157.106995,154.300003,156.041504,156.041504,70292000,7249630046.0712385,10799874000,13.997204689649594,44.0,-0.36933512189023077,43.364702274071234,13.160787932860451,159.3530391153846,159.22573831971363,-86.83921206713956
2021-01-13,156.421997,159.497498,156.104004,158.294495,158.294495,66424000,7268959062.9818325,10866298000,13.839383994541071,44.0,-0.38680155029453545,48.229346752068764,30.186983591458016,159.3594043846154,159.15675733306819,-69.81301640854198
2021-01-14,158.376007,158.899994,156.029495,156.373505,156.373505,61418000,7222262131.465047,10804880000,13.716014813274489,44.00000000000001,-0.5493194466193358,44.70355761264337,15.669769985984443,159.30069326923075,158.95059049358164,-84.33023001401556
2021-01-15,156.151001,157.127502,154.758499,155.212494,155.212494,84880000,7169914885.201534,10720000000,13.998838832642596,44.0,-0.7630044942058021,42.67309493191115,6.895833273505797,159.1602314230769,158.67369445702005,-93.10416672649421
2021-01-19,155.350006,157.25,154.800003,156.037994,156.037994,66102000,7170615971.96613,10786102000,14.206596766736864,44.0,-0.8558744945175931,44.599861928118884,13.134262329002391,159.19207707692308,158.47845738612966,-86.8657376709976
2021-01-20,159.099503,163.990005,158.75,163.169006,163.169006,106196000,7243534595.397215,10892298000,14.313109223807226,44.0,-0.3500266771605709,57.795912945279866,69.26206831975617,159.50340450000002,158.82590543160154,-30.737931680243832
2021-01-21,164.649994,167.427505,164.4785,165.349503,165.349503,98722000,7203128643.125855,10991020000,15.211893422778772,-36.0,0.22422452649138336,60.86551299758536,84.17062134136411,159.86988542307694,159.30913488111253,-15.829378658635886
2021-01-22,165.2155,166.095505,164.158005,164.611496,164.611496,56438000,7173110385.121209,10934582000,15.92717805369112,-36.0,0.6127088196489581,59.29361315655463,78.54878254827149,160.13000084615385,159.7019023714005,-21.451217451728514
2021-01-25,166.425003,168.194504,162.157501,164.699997,164.699997,74996000,7161283818.701414,11009578000,17.045070380596552,32.0,0.9171543277393823,59.428927070612936,74.84971212712136,160.377847,160.07213160314862,-25.150287872878636
2021-01-26,164.817993,166.899994,164.143494,166.306503,166.306503,59104000,7194936926.5816965,11068682000,18.083113255580166,32.0,1.2733824343317224,61.90448239799674,86.41188337745987,160.54163542307694,160.53393689180427,-13.588116622540126
2021-01-27,167.074493,167.326004,160.354004,161.628998,161.628998,93204000,7135822008.846757,10975478000,17.6278132731833,32.0,1.1648327465128148,51.96269631648267,52.747450232289715,160.53490453846155,160.6150525294484,-47.252549767710285
2021-01-28,161.751999,165.084,161.434494,161.880997,161.880997,62984000,7088249708.376502,11038462000,17.205034718100496,31.999999999999993,1.0866147318796493,52.40616429366303,54.561110183086164,160.60407734615384,160.7088261939337,-45.438889816913836
2021-01-29,161.5,161.849503,159.227493,160.309998,160.309998,85872000,7073282754.01706,10952590000,16.073938923583007,32.0,0.887627880165553,49.347640860432925,43.25448607330344,160.6041155,160.67928336475345,-56.74551392669656
2021-02-01,162.117996,167.513,161.751495,167.143997,167.143997,83204000,7145828939.570314,11035794000,16.45858155650581,32.0,1.2667733965700165,60.223030314637114,92.43940462489454,160.866346,161.15815104143837,-7.560595375105465
2021-02-02,169.0,171.386993,168.056503,169.0,169.0,141972000,7084295647.438527,11177766000,17.547675700276923,56.0,1.6974457823960734,62.57328688421987,85.64516425841094,161.2408266153846,161.73902874207255,-14.354835741589053
2021-02-03,171.250504,171.699997,165.431,165.626495,165.626495,141776000,6951362050.495986,11035990000,17.741055444593357,60.0,1.7464115458507194,56.08650457814395,64.15014776143177,161.50974926923078,162.02698920562273,-35.84985223856823
2021-02-04,166.5,167.350006,163.887497,166.550003,166.550003,73414000,6990851852.614045,11109404000,17.472477305482805,60.0,1.8385430637043498,57.38879590625992,69.60130680297578,161.600211,162.3620272644655,-30.398693197024215
2021-02-05,165.949997,168.850006,165.135498,167.607498,167.607498,72416000,7014821350.774232,11181820000,17.541202433159203,60.0,1.9741323946300895,58.89213652164874,75.7840209884098,161.65819146153848,162.75058065228285,-24.215979011590214
2021-02-08,167.925003,168.25,165.199997,166.147003,166.147003,65148000,6990129407.30139,11116672000,17.605018623144428,60.0,1.9413593929948831,55.955932962535464,57.11972751808371,161.72951865384616,163.0021674928545,-42.88027248191629
2021-02-09,165.624496,166.899994,164.891998,165.25,165.25,44070000,6961773729.580916,11072602000,17.561242802611282,60.0,1.822002991223826,54.169597724464445,48.28627034314839,161.82196107692306,163.1686736044949,-51.71372965685161
2021-02-10,165.699997,165.897507,162.699997,164.328995,164.328995,63032000,6962966080.36387,11009570000,16.807124812683742,60.0,1.634256089651359,52.322630577528784,40.90198728338742,162.0141725384615,163.25462333749527,-59.09801271661258
2021-02-11,164.600006,164.600006,162.403,163.106506,163.106506,46028000,6946415445.621861,10963542000,16.012827379666156,60.0,1.3710164477965066,49.89102227120216,31.10051518123378,162.0980571153846,163.24365168286602,-68.89948481876623
2021-02-12,162.5,164.012497,161.665497,163.885498,163.885498,46706000,6988066809.666174,11010248000,15.034776672583543,60.0,1.2112922560550317,51.43968989867057,37.346189666485635,162.36599911538462,163.29119585450556,-62.653810333514365
2021-02-16,162.702499,165.414993,162.679504,163.447495,163.447495,51494000,6965486783.40469,10958754000,14.553906538811585,60.0,1.0374079091800468,50.4947211919237,33.8344409430536,162.5713642307692,163.30277356898662,-66.16555905694639
2021-02-17,163.179993,166.045502,162.975006,165.432007,165.432007,65950000,7005082738.162488,11024704000,14.296004786089211,60.0,1.0476600714953008,54.56712325859147,49.74553626120301,162.813557,163.4604945638765,-50.25446373879699
2021-02-18,164.121002,166.899994,163.697006,166.411499,166.411499,60548000,7047162111.205409,11085252000,14.313102730916345,60.0,1.1218893602437845,56.47045761612597,57.59874681138599,163.22513407692307,163.67908748507082,-42.40125318861401
2021-02-19,166.411499,166.675003,162.287506,162.494995,162.494995,86104000,6969201994.998833,10999148000,13.781987395679957,48.00000000000001,0.8548334769527912,47.84025989737934,8.26646071054861,163.47334526923078,163.59137693062112,-91.73353928945139
2021-02-22,160.406494,161.615997,158.613007,159.037003,159.037003,70314000,6918743442.232423,10928834000,13.51283172492955,48.0,0.3600087538392813,41.77040611606654,3.239828256917662,163.50190326923075,163.25401589872328,-96.76017174308235
2021-02-23,156.351501,160.236496,154.679993,159.725006,159.725006,93544000,6995065523.856783,11022378000,14.253402292425124,-52.0,0.02310633255274297,43.31150552313274,29.641667534273267,163.63080715384615,162.9926077580771,-70.35833246572673
2021-02-24,158.337494,158.561493,156.268997,157.976501,157.976501,60226000,7024554957.082402,10962152000,14.94107496224244,-52.0,-0.3805937562906081,40.38613792814713,23.263973011175178,163.73711511538463,162.62104429451585,-76.73602698882483
2021-02-25,156.837006,158.912994,152.388,152.858002,152.858002,90676000,6946941927.363141,10871476000,16.394746921921598,-60.0,-1.100859059443735,33.296336849327076,2.855071247088561,163.61480773076923,161.89785597640355,-97.14492875291144
2021-02-26,154.759995,156.121994,151.835007,154.6465,154.6465,85518000,6973592804.186887,10956994000,17.848520913391475,-64.0,-1.5099518746270348,37.42967249697848,17.127591830225033,163.28701903846152,161.36071849666996,-82.87240816977497
2021-03-01,156.394501,157.477997,154.899506,157.307007,157.307007,54582000,7020935704.899746,11011576000,18.650930807520922,-64.0,-1.6010245831082557,43.080034202610186,36.32263340154232,162.97769226923077,161.0604435709907,-63.67736659845768
2021-03-02,157.173492,158.175995,154.356003,154.726501,154.726501,51916000,6979090288.381597,10959660000,19.118158073399055,-64.0,-1.8599848808287618,39.36671605441502,19.19347159078214,162.59750015384617,160.59126263980622,-80.80652840921786
2021-03-03,154.059006,155.389008,149.75,150.25,150.25,79774000,6913463102.856767,10879886000,20.494541156144987,-76.0,-2.398777388947906,33.90674092303901,2.9154529150272603,162.04173103846153,159.82524318500575,-97.08454708497274
2021-03-04,150.600006,152.906494,147.2715,148.878494,148.878494,109632000,6866361059.839151,10770254000,22.18074088725939,-80.0,-2.9029796629563975,32.42299899555253,8.187046851378343,161.37142300000002,159.01437287500534,-91.81295314862166
2021-03-05,150.25,150.449997,144.050003,150.022995,150.022995,107772000,6959752152.749552,10878026000,24.20525055548756,-84.0,-3.1736283202228037,34.979952050927025,26.140019048585216,160.92503826923078,158.3483448842642,-73.85998095141478
2021-03-08,150.75,153.229507,147.565506,147.597504,147.597504,83700000,6876997856.1842785,10794326000,25.048041498303377,-84.0,-3.5429947460557685,32.19934834563958,15.525174605101528,160.37567315384615,157.55198630024464,-84.47482539489847
2021-03-09,150.899506,154.548004,150.257507,153.142502,153.142502,80600000,6904791171.457544,10874926000,25.374409231400787,-84.0,-3.3496723646308055,43.29659920487652,39.79213383497616,160.10000023076924,157.22535783355985,-60.20786616502383
2021-03-10,154.922501,155.822998,151.502502,152.882004,152.882004,60250000,6883015918.569913,10814676000,25.2457821684914,-84.0,-3.1808165231767305,42.9410157610392,39.03646850828726,159.55146203846152,156.90362791996284,-60.96353149171274
2021-03-11,155.2005,156.589005,154.1465,155.679504,155.679504,55528000,6897190659.0859,10870204000,24.867861294099594,-84.0,-2.7891110459898982,47.890448918339864,66.20462810131902,159.03913526923077,156.81295207403969,-33.79537189868098
2021-03-12,153.75,154.949005,152.274994,154.474503,154.474503,48438000,6928438058.242448,10821766000,24.925955711669957,-76.0,-2.5465599849917737,46.037985113963295,64.40246197863863,158.61021250000002,156.63973362411082,-35.59753802136136
2021-03-15,153.7285,154.112,151.604507,154.084,154.084,58272000,6985408665.975351,10763494000,25.122483902931485,-76.0,-2.35865771230101,45.42476671181347,67.50994466726114,158.13075084615386,156.45042002232483,-32.490055332738855
2021-03-16,155.248505,156.445496,153.792999,154.593002,154.593002,50776000,6965261128.384923,10814270000,24.470854879140955,-72.0,-2.1439573936709166,46.4264469791751,70.93457164846573,157.6301933076923,156.3128335021526,-29.06542835153427
2021-03-17,153.660995,158.652496,153.511002,156.786499,156.786499,62372000,6982359919.903497,10876642000,23.159667852579737,-68.0,-1.776332512765066,50.63162681532748,87.22138062315784,157.27017392307692,156.34791983532648,-12.778619376842162
2021-03-18,155.050003,155.831497,151.25,151.399506,151.399506,72992000,6914131752.315479,10803650000,22.518463837378885,-44.0,-1.8977958509412076,41.927467953152394,50.3304675441378,156.7374626153846,155.98137066233932,-49.6695324558622
2021-03-19,151.461502,153.864502,150.831497,153.748001,153.748001,92508000,6999533087.797617,10896158000,22.026300306787128,-44.0,-1.7839878013533905,46.26451388214432,66.4133035365946,156.33050130769232,155.8159358725364,-33.58669646340541
2021-03-22,153.392502,156.328995,153.002502,155.543503,155.543503,58044000,7030164976.815871,10954202000,20.77225443533689,-44.00000000000001,-1.5312606764472037,49.37730148274167,78.70916288061207,156.03961657692307,155.7957556597559,-21.290837119387934
2021-03-23,156.350006,159.100006,156.042496,156.875,156.875,76346000,6995394213.125155,11030548000,19.749997090258255,-44.0,-1.2095885452364428,51.61567212274764,85.21590992373883,155.76998203846154,155.8756996849592,-14.784090076261162
2021-03-24,157.552002,158.015503,154.257507,154.3535,154.3535,59180000,6939237561.601311,10971368000,18.392390581187787,-44.0,-1.1449270345130458,47.34618991596204,68.46176043951613,155.420213,155.76294415273998,-31.538239560483873
2021-03-25,153.649506,155.488998,151.856995,152.313004,152.313004,71270000,6885863891.21888,10900098000,17.764566618907462,-44.0,-1.243993314892009,44.16265064504362,41.15911396246048,154.91563596153847,155.5073930303148,-58.84088603753952
2021-03-26,152.203003,152.832993,149.800003,152.601501,152.601501,66258000,6942007649.539218,10966356000,17.67295672490035,-40.0,-1.28441877883688,44.72852042752004,30.123624691303952,154.3844821923077,155.29214176881,-69.87637530869605
2021-03-29,152.772003,154.5625,151.422501,153.786499,153.786499,54920000,6969782433.93883,11021276000,17.051541528308082,-36.0,-1.2069241448467949,47.099942473704374,42.86553455950484,154.04954003846154,155.18061267482406,-57.13446544049516
2021-03-30,153.500504,153.649994,151.699997,152.764496,152.764496,46752000,6974074058.362868,10974524000,16.474513131472403,-32.0,-1.2139821593007412,45.29494445057717,31.876258534540295,153.80828976923075,155.00164106928153,-68.1237414654597
2021-03-31,153.203003,155.966507,153.125,154.703995,154.703995,61878000,6980965941.815557,11036402000,15.365327820187554,48.0,-1.0509595192370682,49.268303506690074,52.73107976416767,153.61517396153846,154.97959321229771,-47.26892023583233
2021-04-01,155.897003,158.121994,155.777496,158.050003,158.050003,58806000,7036160505.383535,11095208000,14.926771186650905,48.0,-0.6443404648369153,55.30025074585069,88.70964880333906,153.61800096153846,155.20703097434975,-11.290351196660941
2021-04-05,158.649994,161.798004,158.061996,161.336502,161.336502,66698000,7086380349.878515,11161906000,15.382450640057481,80.0,-0.0562505109354845,60.29398741516536,96.15350923874739,153.94409711538464,155.66106586513865,-3.846490761252615
2021-04-06,161.1875,162.365494,160.852005,161.190994,161.190994,50756000,7058360855.639707,11111150000,15.927257326474665,84.0,0.3935372821318026,59.97452086806127,90.65297169843961,154.19580842307693,156.0706901714247,-9.34702830156038
2021-04-07,161.690002,165.180496,161.182495,163.969498,163.969498,66924000,7084742179.361236,11178074000,17.003158649294882,88.0,0.9630974130861887,63.9071369737099,92.12640323037748,154.45205807692307,156.65578704761546,-7.8735967696225195
2021-04-08,165.544998,166.225006,164.600006,164.964996,164.964996,56242000,7053765124.075082,11234316000,18.198253362071704,92.0,1.4777714596961857,65.22545596130036,92.32870764163638,154.84584634615385,157.27128400705135,-7.671292358363611
2021-04-09,165.235001,168.610001,164.445007,168.610001,168.610001,86830000,7140595124.075082,11321146000,19.729646250612024,96.0,2.154935040832868,69.60336824688696,100.0,155.55200023076924,158.111188969492,-0.0
2021-04-12,167.760498,169.751999,167.557495,168.969498,168.969498,65636000,7159423065.729322,11386782000,21.341018698092096,100.0,2.6895964671840034,70.00446035498092,96.07808161148377,156.32473115384616,158.91550815693702,-3.921918388516239
2021-04-13,170.042496,171.600006,169.781494,170.0,170.0,66316000,7109043659.929415,11453098000,23.13037331005895,100.0,3.1600453628473417,71.17847590512854,92.66052394579943,157.0930775,159.73658162679354,-7.339476054200577
2021-04-14,170.201996,170.206497,166.300003,166.649994,166.649994,62904000,7057411062.810873,11390194000,23.4737469843704,44.0,3.2253818211266037,62.600646283848434,77.29352606052387,157.82586557692306,160.24868624703106,-22.70647393947613
2021-04-15,168.550003,169.850006,167.600006,168.954498,168.954498,64672000,7070603690.921095,11454866000,23.792593967659606,44.0,3.4236499428995444,65.66592939181346,87.86464387183797,158.43401926923076,160.89356119169543,-12.135356128162028
2021-04-16,169.0,170.339996,167.779495,169.972,169.972,63720000,7116007974.4890375,11518586000,24.19244492974388,44.0,3.6211405118908715,66.95379508587065,91.93157925125034,159.0913268076923,161.56603814045872,-8.068420748749658
2021-04-19,169.516495,171.796494,168.007996,168.600494,168.600494,54508000,7078549412.542852,11464078000,24.869514269978747,60.0,3.6251951455804488,63.49645665933122,84.09673088797516,159.58828796153844,162.0871089448692,-15.903269112024837
2021-04-20,168.679993,169.149506,165.800003,166.734497,166.734497,52460000,7055361549.477795,11411618000,24.638285320159092,60.0,3.4382046261568746,59.030246034470785,72.8891699828627,160.05982619230767,162.4313599119159,-27.11083001713731
2021-04-21,165.800003,168.143005,165.190506,168.100998,168.100998,44224000,7098327145.957252,11455842000,24.197024685550076,60.0,3.3615288901280564,61.18347427410831,76.9305420975769,160.59894150000002,162.85133310362585,-23.069457902423082
2021-04-22,168.584,168.643494,165.072495,165.451996,165.451996,51612000,7057685076.563225,11404230000,23.91855871500763,60.0,3.051830887368993,55.13418081792896,53.806116539534344,161.0165951153846,163.04397479965354,-46.193883460465656
2021-04-23,165.955002,168.75,165.425003,167.044006,167.044006,63856000,7056014429.252565,11468086000,23.689238926600662,60.0,2.9014092511632157,57.83251891911731,56.576428556874625,161.4111146153846,163.3402734070866,-43.423571443125375
2021-04-26,167.399994,171.422501,166.546997,170.449997,170.449997,97614000,7114686811.952692,11565700000,24.16690290501481,60.0,3.0221960347494132,62.964461782248534,87.31395207404863,162.1438258076923,163.86691959915427,-12.686047925951364
2021-04-27,172.173492,173.0,169.900497,170.871506,170.871506,76542000,7086102804.494078,11642242000,24.968189924684516,84.0,3.1160132237727964,63.55559190978079,75.11986275149506,162.80242215384618,164.38577785106878,-24.88013724850494
2021-04-28,171.740005,174.494003,171.25,172.925003,172.925003,92638000,7089129899.695285,11734880000,26.027718129974595,88.0,3.3178183237338885,66.37165171940455,84.38649990506524,163.47094138461537,165.01831304728591,-15.61350009493476
2021-04-29,175.255005,175.722504,171.75,173.565506,173.565506,153648000,7075921715.936125,11888528000,27.25698200345459,92.0,3.489212093518404,67.222397753228,79.74651476820357,164.1128839230769,165.65143845119064,-20.253485231796432
2021-04-30,176.255997,177.699997,173.125,173.371002,173.371002,140186000,6950811588.716806,11748342000,28.76347313685323,96.0,3.5682158721983512,66.67080047051653,65.71772469329251,164.8443263076923,166.22325797332468,-34.28227530670749
2021-05-03,174.236496,174.332504,168.634995,169.324493,169.324493,117510000,6861743109.381363,11630832000,28.250506276029643,96.0,3.26665155210776,56.317312210855306,33.67251891941881,165.49861434615383,166.45297908641174,-66.3274810805812
2021-05-04,167.809494,168.399002,163.606506,165.593506,165.593506,108788000,6843163533.551148,11522044000,26.243109762388862,92.0,2.6955278192492074,48.79345559071939,14.098706984664018,165.99830684615384,166.3893144133442,-85.90129301533598
2021-05-05,166.942993,167.735001,163.218002,163.526993,163.526993,74226000,6779092579.397295,11447818000,24.48360298951894,88.0,2.052497899553771,45.192144559302484,2.1336217834627904,166.37294123076924,166.17729060494835,-97.86637821653721
2021-05-06,163.5,165.720001,162.360001,165.318497,165.318497,88954000,6846787420.578248,11536772000,23.086434836853794,84.0,1.6682212399684317,48.725328635612215,19.286158875139208,166.85578742307692,166.11367626384106,-80.71384112486078
2021-05-07,165.954498,166.544495,164.453506,164.580505,164.580505,94206000,6764024874.172694,11442566000,21.536685847814734,80.0,1.289267558071458,47.37060429007532,14.47525801180117,167.2356531923077,166.00010802207504,-85.52474198819884
2021-05-10,164.115997,164.149994,159.5,159.524506,159.524506,116772000,6648483677.753086,11325794000,21.357739172213222,76.0,0.5743464619063161,39.307356520257606,0.13464837384315154,167.29236484615382,165.52043379821765,-99.86535162615684
2021-05-11,156.813995,161.899994,156.3685,161.195496,161.195496,92396000,6717344337.315946,11418190000,21.819505918646637,-28.0,0.14097618471816986,42.774277323742425,22.628491568125686,167.28694153846158,165.20006803538672,-77.37150843187432
2021-05-12,159.25,160.397003,156.654999,157.597,157.597,98728000,6668323325.725365,11319462000,22.248289326049097,-28.0,-0.4872250089160559,37.77055612446601,5.759089481624275,167.148711,164.63687781054327,-94.24091051837571
2021-05-13,159.273499,160.192001,156.649994,158.073502,158.073502,67018000,6655173462.713236,11386480000,22.64748271188783,-28.0,-0.9358414539694593,38.79161256119768,7.992884887544368,166.92194192307696,164.15070182457708,-92.00711511245562
2021-05-14,159.278,161.442993,159.149994,161.145004,161.145004,66500000,6704389313.43973,11452980000,22.54900992491181,-28.0,-1.031636612299394,45.05038601029885,22.391789943293674,166.77501915384616,163.92805754127508,-77.60821005670633
2021-05-17,162.296494,164.637497,161.729507,163.519501,163.519501,74478000,6721600193.4785185,11527458000,21.38520426826429,-27.999999999999993,-0.9055146923322468,49.36127246258996,33.52320280194112,166.57923069230768,163.89779409377323,-66.47679719805889
2021-05-18,164.628998,165.600006,161.518494,161.613998,161.613998,56568000,6667679482.165652,11470890000,20.01141948002103,-28.0,-0.9483879038413647,46.227110869457626,24.590388569541094,166.29632684615385,163.728624012753,-75.40961143045891
2021-05-19,159.75,161.737503,159.199997,161.589996,161.589996,53594000,6715042568.6954975,11417296000,19.372188777848653,-28.0,-0.9730848769173122,46.18732944154492,24.477869509111365,165.9728651538462,163.57020712291944,-75.52213049088864
2021-05-20,162.220001,162.983994,161.809006,162.384003,162.384003,52664000,6713922315.53887,11469960000,18.381318733216283,-28.0,-0.9180054811572518,47.788048533819484,33.48642652272845,165.80878857692306,163.48234015085134,-66.51357347727155
2021-05-21,162.5,162.834503,159.850494,160.154007,160.154007,82098000,6648525210.391399,11387862000,17.98854946513458,-28.0,-1.0422819262892915,43.84347559949878,31.465910566325498,165.47030815384613,163.235796954492,-68.5340894336745
2021-05-24,160.774994,162.897507,160.524994,162.249496,162.249496,48456000,6670511369.327515,11436318000,17.602071801248254,-28.0,-0.9606101391273398,48.172655527214594,51.7397218370014,165.17328876923077,163.16273762452963,-48.2602781629986
2021-05-25,163.333496,163.990997,160.688004,162.952499,162.952499,65222000,6694720314.467271,11501540000,16.857003535254375,-28.0,-0.8295951362041194,49.5770532421611,64.70127982570723,164.9560581923077,163.147164393083,-35.29872017429276
2021-05-26,163.729507,164.786499,162.925507,163.257996,163.257996,47680000,6664077545.707383,11549220000,15.887565097953777,-28.000000000000004,-0.6931238474613792,50.208477149141,67.70341376936584,164.82234661538462,163.1553741417435,-32.296586230634155
2021-05-27,162.800003,163.018005,161.501999,161.505493,161.505493,51224000,6613089661.733309,11497996000,15.438591372795253,-28.0,-0.7181038594439997,46.60315080324076,55.646315996544786,164.56867334615384,163.03316072383655,-44.353684003455214
2021-05-28,162.100006,162.399506,160.985001,161.153503,161.153503,46596000,6577595098.903201,11451400000,15.18253324304799,-28.0,-0.7575705484965738,45.890387233799004,51.833395331162556,164.4033466923077,162.89392681836716,-48.166604668837444
2021-06-01,162.175003,162.548996,160.453003,160.932495,160.932495,48600000,6551231157.134312,11402800000,15.113900423129335,-28.0,-0.7974887288255559,45.42065971448317,47.84910902912743,164.1682885769231,162.7486355725622,-52.15089097087257
2021-06-02,161.154999,161.75,160.399994,161.699493,161.699493,40290000,6588506463.821836,11443090000,15.067780893720128,-28.0,-0.7584904401508084,47.431692705674536,56.41890759476064,163.8317307307692,162.67092130792796,-43.58109240523936
2021-06-03,160.211502,160.722,159.201508,159.350494,159.350494,47966000,6549940398.153619,11395124000,15.424553511907517,-28.0,-0.9066769952899563,42.292155466556906,3.1085213484874874,163.3886148846154,162.42496372956293,-96.89147865151251
2021-06-04,160.600006,161.050003,159.940506,160.311005,160.311005,44994000,6534996469.503068,11440118000,15.593646236848238,-28.0,-0.9358231111934003,44.92031102388454,17.359475588237395,162.9034611153846,162.26837419403975,-82.6405244117626
2021-06-07,159.866501,160.399994,158.610001,159.900497,159.900497,44316000,6554579736.970594,11395802000,16.198781646947772,-28.000000000000004,-0.9807408132693922,43.998050513132,18.46201826751184,162.37788384615385,162.09297588337014,-81.53798173248816
2021-06-08,161.130493,163.976501,160.900497,163.205505,163.205505,68334000,6588658098.379746,11464136000,15.157184406232009,-24.0,-0.7411088497873948,52.460581920415706,74.40306788733666,161.9869031923077,162.17538544756493,-25.59693211266334
2021-06-09,163.643494,164.878998,163.535004,164.057495,164.057495,49110000,6577732097.727958,11513246000,14.299249674018085,-20.0,-0.47695231030957075,54.37461887699293,86.89578253108098,161.78432634615385,162.3148009699675,-13.104217468919016
2021-06-10,164.100494,167.550003,164.057495,167.482498,167.482498,69530000,6644574274.163917,11582776000,14.40170558991552,-16.0,0.008662907917255325,61.14687739911789,99.24491068346505,161.85697988461536,162.69759334256253,-0.7550893165349549
2021-06-11,167.482498,168.328995,166.672501,167.341507,167.341507,56348000,6633740655.849573,11526428000,14.732900501128501,88.0,0.37778480358883826,60.74714622283289,89.83960685642992,162.00369196153846,163.04158694681715,-10.160393143570072
2021-06-14,167.341507,169.25,166.774994,169.193497,169.193497,51394000,6682788063.411414,11577822000,15.315477003041527,92.0,0.8104147240883322,64.06980148813363,99.46895671700727,162.15273042307692,163.49728398779365,-0.531043282992717
2021-06-15,169.199997,169.849503,168.155502,169.156494,169.156494,48524000,6691610116.699458,11529298000,16.034146857178754,96.0,1.1371824883077295,63.95331913952593,93.83416631804513,162.32873,163.91648472943857,-6.16583368195486
2021-06-16,169.600006,171.317505,168.026505,170.762497,170.762497,84056000,6747315006.126379,11613354000,17.11942588939285,100.0,1.5083519732282298,66.776545063599,95.63243891168545,162.76096042307694,164.42359674948017,-4.367561088314551
2021-06-17,170.158997,174.860001,170.050003,174.462006,174.462006,102730000,6833044572.300835,11716084000,18.958716495598974,96.0,2.0770826070180703,72.18154587627718,97.55079999999994,163.2712108076923,165.16718261988905,-2.449200000000054
2021-06-18,173.999496,175.350006,173.685501,174.345001,174.345001,104954000,6811259037.400068,11611130000,20.7669973771437,100.0,2.489665096659479,71.78378474784161,93.99638769522464,163.91536469230772,165.84702101841577,-6.003612304775365
2021-06-21,173.820999,174.100006,171.699997,172.697998,172.697998,65542000,6800225984.276518,11545588000,21.44727321579871,36.0,2.6531563794650026,66.24959505885437,84.15766303534559,164.4778453076923,166.35450079482945,-15.842336964654406
2021-06-22,172.903,176.188995,172.804504,175.272003,175.272003,66902000,6830875207.250962,11612490000,22.571670594414428,43.99999999999999,2.9563461722104876,70.12593368224734,94.78359228065045,165.0211914230769,167.01505651373097,-5.216407719349546
2021-06-23,175.25,176.050003,174.160004,175.190994,175.190994,56266000,6835995148.026592,11556224000,23.61575387455759,44.0,3.153735221544281,69.85401274530776,94.32276386236882,165.470095,167.62068151271387,-5.677236137631179
2021-06-24,175.382004,176.242996,171.542496,172.453995,172.453995,76640000,6789078489.526432,11479584000,23.353305416388256,52.0,3.0541086565318096,61.21702571424726,78.51186936762578,165.88701796153848,167.97870473399433,-21.48813063237422
2021-06-25,173.199997,173.240997,169.709,170.072998,170.072998,78820000,6726504438.97656,11400764000,22.367486643783984,52.0,2.7513119157780466,54.8620770457136,59.78492160892439,166.21328726923076,168.1338375685133,-40.21507839107561
2021-06-28,170.800003,172.399994,170.675507,172.194504,172.194504,44856000,6760670350.341505,11445620000,21.4520834977943,52.0,2.65196096600485,58.95103061473496,68.14215810019392,166.5906142307692,168.43462767454935,-31.857841899806076
2021-06-29,171.940994,172.801498,171.151505,172.406998,172.406998,41968000,6782569930.657299,11487588000,20.741135554013056,52.0,2.56085121372098,59.34825589674956,68.51998124656497,167.0618831153846,168.72887732828642,-31.480018753435026
2021-06-30,172.052994,173.580002,171.75,172.007996,172.007996,48080000,6748046689.261934,11439508000,20.35288969979653,52.0,2.4284562201797826,58.20921465672704,55.74941526013005,167.43721003846153,168.97177500767262,-44.25058473986995
2021-07-01,171.730499,172.850006,170.470993,171.648499,171.648499,40742000,6747635657.988881,11398766000,19.409890629879214,52.0,2.268375410765117,57.145035193326464,51.47342596674555,167.77167157692307,169.17005085895613,-48.52657403325445
2021-07-02,172.582001,175.585999,171.845993,175.548996,175.548996,63388000,6809769357.239631,11462154000,19.46340030261653,52.0,2.4282562989928067,64.68818217178946,91.55357195669033,168.24440234615383,169.64256531384825,-8.446428043309671
2021-07-06,176.505493,184.274002,176.449997,183.787003,183.787003,134896000,6927872367.689138,11597050000,21.360342343948037,80.0,3.1830096182709724,74.78355195722754,97.00262138838987,169.1013835,170.69030143874838,-2.997378611610127
2021-07-07,185.869003,186.710007,183.945496,184.828995,184.828995,106562000,6889421813.393641,11703612000,23.465303582586813,84.0,3.821188821485805,75.72874664290835,88.93587891587835,170.01197934615382,171.73761207291517,-11.064121084121663
2021-07-08,182.177994,187.999496,181.056,186.570496,186.570496,103612000,6950386262.93779,11807224000,24.31907371821989,88.0,4.416563618061701,77.26272687937673,92.18719929738371,170.99805630769228,172.8363442156622,-7.812800702616281
2021-07-09,186.126007,187.399994,184.669998,185.966995,185.966995,74964000,6946651732.217599,11732260000,25.11186027273632,88.0,4.784551614033603,75.48235009315842,88.88766603158275,171.93142176923078,173.808985014502,-11.112333968417245
2021-07-12,187.199997,187.864502,184.839493,185.927505,185.927505,51432000,6932217065.570326,11680828000,25.93425578587428,88.0,5.0151862933388145,75.359979662978,88.67176155310388,172.95361450000001,174.70665316157593,-11.328238446896126
2021-07-13,185.104996,188.654007,183.565994,183.867996,183.867996,76918000,6864430091.704103,11603910000,26.187439707861337,100.0,4.974438543012809,69.07089553522098,74.73734900177128,173.85965261538462,175.38527114960735,-25.26265099822872
2021-07-14,185.442505,185.882996,183.041504,184.084,184.084,65932000,6846876792.944157,11669842000,26.212838559212056,96.0,4.903055997395455,69.35971220407482,75.8775122120567,174.78978734615384,176.02962143482162,-24.1224877879433
2021-07-15,184.710007,184.770004,181.046005,181.559998,181.559998,63706000,6800756424.980041,11606136000,25.468077882483403,92.0,4.589909330630917,62.06641134671719,62.55473011965634,175.49572938461537,176.43927895816816,-37.44526988034366
2021-07-16,181.665497,182.302994,178.522995,178.681503,178.681503,80874000,6726665059.574388,11525262000,23.918563183124444,88.0,4.062636308742668,54.967622363992085,45.15483516649106,176.05819123076924,176.60536962793347,-54.84516483350894
2021-07-19,176.628998,177.510498,174.957993,177.479507,177.479507,75692000,6800519044.940136,11449570000,22.951037210720834,84.0,3.5073470943431175,52.27872135231484,38.544291941919056,176.4426915769231,176.67012054438285,-61.45570805808094
2021-07-20,178.365997,179.600006,175.899994,178.6595,178.6595,65114000,6832530391.389823,11514684000,21.427939759300944,80.0,3.1264521703053845,54.62533907977066,45.03382662522291,176.877999,176.81748198553967,-54.96617337477709
2021-07-21,178.819,179.322495,177.182007,179.259995,179.259995,46380000,6876201896.878291,11561064000,20.013634982982474,72.0,2.840303871753804,55.816058344823745,48.33633191944968,177.265172,176.9984088754997,-51.66366808055032
2021-07-22,179.361496,182.001007,179.113495,181.901505,181.901505,65308000,6937008944.767269,11626372000,19.232827438075994,72.0,2.7944642205039543,60.70145675154975,59.82569981200625,177.75536473076923,177.36160118101824,-40.17430018799375
2021-07-23,182.0,183.305496,181.102005,182.832001,182.832001,48726000,6964794067.432167,11675098000,18.847937364008605,44.0,2.8009318188637167,62.28348425784814,57.491237961643385,178.21957642307692,177.7668159824243,-42.508762038356615
2021-07-26,183.658493,185.604004,182.362503,184.990997,184.990997,58002000,7000858309.576161,11733100000,19.046878215118547,44.0,2.9463071757681973,65.7306737334543,73.2549192779738,178.6245376153846,178.30194050224475,-26.745080722026195
2021-07-27,184.925003,184.925003,179.307495,181.319504,181.319504,82638000,6977416807.290807,11650462000,18.236179194224437,44.0,2.7337464647872025,56.3060466404476,46.447900827204165,178.89278773076921,178.5254637243007,-53.552099172795835
2021-07-28,181.688995,182.921005,180.050003,181.516006,181.516006,59988000,6978691452.154168,11710450000,17.483387246251336,44.00000000000001,2.5517318625680048,56.66418596019575,47.882639430713255,179.23194188461537,178.7469853743525,-52.117360569286745
2021-07-29,181.387497,181.897507,179.000504,179.996002,179.996002,110400000,6944165021.632695,11600050000,16.44853872474229,44.0,2.258794383763046,53.04245083330601,36.78449072847041,179.41363415384615,178.83950512440046,-63.21550927152959
2021-07-30,167.397507,168.406998,165.348999,166.379501,166.379501,199312000,6879183617.963173,11400738000,17.851406366864104,-52.0,0.9173271125197004,32.81082868645652,4.421804961405772,179.0747305769231,177.91654185592634,-95.57819503859422
2021-08-02,167.654999,167.945999,165.850006,166.574005,166.574005,67078000,6858445853.7578535,11467816000,19.154069177405795,-52.0,-0.12861789044896454,33.202763029110045,5.96574549027161,178.84857711538461,177.07635394067253,-94.03425450972838
2021-08-03,167.035995,169.550003,164.988495,168.311996,168.311996,83146000,6896459704.46775,11550962000,19.885742853875445,-60.0,-0.8079815834819613,36.75300226367058,16.12136280506095,178.78084626923075,176.42714224136344,-83.87863719493905
2021-08-04,168.967499,169.444,167.278,167.735992,167.735992,43678000,6871252779.79185,11507284000,20.565154124882977,-60.0,-1.376987854849915,36.06878613562004,13.32733040935351,178.60936503846153,175.78335333459577,-86.67266959064649
2021-08-05,167.811005,169.449997,167.046005,168.7995,168.7995,48670000,6893583516.607945,11555954000,21.237288345527638,-60.0,-1.722260074812283,38.35084863042224,18.48610674613949,178.47061511538462,175.26603086536647,-81.51389325386052
2021-08-06,168.75,168.75,166.451996,167.246994,167.246994,52752000,6877330786.840721,11503202000,21.97174292517035,-60.0,-2.0969922348988916,36.31307997078352,10.955339497074752,178.28749965384617,174.67202813459858,-89.04466050292525
2021-08-09,167.180496,167.744003,166.425995,167.093506,167.093506,42964000,6877885403.729238,11460238000,22.658817318572392,-60.0,-2.378932517190151,36.10880327776045,10.210812645954995,178.11230761538462,174.11065612462832,-89.789187354045
2021-08-10,167.250504,167.899994,165.75,166.033997,166.033997,48252000,6842380809.762929,11411986000,23.43490847164023,-60.0,-2.6572347951426423,34.65939218357748,5.071434326457808,177.7463461153846,173.51238507835956,-94.9285656735422
2021-08-11,166.572495,166.884995,163.889496,164.605499,164.605499,58944000,6811615140.539871,11353042000,24.522559338358754,-84.0,-2.9589502688074845,32.750605113592044,3.2973484824063286,177.00859596153848,172.85261573922182,-96.70265151759368
2021-08-12,164.5,165.725494,163.483505,165.175003,165.175003,46282000,6835169264.121209,11399324000,25.610679706659482,-88.0,-3.1161862864217653,34.303984011073425,7.646744316210932,176.25267319230773,172.28390368446466,-92.35325568378906
2021-08-13,165.283493,165.303497,164.149994,164.698502,164.698502,41134000,6833154933.635722,11358190000,26.621077191510153,-88.0,-3.241876279864016,33.60456249737892,5.666567699700752,175.41144265384617,171.722022078208,-94.33343230029924
2021-08-16,164.149994,165.0,160.556503,164.949493,164.949493,66394000,6898039599.092231,11424584000,28.225342694135197,-96.0,-3.2833848128473733,34.36369496449157,19.642690903647193,174.6030771923077,171.22035325759998,-80.35730909635281
2021-08-17,163.875,164.024506,161.283997,162.098007,162.098007,67758000,6870533749.024962,11356826000,29.715017803715593,-96.0,-3.5059572211637544,30.146582410895064,7.223202807140674,173.68655803846153,170.54462390518518,-92.77679719285932
2021-08-18,162.099503,162.705002,160.0,160.061005,160.061005,56086000,6816977526.400358,11300740000,31.317511116011044,-100.0,-3.802879270743091,27.545955382326895,0.6387956108494877,172.7709045384615,169.76805954183814,-99.36120438915052
2021-08-19,159.701004,161.649994,159.123001,159.387497,159.387497,75658000,6757157511.205224,11225082000,32.95064078476058,-72.0,-4.045899984564585,26.725047438737704,2.5366447613610115,171.82103903846155,168.99912898318348,-97.46335523863898
2021-08-20,160.193497,160.390503,158.787994,159.997498,159.997498,67168000,6791380473.342723,11292250000,34.523293976515696,-76.0,-4.141532657962472,28.79481098539189,11.238645126574498,170.99171211538462,168.33234150294768,-88.7613548734255
2021-08-23,160.595001,164.044998,160.500504,163.293503,163.293503,65362000,6829026688.69758,11357612000,34.12611732399761,-76.0,-3.906332414522467,38.846290500867525,42.25762269997476,170.39986596153844,167.95909420643304,-57.74237730002524
2021-08-24,164.0,165.774506,163.729004,165.289001,165.289001,51036000,6855835644.988995,11408648000,33.03155339450949,-76.0,-3.5183570851660875,44.000375555278275,60.97359942592416,169.93100034615384,167.76130952447502,-39.02640057407584
2021-08-25,165.4935,166.050003,164.307495,164.959,164.959,33606000,6847359488.903628,11375042000,31.90201079888479,-76.0,-3.2006174386884254,43.34970144264264,61.94541541131379,169.40405803846153,167.55373104118058,-38.05458458868621
2021-08-26,164.949997,166.600006,164.800003,165.800003,165.800003,41976000,6852023411.170424,11417018000,30.619790039885917,-76.0,-2.8481132890128436,45.55922392628271,76.95356672519766,168.88636603846155,167.42382526035237,-23.046433274802347
2021-08-27,166.661499,167.615997,165.6875,167.481506,167.481506,48048000,6893369794.763451,11465066000,29.001570748592194,-76.0,-2.4053407012156356,49.77700124816716,95.40728709394209,168.33175069230768,167.4280979077337,-4.592712906057909
2021-08-30,167.871506,172.25,167.761002,171.078506,171.078506,63844000,6923891051.943784,11528910000,27.942895380807897,-76.0,-1.7440876401070682,57.38319972404438,91.29777538354986,167.87969319230768,167.69849850716082,-8.702224616450144
2021-08-31,171.240005,173.628998,169.779495,173.539505,173.539505,87128000,7006967959.579912,11616038000,27.33792876216058,-72.0,-1.0098172288099647,61.66136308607431,99.39698823610583,167.4392511923077,168.13116565477853,-0.6030117638941711
2021-09-01,174.820007,176.350006,173.761993,173.949997,173.949997,72598000,6944917599.326699,11688636000,27.44268802422822,-68.0,-0.3902804538186899,62.340456502223546,86.33408859987108,167.15580861538461,168.56219019886902,-13.665911400128927
2021-09-02,174.738007,175.598007,172.75,173.156006,173.156006,58474000,6903115464.841074,11630162000,27.131898302637257,-64.0,0.036220933468683825,60.122143261208286,81.81301777951174,166.83427015384615,168.90247285080466,-18.18698222048826
2021-09-03,172.600006,174.133499,171.822006,173.902496,173.902496,51514000,6944333185.733156,11681676000,26.47436192676332,32.0,0.4295107276856527,61.50891858170297,86.06361275689828,166.59990453846154,169.27284493593024,-13.936387243101716
2021-09-07,173.899994,176.404495,173.847,175.464493,175.464493,54758000,6958838806.341603,11736434000,26.447559549468316,43.99999999999999,0.8573527974831734,64.30603160109317,94.66408227150221,166.9493273076923,169.73148553326874,-5.335917728497803
2021-09-08,175.582504,177.281494,174.783493,176.274994,176.274994,61068000,6970695503.383758,11797502000,26.63258024444298,48.0,1.247441646498487,65.69891820602393,94.5575472463297,167.32244226923078,170.21618986413773,-5.442452753670296
2021-09-09,176.300995,177.499496,174.018494,174.207993,174.207993,54384000,6922232622.427067,11743118000,26.472478001809208,52.0,1.373961985225634,59.33924554742688,82.40919943252013,167.54921138461538,170.5118789853127,-17.590800567479867
2021-09-10,175.091507,175.422501,173.145493,173.457504,173.457504,47946000,6887426391.286904,11695172000,25.947263208109415,52.0,1.3975618519181126,57.175170391682435,76.22216658493635,167.76926953846154,170.7300734308451,-23.77783341506365
2021-09-13,174.139999,174.897995,171.899994,172.858505,172.858505,51380000,6868900479.847916,11643792000,24.93941035114124,52.0,1.3523417491624627,55.43737195340756,66.29756583860629,167.9253851153846,170.88773502856026,-33.70243416139372
2021-09-14,173.777496,174.3405,171.885498,172.5,172.5,38738000,6849555196.005377,11605054000,23.997430634545054,52.0,1.2729029022836755,54.37219297308116,62.10206472846696,168.1274238076923,171.0071620634817,-37.89793527153304
2021-09-15,172.126007,174.270996,170.100494,173.789505,173.789505,59150000,6895047275.376158,11664204000,22.386972704597273,52.0,1.2990249692329314,57.53290550872347,70.78630619348343,168.38496223076922,171.21326154026085,-29.21369380651657
2021-09-16,172.998001,174.627502,172.307007,174.412003,174.412003,51672000,6937121957.279803,11715876000,21.028390339033443,52.0,1.3543452328628973,59.00909635701321,73.86137787381577,168.70719323076926,171.45020535209338,-26.138622126184234
2021-09-17,174.420502,174.870499,172.606506,173.126007,173.126007,92332000,6887163380.105757,11623544000,19.863959030700595,52.0,1.2796666105460588,54.773208240833064,55.090704989909064,169.03490507692308,171.5743388074939,-44.909295010090936
2021-09-20,169.800003,170.949997,165.250504,167.786499,167.786499,93382000,6876882205.070363,11530162000,20.459649456161888,52.0,0.7806309650209755,41.46421345116208,20.703703619040557,169.1353472307692,171.29375808101284,-79.29629638095945
2021-09-21,168.75,168.985001,166.619507,167.181503,167.181503,55618000,6847691744.9652,11474544000,21.012790565518802,52.0,0.332490753113575,40.27023314244815,15.764554340471344,169.23084726923074,170.98914659353042,-84.23544565952865
2021-09-22,167.550003,169.449997,167.052505,169.002502,169.002502,48228000,6877916107.113646,11522772000,21.32008005126712,52.0,0.12285955856373221,45.3694254214098,30.631075601975983,169.38673223076924,170.8419877347504,-69.36892439802402
2021-09-23,169.002502,171.447998,169.002502,170.800003,170.800003,47588000,6900284858.290503,11570360000,20.76024637453556,52.0,0.10060887840575106,49.91474645209936,45.30576066993923,169.7214243846154,170.8388777543985,-54.69423933006077
2021-09-24,170.100494,171.462997,169.669998,171.276001,171.276001,42324000,6933780723.18948,11612684000,20.234217920611922,52.00000000000001,0.12000081983859445,51.075593576856676,49.191778392867,170.1527703846154,170.8712572540727,-50.808221607133
2021-09-27,168.574997,170.778503,166.980499,170.289993,170.289993,72690000,6987771537.038017,11539994000,20.539947038130148,52.0,0.05517049680349828,48.56460350923448,41.142071118995005,170.57209715384613,170.8282006426599,-58.857928881004995
2021-09-28,167.885498,168.459503,164.505005,165.798004,165.798004,88616000,6957104940.165291,11451378000,21.43253124657173,48.0,-0.3545865197830267,39.12718691944838,9.950362811440495,170.79519353846155,170.45559348394437,-90.04963718855952
2021-09-29,166.105499,167.565002,164.893494,165.056,165.056,51246000,6912093458.2547,11400132000,22.261359440124632,44.0,-0.7307715496467324,37.81979820474442,5.04689903252541,170.86298188461538,170.0556235962448,-94.95310096747458
2021-09-30,165.800003,166.392502,163.699493,164.251999,164.251999,56848000,6878571678.915679,11343284000,23.315099467056463,-60.0,-1.0813123616522375,36.400516266931355,4.9337491746665885,170.82309719230767,169.62572547800443,-95.0662508253334
2021-10-01,164.4505,165.458496,162.796997,164.162994,164.162994,56712000,6880073807.017174,11286572000,24.50107152224774,-64.0,-1.3507300649425247,36.23838722032485,11.314008147760228,170.79248157692308,169.22107870185593,-88.68599185223977
2021-10-04,163.969498,163.999496,158.8125,159.488998,159.488998,90462000,6813208263.261212,11196110000,26.374152848337253,-68.0,-1.9192737576635182,28.946928932051904,4.21284121390224,170.5497506153846,168.50018383505179,-95.78715878609775
2021-10-05,160.225006,163.036499,160.123001,161.050003,161.050003,65384000,6789431361.510809,11261494000,28.11344265113466,-68.0,-2.218317291759263,33.74189137732418,13.933884290315403,170.30238511538462,167.9483185880109,-86.0661157096846
2021-10-06,160.676498,163.216995,159.931,163.100494,163.100494,50660000,6836499182.788687,11312154000,29.763521596076544,-68.0,-2.263758758167512,39.51595349285231,26.703165195115524,169.9955385,167.58922047038044,-73.29683480488447
2021-10-07,164.576996,166.287506,164.153,165.121506,165.121506,48182000,6832041169.59594,11360336000,29.715500449583423,-68.0,-2.1123428955737893,44.63698943140735,49.871605834932886,169.6717693076923,167.4064268059078,-50.128394165067114
2021-10-08,165.850006,166.071503,164.410004,164.431,164.431,39964000,6793087202.276069,11320372000,29.670909384982668,-68.0,-2.0247230500023647,43.288424046349355,44.41327483023008,169.30565403846154,167.186024820285,-55.58672516976992
2021-10-11,163.75,164.629501,161.904999,162.315002,162.315002,40684000,6764648054.40097,11279688000,30.245375363500823,-68.0,-2.101798817147227,39.363729755730354,27.686675076876366,168.88869234615385,166.8252083150787,-72.31332492312363
2021-10-12,162.850006,163.376495,161.813995,162.366501,162.366501,36392000,6753992756.291531,11316080000,30.799873000208283,-68.0,-2.134125508589534,39.507478471215244,28.093765802244757,168.44500023076924,166.49493369914694,-71.90623419775524
2021-10-13,163.485504,164.419006,163.054504,164.214005,164.214005,48402000,6787851049.646908,11364482000,30.77073535828851,-68.0,-1.9877529334108317,44.58305465239918,42.697966728105506,168.01228915384615,166.32597601772864,-57.302033271894494
2021-10-14,165.122498,165.630005,164.539001,164.992996,164.992996,42190000,6780773751.433518,11406672000,30.14219874805457,-68.0,-1.7882793781180055,46.616905696511104,51.65046340035185,167.57836615384616,166.22723675715613,-48.34953659964815
2021-10-15,165.570999,170.520996,165.199997,170.451004,170.451004,103598000,6881646311.63697,11510270000,28.33034153237355,-64.0,-1.1762207763573258,58.19404208490913,99.4022118639321,167.4338665769231,166.5401084047742,-0.5977881360679029
2021-10-18,169.417999,172.458496,169.255005,172.337006,172.337006,63482000,6940313296.904604,11573752000,27.22978079848586,-60.0,-0.5328331564438997,61.31596275501216,99.10970221594675,167.3907705,166.9695082266428,-0.8902977840532443
2021-10-19,171.714493,172.734497,171.100006,172.207504,172.207504,47722000,6957262218.37924,11526030000,26.288403425138466,-44.00000000000001,-0.033013008005212896,60.97923056542138,96.21467380003023,167.365732,167.35750791355815,-3.7853261999697625
2021-10-20,172.632996,173.143005,170.018494,170.753006,170.753006,42796000,6934587239.269869,11483234000,24.99202139432298,-44.0,0.24293186052085503,57.18097670428322,83.32229743473806,167.29853992307693,167.60902629033163,-16.677702565261942
2021-10-21,170.712494,172.014008,170.149994,171.750504,171.750504,37628000,6961576769.266962,11520862000,23.78823807999431,-44.0,0.5359320183630132,59.0641465259257,90.28295932348523,167.2201168076923,167.91580241697372,-9.717040676514769
2021-10-22,171.050003,171.492004,166.565002,166.777496,166.777496,62782000,6904210150.9972725,11458080000,22.791120874077016,-44.0,0.362675868314966,47.781640100804324,51.82026497870697,166.92648192307692,167.8314834231238,-48.17973502129303
2021-10-25,166.75,167.389999,164.884995,166.018494,166.018494,44520000,6899980206.805567,11413560000,22.36352178195943,48.0,0.16225364399451792,46.32710156378946,46.07547454001117,166.65311603846155,167.69718791029985,-53.92452545998883
2021-10-26,167.475494,170.806,167.199005,168.803497,168.803497,53966000,6894025371.374412,11467526000,20.774447486804302,48.0,0.22554412187457729,52.09019917105067,61.6956115318108,166.69223134615385,167.7791367317591,-38.3043884681892
2021-10-27,169.399994,171.850006,168.572495,169.624496,169.624496,54044000,6874674980.057342,11521570000,19.623575090928057,48.0,0.33805317295579584,53.66951650870747,68.942484824358,166.78619261538464,167.91583001088807,-31.057515175642003
2021-10-28,170.104996,173.949997,169.300003,172.328506,172.328506,114174000,6909222161.857576,11635744000,19.166010715253176,72.0,0.6380533335128291,58.51949108755971,86.63900187228056,166.91411584615386,168.24269489897046,-13.360998127719434
2021-10-29,165.001007,168.740997,163.666,168.621506,168.621506,129722000,7032835542.876325,11506022000,18.517939664181757,72.0,0.5701098315730349,50.68593326749399,56.09352239724425,166.83032749999998,168.2707549805282,-43.90647760275575
2021-11-01,168.089996,168.792999,164.600998,165.905502,165.905502,72178000,7005579521.526616,11433844000,17.900098410002595,72.0,0.29371947727182146,45.843851567729246,26.16676455117733,166.62376984615386,168.09555105604463,-73.83323544882268
2021-11-02,165.750504,166.556,164.177505,165.637497,165.637497,52552000,7017543528.147609,11381292000,17.439678613133882,72.0,0.052447781140955385,45.383132371379425,19.17053262462056,166.44482769230768,167.9134729778191,-80.82946737537944
2021-11-03,165.449997,169.746002,164.876007,169.199997,169.199997,67944000,7070252291.265435,11449236000,16.370291339443323,72.0,0.14700758866075603,52.25230293263845,53.81173292835461,166.57567357692307,168.00877105353624,-46.18826707164539
2021-11-04,168.5,174.931503,168.25,173.850006,173.850006,107060000,7142653901.133754,11556296000,16.627356651153207,92.0,0.5903584966758615,59.42552146481799,90.39992266656904,166.9139045769231,168.44145512364466,-9.600077333430962
2021-11-05,173.850006,178.3125,173.848999,175.949493,175.949493,99940000,7136776104.932968,11656236000,17.505716731729684,96.0,1.0984659089762943,62.18762330674504,83.86640494316042,167.36380819230772,168.99760607744875,-16.133595056839585
2021-11-08,176.162003,178.949997,174.393005,174.449005,174.449005,61480000,7076807136.771515,11594756000,18.434126904560106,100.0,1.364340583468362,59.09151675671209,70.55094946694902,167.759424,169.40141340504516,-29.449050533050986
2021-11-09,175.762497,179.688507,175.071503,178.811493,178.811493,85898000,7130071962.283471,11680654000,19.43009818677574,96.0,1.9051036522758977,64.6084521490514,94.52636219787593,168.5025968846154,170.09845633800478,-5.473637802124067
2021-11-10,178.193497,180.272507,173.154495,174.102493,174.102493,80548000,7070979206.50166,11600106000,19.692039942802854,100.0,1.931421114706012,55.85244968714337,62.845804960670044,169.00461573076925,170.39505164630071,-37.15419503932996
2021-11-11,175.649994,177.162003,173.373505,173.625,173.625,45288000,7031703988.115905,11554818000,19.935271573399458,84.0,1.8919391024822403,55.03792991434111,59.97046820261484,169.40940442307692,170.63430707990807,-40.02953179738516
2021-11-12,174.25,177.036499,172.352493,176.257507,176.257507,53788000,7067601139.258752,11608606000,19.79617435116624,84.0,2.049445900854124,58.62078210657931,75.82273021051333,169.83771215384616,171.0508404073223,-24.17726978948666
2021-11-15,176.850006,179.694,176.290497,177.283997,177.283997,58594000,7043214918.126583,11667200000,20.277529852784795,84.0,2.2313783964349057,59.96058284343026,82.00398193310615,170.33205819230767,171.5125557104836,-17.99601806689385
2021-11-16,176.949997,178.824997,176.257507,177.035004,177.035004,44342000,7025728541.302525,11622858000,20.71192746784707,84.0,2.3286265978564984,59.45768126194245,80.50461183679383,170.89821211538464,171.92162595415147,-19.495388163206176
2021-11-17,178.235992,179.362503,177.267502,177.449997,177.449997,51206000,6983443624.3664465,11674064000,21.24065079640417,80.0,2.411386008111492,60.05895862843728,83.00359009874867,171.4783465769231,172.33113492051064,-16.99640990125133
2021-11-18,178.317505,185.210007,178.050003,184.802994,184.802994,114070000,7084544924.094771,11788134000,22.8523253992634,56.0,3.0353096827202535,68.86883709980637,98.06483793511596,172.27023076923075,173.25497633380616,-1.9351620648840446
2021-11-19,185.634506,188.107498,183.785995,183.828506,183.828506,98734000,6987753433.945626,11689400000,24.767621575232532,60.0,3.4118114143058165,66.76695245610482,82.11870768202904,172.99467346153844,174.03820075352422,-17.88129231797096
2021-11-22,183.819,185.673004,178.375,178.628494,178.628494,96844000,6897637129.0622635,11592556000,24.69219039261634,60.0,3.2530945896015737,56.80420449710326,59.19760810875203,173.30919230769229,174.3782224754854,-40.802391891247964
2021-11-23,179.251999,181.052505,176.385498,179.001999,179.001999,73804000,6906587768.086375,11666360000,24.054358661734135,60.0,3.1214667686554662,57.29709647829894,54.14578916236082,173.56553819230768,174.72072444026426,-45.85421083763918
2021-11-24,178.133499,180.682007,176.842499,179.020493,179.020493,46560000,6912850890.548941,11712920000,23.46208634020066,60.0,2.984242592487931,57.32306352920557,42.323058608994316,173.82757623076924,175.03922581505952,-57.676941391005684
2021-11-26,180.104996,181.675003,175.207504,175.227997,175.227997,59826000,6853404021.405551,11653094000,22.434950995462305,60.0,2.5401870175135173,50.53650788795387,18.251368374684624,173.99969126923077,175.05320886579585,-81.74863162531538
2021-11-29,177.382004,179.800003,176.574997,178.078506,178.078506,65312000,6848989383.958055,11718406000,21.481182461062406,60.0,2.390723259143101,54.86207978275289,36.3440887514793,174.24307596153847,175.277304949811,-63.6559112485207
2021-11-30,178.175003,179.288498,174.600494,175.3535,175.3535,80022000,6794674292.967518,11638384000,20.012883361776414,60.0,2.0289979184352944,50.33078616554954,19.04795968011429,174.57292226923076,175.2829490276028,-80.95204031988571
2021-12-01,177.25,177.994003,172.080002,172.186005,172.186005,74916000,6722443893.036912,11563468000,19.189325833945258,60.0,1.4697947265025846,45.61463910800726,0.6613821647497966,174.81013423076922,175.0535457662989,-99.3386178352502
2021-12-02,173.0,174.634995,171.1875,171.867996,171.867996,64726000,6683270234.140235,11498742000,18.64898916497586,60.0,0.989554530811688,45.1571421297514,4.021844447026562,174.92799957692307,174.81757911694342,-95.97815555297345
2021-12-03,172.75,173.4935,166.929993,169.489502,169.489502,80712000,6665507230.890904,11418030000,19.093569346080393,60.0,0.4122835794206594,41.78179521878641,12.085979911231242,174.92280749999998,174.42290673791058,-87.91402008876875
2021-12-06,169.649994,173.695496,166.934494,171.3685,171.3685,68860000,6686966876.754047,11486890000,19.438593053215634,60.0,0.10519895847988892,45.26264073384851,20.9585926198578,174.88588419230766,174.19665438695424,-79.0414073801422
2021-12-07,174.600006,177.499496,173.334503,176.164505,176.164505,66410000,6710804535.187086,11553300000,18.57664836273915,52.00000000000001,0.24599403941255105,52.988824646638925,43.60528778059548,175.17599953846155,174.3424210990317,-56.39471221940452
2021-12-08,176.150497,177.179993,174.750504,176.158005,176.158005,45254000,6717985471.302459,11508046000,17.776271150153843,52.0,0.35298170636082205,52.97791038306983,43.57459483541621,175.5703265769231,174.4769087953997,-56.42540516458379
2021-12-09,175.75,176.969498,174.139496,174.171005,174.171005,46062000,6672949172.031999,11461984000,17.193694425775735,48.0,0.27427424648996634,49.61371585715599,34.19199759367316,175.8985384230769,174.45424925499972,-65.80800240632684
2021-12-10,175.417007,175.927002,170.5,172.212006,172.212006,60690000,6650549795.156884,11401294000,17.52264141822618,-36.0,0.05320980076217552,46.479906643246466,28.18124046344532,176.01438492307696,174.28815716203678,-71.81875953655468
2021-12-13,172.0,172.100006,169.130005,169.567505,169.567505,62170000,6606695866.430934,11339124000,18.11741341093571,-36.0,-0.3315525632782226,42.57080580503714,17.88748871652182,175.84967334615385,173.9384792241081,-82.11251128347817
2021-12-14,167.550003,169.498993,166.440002,169.091507,169.091507,55976000,6647758820.700496,11283148000,19.192535143029893,-64.0,-0.6671975315346401,41.88792245634906,17.40403561509456,175.58590465384617,173.57944424454456,-82.59596438490543
2021-12-15,168.598007,173.600006,165.195007,173.315002,173.315002,75794000,6718412643.24753,11358942000,18.86425132641003,-68.0,-0.5856468652792728,49.61148629201696,49.27182627956942,175.54228915384616,173.55985593013384,-50.72817372043058
2021-12-16,173.3685,174.166,168.160507,168.871002,168.871002,60876000,6671940820.763015,11298066000,18.393187383754682,-68.0,-0.869586977298269,43.11775611297245,25.16943517136191,175.15996257692308,173.2125334167906,-74.83056482863807
2021-12-17,167.710495,170.898499,165.613495,170.017502,170.017502,85542000,6728963544.19331,11383608000,18.51723668619702,-68.0,-0.9906786664607523,45.11375463838023,34.21788824358708,175.00284753846154,172.97586442295426,-65.78211175641292
2021-12-20,166.850006,167.874496,165.600006,167.078995,167.078995,57372000,6746203924.909865,11326236000,18.635339179132057,-68.0,-1.308672101941795,41.13010890638075,14.719810835162303,174.75107811538462,172.53905928051321,-85.2801891648377
2021-12-21,167.850494,170.716507,165.647507,170.417007,170.417007,55956000,6795547645.564827,11382192000,17.853566542338406,-68.0,-1.276618456213896,46.86944832161743,42.43979575259089,174.52644350000003,172.38187022269742,-57.56020424740911
2021-12-22,169.270004,172.050003,168.500504,171.037003,171.037003,55036000,6819169934.503069,11437228000,16.744096607470134,-68.0,-1.1874984721682438,47.885722922360614,47.478574689286155,174.28617450000002,172.28225042842354,-52.521425310713845
2021-12-23,170.427994,171.975006,170.149994,171.068497,171.068497,36788000,6819411705.665122,11474016000,15.71387452509245,-68.0,-1.1016300348428274,47.940197375904795,47.73453005646971,174.05669346153843,172.19234276705885,-52.26546994353029
2021-12-27,171.037003,172.942993,169.2155,169.669495,169.669495,58688000,6775019672.718582,11415328000,14.720102166980569,-68.0,-1.133401304347501,45.657123789867875,36.364679589701055,173.75744338461539,172.00546515468412,-63.635320410298945
2021-12-28,170.182495,172.175995,169.135498,170.660995,170.660995,54638000,6775208304.736966,11469966000,13.771333840643901,-68.0,-1.0662830533400722,47.56309445925291,45.60696191051048,173.21352034615387,171.90587477285567,-54.39303808948952
2021-12-29,170.839996,171.212006,168.600494,169.201004,169.201004,35754000,6755897372.614885,11434212000,12.866755014448868,-64.0,-1.1180126737378089,45.057106202264194,34.02267664903743,172.65092411538464,171.70551397486636,-65.97732335096258
2021-12-30,169.699997,170.888,168.524002,168.644501,168.644501,37584000,6722144877.054399,11396628000,12.053967337461742,-52.0,-1.1901940951464098,44.103252944748576,32.14215064393892,172.26692438461538,171.47877227302442,-67.85784935606108
2021-12-31,168.955994,169.350006,166.558502,166.716995,166.716995,47830000,6679746157.246008,11348798000,11.976333453361548,-52.00000000000001,-1.3869441877583029,40.87554149635143,16.965658093814078,171.79442423076924,171.12604803057815,-83.03434190618592
2022-01-03,167.550003,170.703506,166.160507,170.404495,170.404495,63520000,6734904641.551199,11412318000,11.376299090089727,-52.0,-1.231127944787488,48.622295260719454,58.07036077277061,171.4630396923077,171.07259965794273,-41.92963922722939
2022-01-04,170.438004,171.399994,166.349503,167.522003,167.522003,70726000,6697017521.968965,11341592000,10.571649553790985,-48.0,-1.3249621254252872,43.792055674766196,25.93911287189735,171.1666553076923,170.80959249809513,-74.06088712810265
2022-01-05,166.882996,167.126495,164.356995,164.356995,164.356995,64302000,6632715521.968965,11277290000,10.515317468987481,-100.0,-1.6358589207919465,39.188596354654976,0.0,170.63890488461539,170.33162231305104,-100.0
2022-01-06,163.4505,164.800003,161.936996,163.253998,163.253998,51958000,6628559563.609798,11225332000,11.20067646752646,-100.0,-1.9487851288907052,37.70119459334688,11.96622168804881,170.17353942307693,169.80735384541762,-88.0337783119512
2022-01-07,163.839005,165.2435,162.031006,162.554001,162.554001,46606000,6597128505.552103,11178726000,11.647537154610982,-84.0,-2.2275870739379684,36.747941698796815,5.606080030732387,169.80307773076927,169.27006844946075,-94.39391996926763
2022-01-10,160.585495,161.661499,156.304504,161.485992,161.485992,87798000,6679173592.36626,11090928000,13.448112158096965,-92.0,-2.505833337733577,35.2821525193155,31.141577819957114,169.40376988461543,168.69347019394516,-68.8584221800429
2022-01-11,161.5,166.350006,160.701508,165.362,165.362,62806000,6720008192.239713,11153734000,13.442145177914318,-92.0,-2.3860788226134844,44.01063023241808,54.43701047613152,169.24501980769233,168.44669462402328,-45.56298952386848
2022-01-12,166.574997,166.878006,164.417007,165.207001,165.207001,50030000,6702097993.848733,11103704000,13.271474945516502,-92.0,-2.277426871193313,43.756482778393575,53.50544150974278,169.0080390769231,168.2067173185401,-46.49455849025722
2022-01-13,165.250504,166.221497,161.091003,161.214005,161.214005,52188000,6652412376.027135,11051516000,13.885108841852594,-88.0,-2.484876711292145,37.71435959010994,29.506892122235257,168.43301984615385,167.68873862827786,-70.49310787776474
2022-01-14,160.149994,162.25,159.800507,162.138,162.138,45974000,6694182168.870797,11097490000,14.7246332838412,-84.0,-2.545381951126899,39.786395257412586,36.75455569990242,167.8937888846154,167.27757280396096,-63.24544430009758
2022-01-18,159.104996,159.734497,157.664505,158.917496,158.917496,67292000,6708355479.241078,11030198000,15.925448500078442,-80.0,-2.820685441582924,35.369861474054204,17.30975278046618,167.30711546153847,166.65830785551944,-82.69024721953382
2022-01-19,158.761993,159.25,156.25,156.298996,156.298996,53242000,6656852575.929078,10976956000,17.302281518174972,-88.0,-3.213117686907907,32.23651468576848,0.3234060686755935,166.6950766153846,165.89095142177726,-99.6765939313244
2022-01-20,156.766006,158.0,151.350998,151.667496,151.667496,71974000,6591730619.905602,10904982000,19.35111574853584,-92.0,-3.853426509462736,27.58218130903039,1.57862269013369,166.00661473076923,164.83736213127526,-98.4213773098663
2022-01-21,149.949997,150.899994,142.070496,142.643005,142.643005,163972000,6449022670.420818,10741010000,22.231555388397556,-96.0,-5.0310816894192385,21.168751090080875,1.9519904500240564,164.98936465384617,163.19333567710675,-98.04800954997594
2022-01-24,139.0,144.945007,135.352005,144.544006,144.544006,155624000,6591636065.476923,10896634000,25.38150511042395,-100.0,-5.744764936514258,25.118596108806486,25.499344776209306,163.88278788461537,161.81190384917292,-74.5006552237907
2022-01-25,142.242493,143.600006,138.145004,139.985992,139.985992,90824000,6562115762.198574,10805810000,28.306458423734174,-76.0,-6.602053327411909,22.241093200866928,14.583985454998702,162.77182596153847,160.19516963812308,-85.41601454500129
2022-01-26,144.75,145.184998,137.318497,138.872498,138.872498,95602000,6504285473.815213,10710208000,30.50927361024023,-76.0,-7.287306678372602,21.590397472372757,11.166950733776908,161.5739411923077,158.6157124797436,-88.83304926622309
2022-01-27,140.800003,144.2435,139.350006,139.637497,139.637497,77516000,6435877547.6602,10787724000,32.55474485485299,-76.0,-7.680114293189405,23.251698255438427,13.593516031418016,160.51849896153846,157.20991874050333,-86.40648396858198
2022-01-28,140.860504,143.998001,137.929504,143.977997,143.977997,74392000,6509779100.826989,10862116000,34.57950320931893,-76.0,-7.554096164704703,32.04880196664293,27.361516609734277,159.50161396153845,156.22977638935492,-72.63848339026572
2022-01-31,144.75,150.360504,144.300507,149.573502,149.573502,78308000,6567747634.449036,10940424000,34.4864808639308,-76.0,-6.922912375553409,41.3774712501429,45.11037413213302,158.67609469230771,155.7367190271805,-54.88962586786698
2022-02-01,150.0,151.707993,147.627502,151.193497,151.193497,59220000,6612033915.384345,10999644000,34.04138098076758,-76.0,-6.220271203135098,43.7837371647429,50.248973854945994,157.9116716153846,155.40018406220418,-49.751026145054006
2022-02-02,155.050507,155.074997,148.863495,150.612503,150.612503,87330000,6573883926.47989,10912314000,32.78467083090517,-72.0,-5.645229678270169,43.10044958287617,49.43553330906776,157.17871038461539,155.0455410205594,-50.564466690932235
2022-02-03,141.737503,144.247498,138.332993,138.845505,138.845505,225532000,6387438158.170962,10686782000,33.03030065291354,-52.0,-6.069043370432752,32.1552947362601,12.9879569090559,155.9550376923077,153.8455383523698,-87.0120430909441
2022-02-04,155.606506,161.199997,150.608002,157.639496,157.639496,253456000,6470495599.361976,10940238000,30.91465260102066,-52.0,-4.832692498247525,52.780540748235445,86.2252317317338,155.5103643076923,154.12657225219425,-13.774768268266206
2022-02-07,158.520004,162.690994,157.25,157.935501,157.935501,102624000,6393730423.916459,11042862000,29.135152904470036,-52.0,-3.785355176754848,53.02277483351147,82.60545406415723,155.0984796923077,154.40871512240207,-17.394545935842768
2022-02-08,156.750504,161.792496,155.550507,161.413498,161.413498,76040000,6460536505.715065,11118902000,27.24144224860442,-52.00000000000001,-2.644206743371626,55.8863096883129,95.32720101683357,154.89449903846153,154.92758792815005,-4.672798983166441
2022-02-09,162.873505,163.834503,160.25,161.189499,161.189499,68786000,6427808156.225611,11050116000,25.758485483069737,-52.0,-1.7378800363805453,55.6510270632912,90.71358137197096,154.5400761153846,155.3914331927315,-9.286418628029038
2022-02-10,158.350006,160.716507,157.75,159.003494,159.003494,68268000,6417233280.423193,10981848000,24.003988645227178,-48.0,-1.1823722740783467,53.29302307547327,83.03867518923369,154.21244115384616,155.65899325252917,-16.961324810766314
2022-02-11,158.134506,159.0,152.733994,153.293503,153.293503,77100000,6353902224.755515,10904748000,22.90407942403207,-28.0,-1.1891689244219208,47.61748827403762,60.24665253130497,153.78692223076922,155.48377175234182,-39.75334746869504
2022-02-14,151.751007,158.448502,151.649994,155.167007,155.167007,83230000,6356785528.436264,10987978000,22.026637689621968,-28.0,-1.031488842219062,49.51718334932824,67.31221134887359,153.47588411538462,155.4603076966128,-32.68778865112641
2022-02-15,157.605499,158.007004,154.637497,156.510498,156.510498,56440000,6363091904.354166,11044418000,21.21187036481259,-28.0,-0.7890223864507675,50.89252317344754,71.72744534751769,153.2434416923077,155.5380995709378,-28.27255465248232
2022-02-16,155.790497,158.834,154.734497,158.100494,158.100494,52704000,6396935715.582991,11097122000,20.304141306310534,-28.0,-0.46322679419415635,52.540442982978085,77.8652413767705,153.11323023076923,155.72790656568316,-22.13475862322949
2022-02-17,158.145996,160.348999,154.5,154.652496,154.652496,64032000,6336242619.854303,11033090000,19.179378909709772,-28.000000000000004,-0.47774887098231034,48.72213935206092,63.99426151627888,152.7013262307692,155.6482465237807,-36.00573848372112
2022-02-18,155.499496,155.499496,150.893005,152.601501,152.601501,63604000,6319818644.555969,10969486000,18.71645204984858,-24.0,-0.6472942716455918,46.554816408937484,55.95162011974981,152.2164993076923,155.4225616701673,-44.04837988025018
2022-02-22,150.4785,152.982498,148.485504,150.197495,150.197495,66128000,6304040073.907221,10903358000,18.64682935257551,48.0,-0.9645249727733187,44.07972207781818,46.524703831263345,151.79278738461537,155.03551969459937,-53.47529616873666
2022-02-23,151.650497,151.763,144.651001,144.826996,144.826996,64244000,6242975664.562394,10839114000,19.11189378410729,48.0,-1.6304916819443065,39.08102459398377,25.465170493825717,151.12697953846154,154.27933275425866,-74.53482950617429
2022-02-24,139.837494,151.748993,139.5,151.358002,151.358002,100786000,6337327434.593286,10939900000,20.16052575548263,48.0,-1.6126874377683862,46.95845063529229,48.729172730587486,150.83622976923078,154.06293788357283,-51.270827269412514
2022-02-25,150.550003,153.990005,149.213501,153.788498,153.788498,62396000,6394458818.140751,11002296000,20.64414552517176,48.00000000000001,-1.3864743183966937,49.57184147649386,58.71703235525294,150.73967215384616,154.04260900330817,-41.28296764474706
2022-02-28,152.425003,154.449997,150.850006,153.563004,153.563004,57684000,6423717578.070984,10944612000,20.991590441154376,48.0,-1.2114296656878878,49.32900424365643,57.79038922635896,150.8125763076923,154.00708270676682,-42.20961077364103
2022-03-01,152.732498,154.098999,149.977005,151.141998,151.141998,44874000,6404208921.097684,10899738000,21.433390080575634,48.0,-1.2536096367486493,46.68476377626767,47.841527727112386,151.13946065384616,153.7948542099693,-52.15847227288761
2022-03-02,150.848999,152.999496,148.75,152.052505,152.052505,47334000,6430446361.885015,10947072000,22.014191647290517,40.0,-1.1997374358788875,47.8176705346876,59.16386236433732,151.4282490769231,153.6657913055271,-40.83613763566268
2022-03-03,153.531494,153.929001,146.856003,147.898499,147.898499,65198000,6384467554.14493,10881874000,22.813561710923032,40.0,-1.475231347609082,43.29731768898888,40.28250469003327,151.73257626923078,153.23858446808066,-59.717495309966736
2022-03-04,147.158997,147.850006,143.807007,145.641006,145.641006,60934000,6378815732.085612,10820940000,23.948212496985317,32.0,-1.8543473143765254,41.027440695163804,29.454680294243417,151.99290349999998,152.67580087785245,-70.54531970575658
2022-03-07,145.443497,146.094498,137.416504,137.453003,137.453003,86934000,6292613008.015511,10734006000,25.68737813203655,-68.0,-2.7834173588310307,34.05401846031263,0.1591584343526166,151.9088845,151.54818622023373,-99.84084156564738
2022-03-08,136.683502,140.699493,133.572495,136.014496,136.014496,91662000,6263765308.13514,10642344000,27.642393523686263,-72.0,-3.5943540790295003,32.993025864626986,9.119939630655315,151.602596,150.39754250021642,-90.88006036934469
2022-03-09,139.5,140.25,136.828003,139.279007,139.279007,82656000,6299513962.858099,10725000000,29.457764958789568,-72.0,-3.9283252292815405,37.7341847015675,21.311639488112437,151.20665388461538,149.57394727797816,-78.68836051188757
2022-03-10,145.684998,148.6745,143.977997,146.817505,146.817505,135062000,6327769064.751147,10860062000,29.06995529182772,-72.0,-3.5438546349857916,47.0511121193657,60.405023012495015,151.0383465,149.36976636849832,-39.59497698750498
2022-03-11,149.574493,149.675003,145.369003,145.524506,145.524506,68900000,6263845449.655931,10791162000,28.500037938137716,-72.0,-3.3053906464636498,45.785646267923994,57.248280948554104,150.8426543076923,149.0849322671281,-42.75171905144589
2022-03-14,145.981003,147.449997,140.884003,141.852997,141.852997,74086000,6211626326.014332,10717076000,28.5491148678177,-72.0,-3.3737755255820048,42.30615919027102,39.66232167047565,150.95832707692307,148.54923335845191,-60.337678329524344
2022-03-15,142.850006,147.985001,142.0,147.366501,147.366501,75584000,6271588372.400623,10792660000,28.47464562791721,-72.0,-2.9490821570783794,48.62070088297112,66.07115161574407,150.56321188461538,148.46162355412216,-33.92884838425593
2022-03-16,148.5,153.149994,147.3535,153.104004,153.104004,84958000,6355198240.781752,10877618000,27.320450243369283,-72.0,-2.1250448665746546,54.23419652186946,93.55290206654037,150.37738507692308,148.80550358715016,-6.447097933459632
2022-03-17,152.640503,157.498505,152.139999,157.238998,157.238998,72934000,6421068001.78006,10950552000,25.466592267740488,-72.0,-1.125357498042348,57.81165304442109,98.91537703110555,150.21682738461539,149.43020687699087,-1.084622968894459
2022-03-18,156.813004,161.593994,156.011002,161.250504,161.250504,102962000,6511360659.828648,11053514000,24.20145294222218,32.0,-0.00929589024022448,60.996944318122765,98.77419120226222,150.21917373076923,150.3057844416582,-1.2258087977377752
2022-03-21,161.121002,163.084,159.552994,161.491501,161.491501,66538000,6517880807.430776,11120052000,23.251062825075387,36.0,0.8844421203197328,61.18653975410082,94.60380282198416,150.3148663076923,151.1343560385724,-5.39619717801584
2022-03-22,161.805496,166.167007,161.699005,164.889008,164.889008,64086000,6545305300.155711,11184138000,22.817455227757765,40.0,1.845611295313205,63.854142666430626,96.07909761005159,150.7608472692308,152.1532191468263,-3.9209023899484126
2022-03-23,163.705002,166.369995,162.686996,163.408005,163.408005,55812000,6511345575.60189,11128326000,22.444256788083873,43.99999999999999,2.459488770931273,61.85834113524571,90.9688543334096,151.07780873076925,152.98690698780214,-9.031145666590403
2022-03-24,163.749496,164.1185,160.050003,163.649506,163.649506,56798000,6555048852.3112,11185124000,21.551027727157145,44.0,2.9316835820744416,62.06654956067534,91.70519399344465,151.35238596153846,153.77672913685385,-8.29480600655534
2022-03-25,164.0,165.3685,162.25,164.773499,164.773499,49032000,6585370517.835009,11234156000,20.928465293547898,44.0,3.3578905414364613,63.07679629466788,95.13226312981172,151.60904,154.5913046822721,-4.867736870188285
2022-03-28,164.975006,169.037506,164.899994,168.990494,168.990494,59854000,6643864349.575437,11294010000,20.924846418771228,56.0,3.9899452755071536,66.66390095143832,99.85404307542406,152.16050146153847,155.65791129840008,-0.14595692457594006
2022-03-29,170.384003,170.831497,167.8685,169.315002,169.315002,66154000,6642301635.565938,11360164000,21.18335274889298,60.0,4.465562069716299,66.93014746827026,94.93615392326309,152.80332842307692,156.66954764666676,-5.063846076736905
2022-03-30,168.509506,168.9505,165.5,166.300995,166.300995,56168000,6612211182.101223,11303996000,20.87355679800806,60.0,4.546873107119865,61.97887973026562,84.87184937744703,153.42269380769233,157.3829881913581,-15.128150622552965
2022-03-31,166.445007,166.494995,162.953506,162.997498,162.997498,59966000,6553734964.659915,11244030000,20.028495082203538,60.0,4.2952352918990755,57.00155815811867,73.84088631923592,154.12155926923077,157.79887780681304,-26.159113680764086
2022-04-01,164.149506,165.826996,162.319504,163.559998,163.559998,57090000,6537026982.614625,11301120000,19.10677961531374,60.0,4.0940064020036,57.62556477444916,74.7793220726624,154.5908668076923,158.22562745075282,-25.2206779273376
2022-04-04,164.125,168.394501,163.205505,168.346497,168.346497,49882000,6585986054.353358,11351002000,18.72359109967434,60.0,4.271522076279183,62.59943822203665,89.41562178408998,155.15078984615386,158.9753214914378,-10.584378215910037
2022-04-05,167.741501,168.110504,163.266006,164.054993,164.054993,53728000,6549758605.921756,11297274000,18.367773192294898,60.0,4.019580794571709,56.226916716702625,63.745527512027074,155.5543278846154,159.351593455035,-36.25447248797292
2022-04-06,161.650497,162.199997,157.254501,158.755997,158.755997,79056000,6518706797.119565,11218218000,17.391316045626915,60.0,3.3536717813299504,49.52316365934572,18.52161483135356,155.847174,159.30747519910648,-81.47838516864644
2022-04-07,158.399994,160.078995,154.511505,157.7845,157.7845,68136000,6530681865.95669,11150082000,16.986883043289524,60.0,2.716231377435946,48.3842000208395,20.055126252512906,156.06763534615385,159.19466222139488,-79.9448737474871
2022-04-08,156.75,157.3685,154.231003,154.460495,154.460495,46002000,6491409492.14215,11104080000,16.662158289031286,60.0,1.9206952618216917,44.60427767835398,1.3824407876056064,156.3200198076923,158.84398316795824,-98.61755921239438
2022-04-11,152.712997,154.136505,150.5345,151.121994,151.121994,52112000,6456296628.638629,11051968000,17.002612063408737,60.0,1.0092045471743916,41.128907930664624,2.8944872978007155,156.53082703846155,158.27198397033172,-97.10551270219929
2022-04-12,153.692505,155.098999,150.382996,150.787506,150.787506,55178000,6410584293.855552,10996790000,17.07608087788108,60.0,0.25688993544588357,40.786022075371925,1.9781890124856374,157.04369253846156,157.71757819475158,-98.02181098751436
2022-04-13,150.018494,156.024994,149.600006,155.541,155.541,53390000,6455930562.206559,11050180000,16.906797544627647,56.00000000000001,0.04373823753385864,47.48629021634788,27.98199146729727,157.79471192307693,157.55635018032552,-72.01800853270274
2022-04-14,155.389999,155.897003,151.472,151.706497,151.706497,51598000,6409801293.507306,10998582000,16.749605878035176,44.0,-0.42964567664262177,43.23621666903475,9.921540602117886,158.27269230769232,157.12302772252363,-90.07845939788211
2022-04-18,151.523499,154.039505,150.250504,152.785004,152.785004,46514000,6425514636.8096695,11045096000,16.855363798855105,44.0,-0.709599516220834,44.734456095437494,15.00129218433118,158.50221150000002,156.80169263196632,-84.99870781566882
2022-04-19,152.029495,158.649002,151.550507,158.115494,158.115494,54926000,6472184390.828514,11100022000,15.739430155789718,44.0,-0.4956256923437081,51.54218926563111,44.00656644734757,158.98648026923078,156.89901125182067,-55.99343355265243
2022-04-20,157.602493,157.602493,153.6035,153.998001,153.998001,59630000,6424319399.984569,11040392000,14.703206058657573,40.0,-0.6507952070571719,46.751539585935845,23.400442523196205,159.45359580769232,156.68412160353768,-76.5995574768038
2022-04-21,154.714005,156.738007,147.589493,148.296005,148.296005,63970000,6370229818.2994995,10976422000,15.001517035414606,36.0,-1.2198103743448314,41.06000622794377,3.395874685556497,159.48934596153848,156.06277963290526,-96.6041253144435
2022-04-22,148.25,149.615005,143.697495,144.350006,144.350006,73078000,6313268123.589394,10903344000,15.920156601074762,-68.0,-1.9664995524266828,37.64453918217228,2.6420651960808708,159.15265373076923,155.19516677120856,-97.35793480391914
2022-04-25,144.022995,146.221497,142.306503,146.074005,146.074005,61874000,6370480088.343363,10965218000,16.983813929763247,-72.0,-2.391575204172568,39.993074973115384,14.600456727621456,158.7232309230769,154.51952515852645,-85.39954327237855
2022-04-26,144.800003,144.856003,138.929504,139.391006,139.391006,77530000,6305024755.042876,10887688000,18.44868984075992,-76.0,-3.230473994524175,34.559245421971596,1.9832068018498623,157.88248099999998,153.3988941097467,-98.01679319815014
2022-04-27,140.191498,141.948502,135.783493,138.167007,138.167007,71336000,6288848562.499443,10816352000,20.20325558896011,-80.0,-3.948557308964638,33.65727051101162,9.81051554316523,156.98538507692308,152.27060617569137,-90.18948445683476
2022-04-28,142.177994,145.9375,140.300003,144.596497,144.596497,117316000,6350352166.34278,10933668000,20.733156961986037,-80.0,-3.9532666030821986,42.19214615877395,38.54278511796963,156.20490388461536,151.70215364415867,-61.45721488203037
2022-04-29,129.848999,130.761002,121.625,124.281502,124.281502,272662000,6236255619.442287,10661006000,23.043640788183307,-88.0,-5.5324741514297955,29.345901356885605,7.175080640931263,154.7000383846154,149.6709942631099,-92.82491935906873
2022-05-02,122.401001,124.667999,118.375,124.5,124.5,148788000,6377099478.592432,10809794000,25.396357344920148,-92.0,-6.68926684427845,29.59419663748473,15.208322232292685,153.19428815384614,147.80647616954622,-84.79167776770731
2022-05-03,124.053497,126.220497,122.824997,124.253502,124.253502,79134000,6364549672.18395,10730660000,27.237483589653728,-92.0,-7.539018602558372,29.46838002623045,14.596269821906445,151.63582673076922,146.06181141624648,-85.40373017809355
2022-05-04,123.599998,126.0,119.182999,125.928497,125.928497,110746000,6472972459.604694,10841406000,29.199150584169583,-92.0,-7.985245950469363,31.59649260047135,18.755267976596897,149.9795960769231,144.57045479282084,-81.2447320234031
2022-05-05,123.0,123.499001,115.072502,116.406998,116.406998,144392000,6374314885.356599,10697014000,31.281964941683373,-100.0,-9.003404095408484,26.670264126026964,3.0624212591649207,147.94467284615385,142.48427280816742,-96.9375787408351
2022-05-06,114.849998,119.050499,113.081497,114.772499,114.772499,124260000,6320459924.095068,10572754000,33.33622339548179,-92.0,-9.828890834658125,25.923082250791694,3.7109822010224116,145.96280761538463,140.43154882237724,-96.2890177989776
2022-05-09,111.3125,114.0,107.957001,108.789001,108.789001,128124000,6227616144.396279,10444630000,35.53128636555587,-96.0,-10.840945632250794,23.34472576729371,1.675882273459982,143.8778654230769,138.08765639109004,-98.32411772654002
2022-05-10,111.25,112.642502,107.170998,108.859001,108.859001,105434000,6187236618.742639,10550064000,37.61157063500961,-100.0,-11.504738472162401,23.440661869233878,3.405496990952205,141.77398092307692,135.92257080656483,-96.5945030090478
2022-05-11,108.1035,110.155998,104.428497,105.372002,105.372002,109704000,6113676225.708399,10440360000,39.689543519835844,-100.0,-12.171861119134022,21.965882196532462,2.0880237083157693,139.35188496153847,133.65956570978224,-97.91197629168423
2022-05-12,102.75,110.780502,102.405502,106.930496,106.930496,132026000,6124316938.029354,10572386000,41.723743154744135,-100.0,-12.43150058192795,24.259512223962233,10.327265191626953,137.15478892307692,131.67963462016874,-89.67273480837305
2022-05-13,109.069,113.183998,107.800003,113.055,113.055,93684000,6213511688.454642,10666070000,42.972405910803744,-96.0,-12.004687869508047,32.63866309108815,24.463609503979136,135.39705826923077,130.3000320557118,-75.53639049602086
2022-05-16,113.099998,113.9925,110.353996,110.810501,110.810501,74566000,6157656538.754656,10591504000,43.91646641822134,-68.0,-11.712533238757317,31.27320769387964,19.307634352092002,133.59036600000002,128.85636308862203,-80.69236564790799
2022-05-17,113.275002,115.800003,111.276497,115.3685,115.3685,76448000,6219519594.534841,10667952000,44.30648648009874,-68.0,-10.986559938439697,37.03410374847565,29.778091049255302,132.08682773076924,127.85726211909447,-70.22190895074469
2022-05-18,111.439499,112.852997,106.249001,107.112503,107.112503,108380000,6139481933.555034,10559572000,45.086484604017016,-68.0,-10.951172527211483,31.829643215028256,16.599957680167893,130.394155,126.32061329545783,-83.40004231983211
2022-05-19,106.280502,110.033997,106.193001,107.319,107.319,88142000,6103018094.0415325,10647714000,45.815195451698465,-68.0,-10.782174965397786,32.08671683342418,20.631950584075305,128.72228938461538,124.91308638468317,-79.3680494159247
2022-05-20,109.568497,109.898003,105.009499,107.591003,107.591003,99500000,6108605314.180863,10747214000,46.589397231110425,-68.0,-10.505197434456605,32.4480803213968,21.774100729393403,126.87805873076924,123.62996909692886,-78.2258992706066
2022-05-23,108.460999,108.819,103.949997,107.556999,107.556999,107798000,6160522804.84538,10639416000,47.39685804733388,-68.0,-10.171187466517424,32.42485249619358,21.833467276989772,125.18000111538461,122.43937871937857,-78.16653272301022
2022-05-24,104.025002,105.400002,101.260002,104.099998,104.099998,102934000,6198812064.876298,10536482000,48.36479667573901,-100.0,-10.069359936462305,30.06827243729316,12.770340967235073,123.30750088461538,121.08090607349867,-87.22965903276493
2022-05-25,103.655502,108.175003,103.650002,106.775002,106.775002,93120000,6234310820.98265,10629602000,48.40628112806299,-96.0,-9.661439359507895,34.06174975172111,30.99969607369597,121.33286657692308,120.02120947546173,-69.00030392630401
2022-05-26,107.970001,112.665497,107.453499,111.077499,111.077499,93002000,6270640892.100099,10722604000,47.22121035312858,-92.0,-8.888522458936677,39.99689700598576,67.52060746075603,119.68207803846154,119.35871240320532,-32.479392539243975
2022-05-27,113.550003,115.186996,112.627998,115.1465,115.1465,93660000,6361336563.593394,10816264000,45.508544547726316,-88.0,-7.857074409099553,45.035692629362444,95.5054817396505,118.40709707692307,119.04669666963456,-4.494518260349504
2022-05-31,116.279999,121.994499,115.675003,120.209503,120.209503,144634000,6424264328.962025,10960898000,42.51851727508834,-84.0,-6.555534251431155,50.59509575419895,91.39117770737334,117.47861619230768,119.13283047188385,-8.60882229262666
2022-06-01,122.255997,125.179001,120.622498,121.683998,121.683998,127528000,6356155129.739727,11088426000,39.769937053137184,-72.0,-5.343478580876919,52.11415382410431,85.38817197157792,116.540539,119.3218058443369,-14.61182802842208
2022-06-02,121.683998,125.610001,120.044998,125.511002,125.511002,100560000,6453137291.797861,11188986000,37.11159113968588,-72.0,-4.027679903595086,55.903857146308354,99.59343324819031,116.0066926923077,119.78026481883045,-0.4065667518096903
2022-06-03,124.199997,124.400002,121.046501,122.349998,122.349998,97604000,6431410126.895271,11091382000,34.64312707719538,-72.0,-3.2030438811823103,52.22725956315818,86.61189678077606,115.3983461923077,119.970615424843,-13.388103219223943
2022-06-06,125.25,128.990005,123.809998,124.790001,124.790001,135269000,6347324079.276224,11226651000,33.16044771226894,-68.0,-2.3258154889081197,54.70364141273943,84.85393600570474,114.63655788461539,120.32760694892872,-15.146063994295252
2022-06-07,122.010002,124.099998,120.629997,123.0,123.0,85156700,6378491054.381851,11141494300,31.13420020686868,32.0,-1.7548153697314035,52.55150301677962,78.39883032107859,114.58726934615385,120.52556198974882,-21.60116967892141
2022-06-08,122.610001,123.75,120.75,121.18,121.18,64926600,6332176746.381851,11076567700,29.252684666139864,32.0,-1.4326378932284882,50.38117657094933,71.83554217430128,114.45957703846153,120.57403887939707,-28.164457825698722
2022-06-09,119.989998,121.300003,116.099998,116.150002,116.150002,67029800,6266436082.880451,11009537900,27.713481619334114,31.999999999999993,-1.5651466863589008,44.86623794469624,53.6963519261069,114.14790396153846,120.24633244388616,-46.3036480738931
2022-06-10,113.419998,114.5,109.050003,109.650002,109.650002,87266000,6198384593.543118,10922271900,27.35865872171871,32.0,-2.169646205918525,38.935030366665416,30.256037116187837,113.521808,119.46141907767236,-69.74396288381216
2022-06-13,104.190002,106.540001,101.860001,103.669998,103.669998,99277700,6175898491.477691,10822994200,27.866960444044537,32.0,-3.0955689838536387,34.42600299449775,8.69093306625321,113.03192338461538,118.29168418302996,-91.30906693374679
2022-06-14,104.190002,104.879997,101.43,102.309998,102.309998,69728800,6141741435.187844,10753265400,28.384277601459484,32.0,-3.8942199468073397,33.47648261274786,3.193025545532327,112.55259642307692,117.1078555768796,-96.80697445446768
2022-06-15,103.860001,109.059998,103.529999,107.669998,107.669998,85011100,6184016386.772628,10838276500,27.97636281912262,32.0,-4.047986713260428,40.44796106444038,22.64149806939441,112.50955784615384,116.40875501562927,-77.3585019306056
2022-06-16,104.470001,104.580002,102.010002,103.660004,103.660004,82186300,6207361261.381656,10756090200,27.789745978749256,32.0,-4.442213909618118,37.298711146662406,8.091449910839982,112.30959642307693,115.46440308854561,-91.90855008916003
2022-06-17,102.800003,106.980003,102.510002,106.220001,106.220001,99772100,6273206301.614018,10855862300,27.116307663490694,32.0,-4.496241565914133,40.48452790411641,17.380261723464823,112.34221176923076,114.77963256346816,-82.61973827653517
2022-06-21,108.199997,111.629997,103.559998,108.68,108.68,70901200,6292271478.512553,10926763500,25.608520591298035,31.999999999999996,-4.291092469668399,43.45755629271337,26.306236156343232,112.40950038461538,114.32780792913718,-73.69376384365677
2022-06-22,107.43,112.129997,107.019997,108.949997,108.949997,60040100,6277584565.596702,10986803600,24.11800515203887,32.00000000000001,-4.05992355985002,43.78944747861957,27.28590578992998,112.25161565384616,113.9294515640159,-72.71409421007002
2022-06-23,110.389999,113.0,107.93,112.440002,112.440002,64345300,6327715570.01114,11051148900,22.57019568119318,32.0,-3.5541364246948604,48.03544874838335,39.94920175087052,112.31428876923079,113.8191219666814,-60.05079824912948
2022-06-24,112.379997,116.709999,111.43,116.459999,116.459999,69867600,6390966918.758062,11121016500,21.451530352537475,32.0,-2.7966779521408824,52.48744709983593,54.53554525842791,112.3562695,114.01474248766795,-45.46445474157209
2022-06-27,117.089996,117.980003,112.699997,113.220001,113.220001,62133200,6341072156.567717,11058883300,20.629375116522404,32.0,-2.4298179870100967,48.85452328867921,52.00706678491984,112.59117326923077,113.95587274784069,-47.99293321508016
2022-06-28,113.5,114.849998,107.040001,107.400002,107.400002,74942900,6273038226.940663,10983940400,19.507521153994304,32.0,-2.5789752794345873,43.085587435251945,26.747320788530445,112.59428873076922,113.47025269244509,-73.25267921146956
2022-06-29,107.379997,110.989998,106.910004,108.919998,108.919998,66375300,6272062020.541389,11050315700,18.488435359333074,32.0,-2.545193132138266,44.915068676465204,37.695001857825595,112.64540392307693,113.133196789301,-62.304998142174405
2022-06-30,108.110001,108.18,102.519997,106.209999,106.209999,97679400,6301745514.645438,10952636300,18.273906040170086,32.0,-2.705902844289156,42.30411205881601,28.882163948852412,112.59359623076922,112.62036732342685,-71.11783605114758
2022-07-01,106.290001,109.75,105.849998,109.559998,109.559998,73021200,6367651757.24675,11025657500,17.744957227932186,-23.999999999999996,-2.5337421248143386,46.44831450189339,49.123846080269544,112.80359623076923,112.3936732994693,-50.876153919730456
2022-07-05,107.599998,114.080002,106.32,113.5,113.5,76583700,6432787341.855182,11102241200,16.541571465893902,-24.0,-2.055681662264945,50.914019398223694,72.93050037513589,113.06225,112.47562342543453,-27.06949962486411
2022-07-06,113.209999,115.480003,112.010002,114.330002,114.330002,66958900,6455364236.225269,11169200100,15.676402137504613,-24.0,-1.5914953094155493,51.82540533994306,77.14464138104935,113.18734626923077,112.61298480132827,-22.855358618950643
2022-07-07,113.849998,116.989998,113.489998,116.330002,116.330002,57872300,6491410543.933383,11227072400,15.144366398581386,-24.0,-1.050135684711151,54.03983540568095,89.66812212472621,113.23286557692307,112.88831940863729,-10.331877875273793
2022-07-08,114.599998,116.580002,113.690002,115.540001,115.540001,45719700,6504224684.265771,11181352700,14.650333212438392,-24.0,-0.6770461931654097,53.0034287494844,84.2275252600178,113.05326934615385,113.08474026725675,-15.772474739982197
2022-07-11,114.080002,114.300003,110.870003,111.75,111.75,53487600,6478182523.062972,11127865100,13.628944402977567,-24.0,-0.6793602474453309,48.22500335886247,59.70245419050938,112.67119250000002,112.98587061783032,-40.29754580949063
2022-07-12,112.160004,113.230003,108.339996,109.220001,109.220001,54280300,6443438773.992858,11073584800,13.186850908527092,-24.000000000000004,-0.8752545378647056,45.28974439689896,43.33765459081966,112.04461553846153,112.70691731280584,-56.66234540918033
2022-07-13,107.029999,111.779999,106.010002,110.400002,110.400002,61353800,6475444877.646188,11134938600,13.212050702897768,-24.0,-0.9246274259383966,46.91271763617322,50.970258355656526,111.58500030769231,112.53603469704244,-49.02974164434347
2022-07-14,110.239998,111.18,107.580002,110.629997,110.629997,51163100,6510974714.244763,11186101700,13.235450511956254,-20.0,-0.9344256439341763,47.24123470647562,52.45793565668735,111.04038476923077,112.39484671948374,-47.54206434331266
2022-07-15,112.5,115.589996,111.589996,113.550003,113.550003,84317800,6509288653.357063,11270419500,12.347887556854957,-16.0,-0.6985186336011395,51.35688843207988,71.34541862402904,110.67692334615384,112.48041385137384,-28.65458137597097
2022-07-18,115.0,117.239998,113.150002,113.760002,113.760002,59115400,6467806715.10128,11329534900,11.867028894862898,-12.0,-0.4889788205640997,51.649012753700916,76.35872443215187,110.39153880769231,112.57519815867947,-23.641275567848133
2022-07-19,115.699997,118.949997,114.029999,118.209999,118.209999,60990000,6510450171.862848,11390524900,11.766404315142234,92.0,0.03574847250550306,57.47675036688623,95.49605599513086,110.47076946153847,112.9925908135921,-4.503944004869143
2022-07-20,118.620003,123.480003,118.32,122.769997,122.769997,71268300,6562105723.33933,11461793200,12.4895940207994,96.0,0.8102127337708396,62.46877785412217,96.61256776357796,110.97538465384615,113.71684312369638,-3.3874322364220366
2022-07-21,123.199997,124.849998,121.260002,124.629997,124.629997,60239900,6614962418.321887,11522033100,13.383873036642687,100.0,1.556129602468502,64.30928998862993,98.84210000000002,111.78153846153847,114.52522489231146,-1.1578999999999808
2022-07-22,125.010002,125.5,121.349998,122.419998,122.419998,51463800,6590036565.050588,11470569300,14.321359100599922,96.0,1.9465075183715754,60.51218480118512,84.19701223160723,112.55499999999999,115.11002290028839,-15.802987768392759
2022-07-25,122.699997,123.639999,120.029999,121.139999,121.139999,50221300,6570699277.79297,11420348000,14.813353621931071,96.0,2.1280685576874134,58.362785222993026,77.62954619082056,113.07307696153846,115.55668779656332,-22.37045380917944
2022-07-26,115.790001,118.150002,114.529999,114.809998,114.809998,67075100,6514000390.699368,11353272900,13.9003224616914,92.0,1.7411083969498264,49.078572549974126,45.15134378156423,113.50192288461538,115.50137744126233,-54.848656218435764
2022-07-27,117.309998,121.900002,117.160004,120.970001,120.970001,61582000,6551417265.911551,11414854900,13.780884407562493,60.0,1.9094890414209544,56.354816096162764,76.75731418751297,114.06923057692309,115.90646066783549,-23.242685812487018
2022-07-28,121.57,122.839996,118.080002,122.279999,122.279999,82245500,6614310962.83638,11497100400,13.84132051103972,60.0,2.124151904850791,57.73784941553827,83.47870020304775,114.59230746153845,116.3785746183662,-16.521299796952242
2022-07-29,134.899994,137.649994,132.410004,134.949997,134.949997,148892900,6609764492.409605,11645993300,15.829358540699923,80.0,3.2788402918131965,68.2252717445685,91.46650542768785,115.59230746153847,117.75423553552426,-8.533494572312145
2022-08-01,134.960007,138.830002,133.509995,135.389999,135.389999,76846900,6587230483.121064,11722840200,17.78564878300599,84.0,4.181244853771631,68.517451307854,89.51857708714194,116.47499965384615,119.06058838474468,-10.481422912858068
2022-08-02,134.720001,137.440002,134.089996,134.160004,134.160004,61922400,6527896176.025494,11660917800,19.60220400800448,84.0,4.742488201701775,66.67182524600807,85.05600639999994,117.15576907692308,120.17906361550433,-14.943993600000061
2022-08-03,136.210007,140.490005,136.050003,139.520004,139.520004,71827800,6568339738.888754,11732745600,21.58711733844662,92.0,5.555741671428208,70.41209447770481,96.64359620095622,118.16730765384615,121.61172586620772,-3.3564037990437874
2022-08-04,140.580002,143.559998,139.550003,142.570007,142.570007,70585000,6604072568.382307,11803330600,23.70755370700112,96.0,6.372897858006738,72.31597925352258,96.7445211107558,119.52000015384615,123.16419113537752,-3.2554788892441917
2022-08-05,140.100006,142.860001,139.600006,140.800003,140.800003,50686900,6590701141.528309,11752643700,25.676530334944584,96.0,6.799297424608056,69.52024185028702,90.65358925342326,120.74615419230769,124.47054756979401,-9.346410746576737
2022-08-08,142.050003,144.229996,138.289993,139.410004,139.410004,52229000,6558168109.533375,11700414700,27.63290253796827,100.0,6.94500317707795,67.31921141160687,83.77106906778471,122.02307746153846,125.57717397203149,-16.22893093221529
2022-08-09,138.050003,138.949997,136.210007,137.830002,137.830002,40434700,6565546731.353163,11659980000,28.829229779982004,72.0,6.853974724715883,64.80751037628119,78.45119647655186,123.11038530769231,126.48479086299211,-21.548803523448143
2022-08-10,142.899994,144.600006,141.009995,142.690002,142.690002,54773800,6562037602.9191265,11714753800,30.505604662514745,80.0,7.092240470304375,68.6786014296894,93.6481424829731,124.23307769230769,127.68517687314085,-6.3518575170268985
2022-08-11,143.860001,144.490005,139.759995,140.639999,140.639999,44867300,6533865152.811283,11669886500,31.705401914324018,80.0,7.034559655932924,65.4102258651736,86.8307080872977,125.24500065384615,128.64479332698227,-13.16929191270231
2022-08-12,142.050003,143.570007,140.119995,143.550003,143.550003,47643500,6580956155.849533,11717530000,32.81949936243263,80.0,7.141339283921866,67.75598491592984,96.50813849162056,126.29192376923078,129.74888293239098,-3.4918615083794418
2022-08-15,142.800003,143.759995,141.490005,143.179993,143.179993,39014600,6600033623.061107,11678515400,33.875657722044515,80.0,7.11409928552095,67.1325752369957,94.82502588738875,127.35500038461538,130.74377997443608,-5.174974112611257
2022-08-16,143.910004,146.570007,142.0,144.779999,144.779999,59102900,6612836959.921182,11737618300,35.17032198882456,96.0,7.139320856169547,68.48297969395699,93.71706673972153,128.62538496153846,131.78349990225564,-6.2829332602784715
2022-08-17,142.690002,143.380005,140.779999,142.100006,142.100006,48149800,6613577872.51846,11689468500,35.962735455487525,96.0,6.863932948772629,63.75769960532895,68.43220301577627,129.89000053846155,132.5476855391256,-31.567796984223737
2022-08-18,141.320007,142.770004,140.380005,142.300003,142.300003,37458700,6636303824.547688,11726927200,36.56115470977321,92.0,6.585905910797578,63.95756313787558,67.30474673377023,131.11692365384616,133.2700794251163,-32.69525326622977
2022-08-19,140.470001,141.110001,137.910004,138.229996,138.229996,47792800,6598069354.544622,11679134400,36.287679476808414,88.0,5.968352477503203,57.06127167610473,33.173047684012374,132.17846207692307,133.63748065288547,-66.82695231598763
2022-08-22,135.720001,136.320007,132.850006,133.220001,133.220001,50461500,6558368948.09618,11628672900,34.60508350313321,84.0,5.016841183867967,49.92503999892969,2.6967563632100964,132.93500046153846,133.60655623415323,-97.3032436367899
2022-08-23,133.410004,134.990005,132.949997,133.619995,133.619995,36252100,6545929337.552888,11664925000,33.0426729561491,80.0,4.246091501574057,50.4577660663102,5.612164313982057,133.69884634615386,133.60755169829002,-94.38783568601794
2022-08-24,132.75,135.470001,132.100006,133.800003,133.800003,38627000,6546273187.135158,11703552000,31.362215526414612,60.0,3.6081988957703004,50.71189171500431,11.748423514276167,134.29846188461536,133.62180735026854,-88.25157648572383
2022-08-25,135.259995,137.419998,134.279999,137.279999,137.279999,37496300,6580425890.845032,11741048300,30.2272140189506,60.0,3.3449129294480144,55.467653726161394,35.79815232908413,134.8565388846154,133.89278450950792,-64.20184767091587
2022-08-26,136.550003,137.830002,130.5,130.75,130.75,53322700,6530740481.803479,11687725600,28.176839400846806,60.0,2.5796044837032355,46.41710227297649,1.5556931618013603,135.09192361538462,133.6599856569518,-98.44430683819864
2022-08-29,129.899994,131.949997,128.770004,129.789993,129.789993,48101600,6513496247.138812,11639624000,26.46302131109193,60.0,1.874024892493452,45.2481886689734,5.730274315122359,135.37538496153846,133.37331953421463,-94.26972568487764
2022-08-30,131.25,132.070007,126.849998,128.729996,128.729996,49203000,6499734389.709256,11590421000,25.302388038989477,60.0,1.2153057951924495,43.932640911419135,9.533454066882019,135.66730792307692,133.02936964279132,-90.46654593311798
2022-08-31,129.449997,130.589996,126.739998,126.769997,126.769997,53648700,6446921745.9104805,11536772300,24.249465801204064,56.00000000000001,0.5290124990712286,41.528355346142696,0.1512808188841652,136.1273078846154,132.56571240999196,-99.84871918111583
2022-09-01,126.0,128.020004,123.660004,127.82,127.82,56636100,6498361769.513967,11593408400,23.939091815623243,52.0,0.06905061180734151,43.31798589960804,18.15798976543125,136.39076938461537,132.21417815739997,-81.84201023456875
2022-09-02,129.5,131.380005,126.389999,127.510002,127.510002,57429800,6466712118.190902,11535978600,22.714709269795456,-48.0,-0.3168344749299763,42.900507946206325,16.804877764529316,136.59192334615383,131.86572066425924,-83.19512223547068
2022-09-06,127.919998,128.619995,124.739998,126.110001,126.110001,43888600,6453817105.900273,11492090000,21.941591618948028,-48.0,-0.72723643775916,40.97968200839429,12.423919248279931,136.2519235,131.4393710594993,-87.57608075172007
2022-09-07,126.120003,129.820007,125.400002,129.479996,129.479996,47900300,6494347898.89596,11539990300,20.89565673199512,-48.0,-0.771657332422933,47.11761578531589,30.455217163788593,136.0246156923077,131.29423216620307,-69.54478283621141
2022-09-08,127.720001,130.279999,127.099998,129.820007,129.820007,43988500,6525610391.519233,11583978800,19.79673544061519,-48.0,-0.7705428273028474,47.708496985833165,35.30088285975064,135.85769273076923,131.18503030203988,-64.69911714024936
2022-09-09,130.910004,133.690002,130.759995,133.270004,133.270004,49387600,6560839190.379987,11633366400,18.87383459674808,-48.0,-0.4856750887921919,53.398347958468605,67.81934619891969,135.61730811538462,131.33947279818506,-32.18065380108032
2022-09-12,134.100006,136.490005,134.0,136.449997,136.449997,53826900,6612936369.664406,11687193300,18.64244698209338,-48.0,-0.0032787000583027748,57.941107310844735,90.2610783713589,135.3819231153846,131.71803014646764,-9.738921628641094
2022-09-13,131.009995,131.399994,126.269997,126.82,126.82,72694000,6555829871.209533,11614499300,17.998957330860467,-48.0,-0.39350033623478,43.96441539700029,22.30061006360051,134.8442306923077,131.35521309858115,-77.69938993639948
2022-09-14,127.360001,128.839996,126.330002,128.550003,128.550003,45316800,6590675287.785987,11659816100,17.401431226144194,-48.0,-0.5567392667293518,46.46290634513857,34.50952498370148,134.42653834615385,131.1474197579455,-65.49047501629852
2022-09-15,127.379997,130.369995,125.5,126.279999,126.279999,52887200,6554729363.131362,11606928900,16.47254006015157,-48.0,-0.8593713488349977,43.70899984085285,18.489734437506637,133.98230746153845,130.78687007217175,-81.51026556249336
2022-09-16,122.779999,123.870003,120.699997,123.529999,123.529999,115667800,6645584897.999246,11491261100,16.55888423872619,-88.0,-1.3060560701561315,40.571694955640105,17.922739494495552,133.24538426923078,130.2493240668257,-82.07726050550446
2022-09-19,122.160004,124.709999,121.800003,124.660004,124.660004,47279700,6691240026.28059,11538540800,16.424552857936884,-88.0,-1.5509960532976947,42.40119197998586,25.079195653352453,132.6307690769231,129.83530035817193,-74.92080434664754
2022-09-20,123.349998,124.400002,121.139999,122.190002,122.190002,47698400,6674267648.98376,11490842400,16.428633182702537,-88.0,-1.9222626263767495,39.53612925416347,9.43637900626783,131.80923057692306,129.26898196127033,-90.56362099373217
2022-09-21,122.489998,123.760002,118.449997,118.540001,118.540001,58498900,6617751848.809692,11432343500,16.938892162752097,-100.0,-2.482403039742067,35.6975154474344,0.498913304251348,130.8615385769231,128.47424263080586,-99.50108669574865
2022-09-22,117.080002,118.790001,116.260002,117.309998,117.309998,55229200,6608364911.263709,11377114300,17.79090123529279,-100.0,-2.991089893065407,34.48251327122867,5.190290876377988,129.80500007692308,127.64726154704246,-94.80970912362201
2022-09-23,116.0,116.050003,112.059998,113.779999,113.779999,65126700,6599387508.884489,11311987600,19.21804493145262,-100.0,-3.6371425913322355,31.200408497631585,7.04052602195329,128.71576903846156,126.62005691392821,-92.95947397804672
2022-09-26,113.300003,117.339996,113.129997,115.150002,115.150002,62723300,6596854902.334297,11374710900,20.1520109246507,-96.0,-3.99257232824975,33.832668403114894,12.648395884618482,127.67153823076923,125.7704232166002,-87.35160411538152
2022-09-27,117.199997,118.32,113.050003,114.410004,114.410004,60094700,6567776862.152017,11314616200,20.7215867796826,-76.0,-4.284574699586841,33.09609941017138,9.619342311281398,126.75538469230767,124.92891068203721,-90.38065768871861
2022-09-28,114.379997,118.699997,113.800003,118.010002,118.010002,55763800,6607835849.786532,11370380000,21.131653796540824,-76.0,-4.177345096508077,39.94587609529235,24.355310254311455,126.17038473076923,124.41639892781224,-75.64468974568855
2022-09-29,115.599998,116.07,113.059998,114.800003,114.800003,58969700,6617043893.753813,11311410300,21.651665891553225,-76.0,-4.301796523195549,36.37020139707932,11.21573563200375,125.44653888461539,123.70407330352984,-88.78426436799626
2022-09-30,114.080002,116.919998,112.839996,113.0,113.0,59479600,6562229474.760293,11251930700,21.84332676392469,-76.0,-4.493867862928525,34.50501888259892,4.860404314458012,124.64653876923079,122.91117898474985,-95.13959568554199
2022-10-03,113.580002,116.910004,112.449997,115.879997,115.879997,50941900,6589642033.396793,11302872600,22.10477387289368,-76.0,-4.363395586503614,39.82258217501827,20.86291439588991,123.82346176923078,122.3903506895832,-79.1370856041101
2022-10-04,119.889999,123.0,119.790001,121.089996,121.089996,62812600,6577705502.789338,11365685200,20.552517765078104,-36.0,-3.7958359558401895,48.04112256948298,49.31731010114315,123.45192315384614,122.29402811998445,-50.68268989885684
2022-10-05,118.580002,121.75,117.690002,120.949997,120.949997,48217500,6606920951.7279825,11317467700,19.567729685121055,-36.0,-3.3190773511228144,47.85200439957889,70.2766663812912,123.11192330769231,122.19447025924487,-29.723333618708796
2022-10-06,120.769997,121.529999,119.5,120.300003,120.300003,42253800,6597970780.706519,11275213900,18.653283610875228,-36.0,-2.9595756596647647,46.92831873704651,65.13837429736178,122.78769280769231,122.05413935115266,-34.861625702638214
2022-10-07,118.0,118.169998,113.879997,114.559998,114.559998,54678000,6560626620.338724,11220535900,19.008389703002656,-36.0,-3.102079569096034,39.64966304946065,20.25931271983379,122.31807746153846,121.49901776958579,-79.74068728016621
2022-10-10,115.099998,116.25,112.43,113.669998,113.669998,42339700,6545774429.930661,11178196200,19.599114099569732,-36.00000000000001,-3.2493737480624674,38.64871023463973,13.760679056178208,121.77384661538461,120.9190903792461,-86.2393209438218
2022-10-11,112.709999,115.480003,110.389999,112.209999,112.209999,56432200,6529698427.686105,11121764000,20.49870275651215,-84.0,-3.4442124267619363,36.99862301548294,14.432988546154704,121.18538496153846,120.27397249930195,-85.5670114538453
2022-10-12,112.489998,113.830002,111.400002,112.900002,112.900002,45728700,6540424912.87129,11167492700,21.33403508081582,-84.0,-3.502570554782764,38.33851255296111,19.90485964275497,120.67730807692307,119.72775246231662,-80.09514035724503
2022-10-13,107.879997,113.440002,105.349998,112.529999,112.529999,86868100,6607750320.035959,11080624600,23.02321000547715,-92.0,-3.537893309730322,37.873363881854694,40.679887741655804,120.02538511538462,119.19458553918204,-59.3201122583442
2022-10-14,114.099998,114.959999,106.599998,106.900002,106.900002,67737300,6544874612.982945,11012887300,24.088910066699448,-92.0,-3.9743665301624134,31.5923945686783,8.781891356159626,119.14384646153847,118.28387564739079,-91.21810864384038
2022-10-17,110.110001,114.190002,110.089996,113.790001,113.790001,62782000,6595406453.943178,11075669300,25.0784886949773,-92.0,-3.7214112523794114,43.86234334960181,47.81870846246932,118.39461557692309,117.95099604388035,-52.181291537530676
2022-10-18,119.059998,119.519997,114.790001,116.360001,116.360001,65607400,6573352417.624669,11141276700,24.3726243794498,-88.0,-3.275803427878458,47.63524986776274,62.37961332808912,117.62192342307692,117.83314455914848,-37.62038667191087
2022-10-19,114.709999,116.589996,113.220001,115.07,115.07,47198100,6577974238.901644,11094078600,24.01828387343947,-80.0,-2.992255457937489,45.96533696623625,55.07082662086947,117.17000034615384,117.62846718439674,-44.92917337913053
2022-10-20,113.830002,118.239998,113.510002,115.25,115.25,48795100,6565079117.00302,11142873700,23.23494625793325,-80.0,-2.7216437383776224,46.2484912736999,56.090656533636654,116.65846176923077,117.45228442999698,-43.909343466363346
2022-10-21,114.790001,119.589996,114.5,119.32,119.32,55660500,6614834656.622698,11198534200,22.145573660188624,-72.0,-2.1539377616469153,52.33113182647725,79.15014400564937,116.3907695,117.59063373147868,-20.849855994350634
2022-10-24,119.980003,120.389999,116.57,119.82,119.82,49531500,6649584526.853423,11248065700,20.919492890042132,-72.0,-1.6447215375798834,53.03427346678037,88.2317087522306,116.24807723076923,117.75577197359137,-11.768291247769401
2022-10-25,119.650002,121.32,118.949997,120.599998,120.599998,50934600,6669571474.998805,11299000300,19.528681323470657,-68.0,-1.1647976294067774,54.1699801740935,94.25215733917443,116.09192315384615,117.96645538295496,-5.7478426608255715
2022-10-26,116.0,119.349998,114.760002,115.660004,115.660004,68802300,6627750552.588067,11230198000,19.225146391131407,-64.0,-1.1695884178249543,46.50058405918048,64.55857676160595,115.84076938461538,117.79560713236572,-35.441423238394044
2022-10-27,113.919998,114.120003,109.769997,110.959999,110.959999,129605400,6569055714.647429,11100592600,19.866383119816724,-28.0,-1.5349424153853164,40.609600727584414,35.12836754810675,115.54923084615385,117.28926578922751,-64.87163245189325
2022-10-28,97.910004,103.959999,97.660004,103.410004,103.410004,223133400,6753229637.90721,10877459200,21.923580965324952,-72.0,-2.405975007030804,33.30947691105929,24.302624565109824,115.0146156923077,116.2611723233588,-75.69737543489018
2022-10-31,103.559998,104.870003,100.739998,102.440002,102.440002,99251400,6735686505.575459,10778207800,23.594414732284438,-72.0,-3.1383685075276304,32.501106692609255,20.202869011474082,114.57846196153847,115.23738192903593,-79.79713098852592
2022-11-01,103.989998,104.580002,96.059998,96.790001,96.790001,153370000,6608598314.858647,10624837800,25.57951237979689,-80.0,-4.127128526349608,28.207110365701922,2.8899562240731833,113.87230807692308,113.87090926762586,-97.11004377592681
2022-11-02,97.32,97.739998,92.010002,92.120003,92.120003,135761800,6478049060.822659,10489076000,27.74837965653266,-84.0,-5.227300706038051,25.23894820095235,0.37530197033789264,113.01500034615385,112.2597310255795,-99.6246980296621
2022-11-03,92.470001,93.5,89.019997,89.300003,89.300003,136683300,6358451527.997279,10352392700,29.98062994475486,-88.0,-6.254645853018587,23.622464502887667,0.86689156035063,111.91076961538462,110.55901043109212,-99.13310843964938
2022-11-04,91.489998,92.440002,88.040001,90.980003,90.980003,129101300,6401876588.878833,10481494000,32.12342856470524,-92.0,-6.854250787513095,26.637010760322696,8.834140890448927,110.99461576923076,109.10871358434456,-91.16585910955108
2022-11-07,91.949997,92.099998,89.040001,90.529999,90.529999,77495700,6399850530.19456,10403998300,34.11317014037346,-92.0,-7.281813368242268,26.337151893179126,7.481965369049442,110.13038496153845,107.73251250402274,-92.51803463095055
2022-11-08,90.790001,91.720001,88.230003,89.980003,89.980003,88703400,6400104745.64305,10315294900,36.024812528189386,-92.0,-7.577688992822189,25.95261294006015,5.829333107852537,109.13423134615384,106.41751180002105,-94.17066689214747
2022-11-09,89.470001,89.480003,85.870003,86.139999,86.139999,90796200,6322890047.479727,10224498700,37.98340642213243,-100.0,-8.029470054896805,23.385339969995357,0.761624888148809,107.7900006923077,104.9154738148343,-99.23837511185118
2022-11-10,92.940002,98.690002,91.650002,96.629997,96.629997,173414900,6394817572.174471,10397913600,37.27713743739864,-96.0,-7.4551166869507455,40.65560731008935,30.352594952264756,106.85461607692308,104.30173479151324,-69.64740504773523
2022-11-11,97.879997,101.190002,96.660004,100.790001,100.790001,111590500,6486701082.639155,10509504100,36.077242047528486,-44.0,-6.588313966343975,45.866983628497486,42.08744502855673,106.10423138461539,104.04160636251225,-57.91255497144327
2022-11-14,98.769997,100.120003,97.290001,98.489998,98.489998,99533100,6471577408.074685,10409971000,34.96305347122048,-44.0,-6.0175905474487195,43.58791113400471,37.69413645372409,105.48615446153846,103.63037611343726,-62.305863546275916
2022-11-15,103.209999,103.790001,97.339996,98.940002,98.940002,111336300,6415477886.346268,10521307300,33.137320666896905,-44.0,-5.4659682842407875,44.17240443515516,46.26548318584074,104.91961615384616,103.2829409939234,-53.73451681415926
2022-11-16,96.849998,98.489998,95.540001,97.120003,97.120003,87958800,6421739575.328188,10433348500,31.74167212679921,-44.0,-5.116680467946935,42.26506345191294,59.21052631578947,104.33923169230769,102.8264270684476,-40.78947368421053
2022-11-17,95.370003,96.970001,94.029999,94.849998,94.849998,82617900,6385207763.284658,10350730600,30.693540186076923,-44.0,-4.9657951934380975,39.94812726137478,47.26313157894738,103.64500076923076,102.23558047078481,-52.73686842105262
2022-11-18,95.949997,95.989998,92.480003,94.139999,94.139999,72428200,6381287080.980382,10278302400,29.972056733836723,-44.0,-4.847628073028744,39.22386060545908,44.20094303586017,102.93769307692307,101.6359077692452,-55.79905696413983
2022-11-21,93.970001,95.019997,90.589996,92.459999,92.459999,84330300,6368152211.4061985,10193972100,29.601949091954914,-44.0,-4.833820465038173,37.49175615146247,36.7745353543008,102.38230834615385,100.95621082337517,-63.225464645699205
2022-11-22,92.620003,93.349998,90.870003,93.199997,93.199997,62192000,6422820920.276982,10256164100,29.258277710207523,-44.0,-4.708885085956808,38.774274621898584,40.90398894017732,101.59038511538462,100.38167646608812,-59.096011059822686
2022-11-23,93.239998,94.580002,92.830002,94.129997,94.129997,59414700,6451679149.33584,10315578800,28.597148052283877,-44.0,-4.483150699657088,40.4285269551157,46.093721662245734,100.73538496153847,99.91858909822975,-53.906278337754266
2022-11-25,93.790001,94.43,93.07,93.410004,93.410004,35088600,6434135055.739369,10280490200,27.98324194135478,-44.00000000000001,-4.312638577061506,39.537868734284224,42.07590313347134,99.90230819230769,99.43647168354606,-57.924096866528664
2022-11-28,93.93,96.400002,93.43,93.949997,93.949997,74943100,6385434488.350929,10355433300,26.842926358388603,-44.0,-4.086823215175357,40.59490860951679,45.08925726442601,99.0830773076923,99.03006615143153,-54.91074273557399
2022-11-29,94.040001,94.410004,91.440002,92.419998,92.419998,65567300,6363136985.294366,10289866000,26.2081898521102,-44.0,-3.9853800659463303,38.539034804876295,36.5513154633165,98.04846184615386,98.54043147354771,-63.4486845366835
2022-11-30,92.470001,96.540001,91.529999,96.540001,96.540001,102805800,6465942785.294366,10392671800,25.010650069372932,-44.0,-3.531823170499706,46.40955309212412,45.07577838038699,97.15307726923076,98.39225143847011,-54.92422161961301
2022-12-01,96.989998,97.230003,94.919998,95.5,95.5,68488000,6431847071.870369,10324183800,23.706638512824405,-40.0,-3.2191866721241524,44.84830855252948,37.196985910232605,96.18769273076921,98.17801059117603,-62.8030140897674
2022-12-02,94.480003,95.360001,93.779999,94.129997,94.129997,72496400,6391469105.906781,10251687400,22.77465755236415,-36.0,-3.0468456472188166,42.80546454335807,26.81817923553819,95.35961553846154,97.8781577325704,-73.18182076446182
2022-12-05,93.050003,94.059998,90.82,91.010002,91.010002,71535500,6328323665.450645,10180151900,22.578109638060806,-28.0,-3.125987230016989,38.504038295978745,3.1818624311127204,94.59230796153845,97.36940545608371,-96.81813756888727
2022-12-06,90.5,91.040001,87.900002,88.25,88.25,75503600,6269651987.367054,10104648300,22.967969657965295,-28.000000000000004,-3.3725400572233326,35.14004047519347,3.3049870840366644,94.00923088461538,96.69389394081826,-96.69501291596335
2022-12-07,88.339996,89.889999,87.480003,88.459999,88.459999,68086900,6256938531.681816,10172735200,23.408539933819807,-24.0,-3.5105226647813197,35.60106141094117,10.051241025641025,93.47153846153846,96.08397579705395,-89.94875897435898
2022-12-08,89.239998,90.860001,87.879997,90.349998,90.349998,73305900,6305153036.557715,10246041100,23.479866319897866,16.0,-3.427853589052887,39.751725780652436,29.435846153846185,93.22384603846155,95.65923670097588,-70.56415384615381
2022-12-09,88.900002,90.300003,88.629997,89.089996,89.089996,67398500,6274884035.016403,10178642600,23.546097964113205,16.0,-3.4245334916696066,37.99362416399197,16.512748717948746,93.1073073076923,95.17262627868138,-83.48725128205125
2022-12-12,89.209999,90.580002,87.870003,90.550003,90.550003,61999800,6335511190.96731,10240642400,23.781479658337584,16.000000000000004,-3.2664384582021313,41.2367385318804,31.487179487179564,93.15538423076924,94.83020973951979,-68.51282051282044
2022-12-13,95.230003,96.25,90.519997,92.489998,92.489998,100212000,6304205870.496797,10340854400,22.137725708412393,16.0,-2.9505930222010903,45.32856094946492,51.38456410256414,93.21346096153846,94.65686072177758,-48.61543589743586
2022-12-14,92.5,93.459999,89.870003,91.580002,91.580002,70298000,6300877031.299204,10270556400,20.78679875117935,16.0,-2.7421030535712276,43.788306093080024,42.05127179487176,93.25384569230769,94.42894526090517,-57.94872820512824
2022-12-15,89.889999,89.970001,87.470001,88.449997,88.449997,84802900,6282559333.529923,10185753500,20.151677176644796,16.0,-2.7971941829515714,38.8929751952324,10.04094056538103,93.19499930769231,93.98606020454181,-89.95905943461898
2022-12-16,88.269997,89.349998,86.730003,87.860001,87.860001,146144100,6262478482.285589,10039609400,19.7437308686519,-88.0,-2.8555450998968297,38.0299210341473,10.76188571428572,93.26115323076922,93.53227804124242,-89.23811428571427
2022-12-19,87.510002,87.629997,84.510002,84.919998,84.919998,83531500,6200900594.9509945,9956077900,19.88664467384827,-92.0,-3.1032499596129526,33.983106089766764,3.2232387403114733,92.81076865384615,92.89433137152076,-96.77676125968853
2022-12-20,85.330002,86.610001,84.330002,85.190002,85.190002,74348300,6182639633.585793,10030426200,20.060708702777355,-96.0,-3.2404172661186124,34.670654585245316,6.666666149870945,92.21076869230771,92.32364030696368,-93.33333385012905
2022-12-21,86.18,87.230003,85.209999,86.769997,86.769997,59267200,6214913552.77724,10089693400,19.988937502423415,-96.0,-3.1849172097783764,38.69429653332764,20.469760145932984,91.75999942307693,91.91225932126267,-79.53023985406702
2022-12-22,85.519997,85.68,82.25,83.790001,83.790001,81431300,6206604283.932517,10008262100,20.620479557379408,-100.0,-3.3428593854687563,34.39188761295176,11.00000714285717,91.17730707692307,91.3106105567247,-88.99999285714283
2022-12-23,83.25,85.779999,82.93,85.25,85.25,57433700,6242676710.776772,10065695800,21.16665921587158,-60.0,-3.312040834964421,38.02756114090225,21.428571428571427,90.72076849999999,90.86167644141175,-78.57142857142857
2022-12-27,84.970001,85.349998,83.0,83.040001,83.040001,57284000,6187342854.80583,10008411800,21.67382604161431,-60.0,-3.426447408387361,34.876981725401535,5.642864285714312,90.26653784615385,90.28229307538125,-94.35713571428569
2022-12-28,82.800003,83.480003,81.690002,81.82,81.82,58228600,6137571905.435968,9950183200,22.46406099636501,-72.0,-3.574356371514881,33.23977749283824,0.8928435292366548,89.79269173076923,89.65545655127893,-99.10715647076334
2022-12-29,82.870003,84.550003,82.550003,84.18,84.18,54995900,6172219157.448269,10005179100,22.705146515620473,-72.0,-3.4612439480790016,39.186784272560665,17.10163696451058,89.47423023076924,89.24986717711012,-82.89836303548942
2022-12-30,83.120003,84.050003,82.470001,84.0,84.0,62401200,6230670682.4433,9942777900,22.95108437664745,-72.0,-3.347537702389019,38.90214202584632,15.865373058430325,89.1203841923077,88.8609881269538,-84.13462694156968
2023-01-03,85.459999,86.959999,84.209999,85.82,85.82,76706000,6243780490.956755,10019483900,21.915080036966646,-72.0,-3.075117849470786,43.38040943977634,28.365374775463486,88.80076892307692,88.63572974717944,-71.6346252245365
2023-01-04,86.550003,86.980003,83.360001,85.139999,85.139999,68885100,6242638635.424465,9950598800,21.22952725660895,-72.0,-2.88088450773175,42.137677444258145,29.311791668256156,88.4826918076923,88.37678672886985,-70.68820833174385
2023-01-05,85.330002,85.419998,83.07,83.120003,83.120003,67930800,6177598683.665527,9882668000,20.68873519863121,-72.0,-2.8570160775062163,38.60016007968633,17.270545564075455,88.06615357692307,87.98739534154615,-82.72945443592455
2023-01-06,83.029999,86.400002,81.43,86.080002,86.080002,83303400,6250174889.591964,9965971400,20.712090050587086,-96.0,-2.5696318763038306,45.78289805637127,58.7121612909497,87.82230757692308,87.84610694587607,-41.2878387090503
2023-01-09,87.459999,89.480003,87.080002,87.360001,87.360001,65266100,6200137485.524924,10031237500,19.46306222383316,-96.0,-2.213081577626113,48.58396884484589,73.66458124301317,87.46923065384615,87.81009909803339,-26.335418756986826
2023-01-10,87.57,90.190002,87.290001,89.870003,89.870003,67756600,6252940956.72021,10098994100,18.102044694551655,-64.0,-1.7082846703700625,53.64179100010602,96.34704421300349,87.25269230769231,87.96268457225314,-3.652955786996509
2023-01-11,90.93,95.260002,90.93,95.089996,95.089996,103126200,6347969205.376446,10202120300,18.353970254454275,-64.0,-0.8769111883846108,62.01129987542176,98.77074493553941,87.28961534615385,88.49063356690105,-1.2292550644605897
2023-01-12,96.93,97.190002,93.5,95.269997,95.269997,85254800,6344503380.144264,10287375100,19.037598502468406,16.0,-0.20119785419790048,62.26429692222489,87.81722870339735,87.45346130769232,88.9928086360195,-12.182771296602649
2023-01-13,94.18,98.370003,94.120003,98.120003,98.120003,85549400,6419988144.850146,10372924500,19.93102462460311,20.0,0.5578509387312778,66.11248493068935,98.52420333101476,87.83307680769232,89.66889710742547,-1.4757966689852424
2023-01-17,98.68,98.889999,95.730003,96.050003,96.050003,72755000,6361968353.375727,10300169500,20.874492119310222,24.0,0.981061805684547,61.228579203564415,83.73427169153905,88.12500003846154,90.14157161798654,-16.265728308460957
2023-01-18,97.25,99.32,95.379997,95.459999,95.459999,79570400,6285629316.976617,10220599100,21.84759095529234,28.0,1.2543912335746086,59.870986487518394,78.42369480156512,88.32153853846154,90.5355292018394,-21.57630519843488
2023-01-19,94.739998,95.440002,92.860001,93.68,93.68,69002700,6260488727.880683,10151596400,21.65939405614412,28.0,1.3122489422226664,55.84779387526338,68.47400782560095,88.49807715384615,90.76845296466611,-31.525992174399054
2023-01-20,93.860001,97.349998,93.199997,97.25,97.25,67481500,6324718173.2247925,10219077900,21.974483320297697,28.0,1.6274109767221603,61.44384045726082,88.42929010620462,88.75576934615384,91.24856755987604,-11.570709893795387
2023-01-23,97.559998,97.779999,95.860001,97.519997,97.519997,76501100,6380500044.348304,10295579000,22.37355555805678,28.0,1.8773250268089754,61.837787517137265,89.93849636668534,88.94923084615385,91.71311788877411,-10.06150363331465
2023-01-24,96.93,98.089996,96.0,96.32,96.32,66929500,6334065741.468298,10228649500,22.82388254678148,27.999999999999993,1.956006359192557,58.954632861246154,83.23085522638344,89.13153846153847,92.05436841553158,-16.76914477361656
2023-01-25,92.559998,97.239998,91.519997,97.18,97.18,94261600,6426349891.647293,10322911100,21.463619791212135,28.0,2.063964595570667,60.380331732146466,88.03801006148693,89.46730780769232,92.43404482919593,-11.961989938513069
2023-01-26,98.239998,99.489998,96.919998,99.220001,99.220001,68523600,6480475696.760756,10391434700,20.851634565608936,52.0,2.2877614178547105,63.60934716147422,98.50499983444071,89.90423088461537,92.93670824925549,-1.4950001655592857
2023-01-27,99.529999,103.489998,99.529999,102.239998,102.239998,87775600,6512837393.878457,10479210300,21.238588706274403,56.0,2.6779408949392973,67.79397828931596,92.38269162283768,90.57038473076923,93.62584082338472,-7.617308377162307
2023-01-30,101.089996,101.739998,99.010002,100.550003,100.550003,70691900,6521900626.627296,10408518400,21.408121892703388,56.0,2.81830480553333,63.40035691053183,81.85187935528631,91.161154,94.13874172535623,-18.14812064471368
2023-01-31,101.160004,103.349998,101.139999,103.129997,103.129997,66527300,6575182606.129595,10475045700,21.923264873173245,56.0,3.101970583855916,66.92451725510927,97.13374954359071,91.79038476923077,94.8047606345891,-2.8662504564092854
2023-02-01,102.529999,106.239998,101.239998,105.150002,105.150002,80450100,6620556591.249755,10555495800,22.97510419123717,68.0,3.4500057596487608,69.40823254491576,92.59513637261301,92.61192326923077,95.57107480980473,-7.404863627386979
2023-02-02,110.25,114.0,108.879997,112.910004,112.910004,158154200,6711371984.853274,10713650000,25.062400855031576,72.0,4.302398085302428,76.65932067208851,95.15126399226904,93.67576957692307,96.85543993500437,-4.848736007730958
2023-02-03,105.260002,108.779999,102.519997,103.389999,103.389999,144374800,6607127001.025729,10569275200,25.064940473823846,72.0,4.1617660545718,58.377990821588995,52.80249295340397,94.4584618076923,97.33948134722627,-47.19750704659603
2023-02-06,102.93,103.949997,100.650002,102.18,102.18,81945200,6601167365.918767,10487330000,24.590404969328585,72.0,3.907632593975748,56.5326578538117,47.419935842535274,95.24153873076924,97.69803828446877,-52.580064157464726
2023-02-07,101.169998,102.410004,98.080002,102.110001,102.110001,119501300,6704109436.383122,10367828700,23.53052152033361,72.0,3.658409790443514,56.42154556769571,47.10855243213267,95.93115415384615,98.02485033747108,-52.89144756786734
2023-02-08,102.040001,102.669998,98.779999,100.050003,100.050003,75878300,6677776519.049391,10291950400,22.59735143178478,72.0,3.257128154736563,53.11310012992603,37.94486148422668,96.54846196153845,98.17486164580656,-62.05513851577332
2023-02-09,101.32,101.779999,97.57,98.239998,98.239998,64622500,6633722644.246214,10227327900,21.42985412436721,72.0,2.7612275779891036,50.321030872959525,29.893238893251027,97.0261541923077,98.179686560932,-70.10676110674898
2023-02-10,97.559998,98.82,96.230003,97.610001,97.610001,52740100,6637184333.298325,10174587800,20.01550710493384,72.0,2.2909783332098925,49.3486350809755,27.090761509239986,97.50576965384616,98.13748763049259,-72.90923849076002
2023-02-13,97.849998,99.68,96.910004,99.540001,99.540001,52841500,6684684484.676521,10227429300,18.90733499758686,72.0,2.050401536494448,52.3842565911337,35.67616961616954,98.13730803846154,98.24137750971535,-64.32383038383045
2023-02-14,98.410004,100.919998,97.519997,99.699997,99.699997,56202900,6700553517.59654,10283632200,18.17415641875128,68.0,1.8513122566006217,52.637667931807904,19.527262722666745,98.661154,98.34942339788459,-80.47273727733325
2023-02-15,99.089996,101.169998,98.449997,101.160004,101.160004,47957600,6748158699.891988,10331589800,17.554221770687157,64.0,1.7907008463521805,54.991628960895625,27.7433980433424,99.19192334615384,98.55761455359685,-72.25660195665759
2023-02-16,99.209999,100.629997,98.099998,98.150002,98.150002,56339200,6694046524.769705,10275250600,16.870093118492782,60.0,1.4826923073102165,49.526500645328035,10.80472326472539,99.51038484615385,98.52742103110819,-89.19527673527462
2023-02-17,97.800003,97.940002,95.650002,97.199997,97.199997,60029400,6715279369.182805,10215221200,15.825404495441358,24.000000000000007,1.1486944227923317,47.90820643220284,8.446840157693726,99.59153873076922,98.42909332510017,-91.55315984230627
2023-02-21,95.339996,95.610001,94.269997,94.580002,94.580002,56580400,6684878304.322103,10158640800,15.234498760435718,23.999999999999996,0.664922183665297,43.67017632210299,1.5712364564769186,99.56500046153846,98.14397544916682,-98.42876354352309
2023-02-22,95.099998,97.010002,94.800003,95.790001,95.790001,59534100,6678682364.141904,10218174900,14.25556342533597,24.0,0.3748450255610294,46.04407668439019,7.704023157016247,99.47538499999999,97.96960697145076,-92.29597684298375
2023-02-23,96.120003,96.43,93.669998,95.82,95.82,48467000,6705725560.825819,10266641900,13.673054721029317,24.0,0.14569794128490798,46.10471976840133,14.228999720119058,99.46653873076924,97.81037682541736,-85.77100027988095
2023-02-24,93.529999,94.139999,92.32,93.5,93.5,57053800,6722653652.02466,10209588100,13.510150984891192,24.0,-0.22056485056998554,42.15840093143322,10.146176305978466,99.39115415384616,97.49108965316422,-89.85382369402153
2023-02-27,94.279999,94.779999,93.139999,93.760002,93.760002,47470300,6711075703.74527,10257058400,13.136351165354531,24.0,-0.4842684185409638,42.74982229749126,13.913065490447487,99.39423115384616,97.21471278996687,-86.08693450955252
2023-02-28,93.139999,94.690002,92.919998,94.230003,94.230003,43959300,6732186203.357587,10301017700,12.8563898025223,24.0,-0.6478620923810041,43.86715005618605,18.454138831717657,99.27807742307694,96.99362317589524,-81.54586116828234
2023-03-01,93.870003,94.68,91.589996,92.169998,92.169998,52299500,6699520214.89932,10248718200,13.001991473367784,24.000000000000004,-0.9329816135675912,40.166937708643275,5.691872710930578,99.07230823076922,96.6363176073104,-94.30812728906943
2023-03-02,91.410004,92.230003,90.389999,92.129997,92.129997,55509400,6748995635.564057,10193208800,13.485452695821897,-76.0,-1.1489245476759748,40.096211914947006,16.14098479972029,98.91115426923078,96.30251608084296,-83.85901520027971
2023-03-03,92.739998,94.940002,92.660004,94.900002,94.900002,55759600,6802798756.654865,10248968400,12.888167188456439,-76.0,-1.084048390095063,47.04926418801843,41.83676640415269,98.82346203846153,96.19862614892867,-58.1632335958473
2023-03-06,95.190002,96.550003,93.739998,93.75,93.75,52112400,6751057336.937676,10196856000,12.146496351958515,-76.0,-1.112603715180171,44.72810750537237,31.168843336627358,98.61307738461538,96.01724643419321,-68.83115666337265
2023-03-07,94.059998,95.089996,92.779999,93.550003,93.550003,49100700,6734690649.495095,10147755300,11.42595644688953,-76.0,-1.1382510528943612,44.318613680367115,29.31358342426562,98.27884680769232,95.83448766129001,-70.68641657573438
2023-03-08,93.599998,94.169998,92.18,93.919998,93.919998,44899100,6768308557.252691,10192654400,10.96042484891552,-76.0,-1.1158583282784775,45.31604682158484,34.47265321731512,98.02384661538461,95.69267361230557,-65.52734678268487
2023-03-09,93.68,96.209999,92.18,92.25,92.25,56218700,6714042864.685199,10136435700,10.548366786535524,-76.0,-1.2188170502656988,41.68633421353334,24.63576504539132,97.6053851923077,95.43766075213478,-75.36423495460868
2023-03-10,92.669998,93.57,90.25,90.730003,90.730003,69827500,6664406575.2168255,10066608200,10.09526805907941,-100.0,-1.4068463845831616,38.65173928469693,7.100633993895215,97.05076984615386,95.08894536308776,-92.89936600610478
2023-03-13,89.970001,94.019997,88.120003,92.43,92.43,72397100,6697782899.3283415,10139005300,10.331267391120964,-100.0,-1.4025180808765185,43.59710616390639,48.481411527717924,96.26307738461539,94.89198644730348,-51.518588472282076
2023-03-14,93.830002,95.07,92.709999,94.879997,94.879997,60912700,6748887471.502888,10199918000,10.157701758863833,-96.0,-1.1877024915806942,49.869077165225804,80.18972716488732,95.93576961538461,94.89109834009581,-19.810272835112684
2023-03-15,93.220001,96.669998,93.07,96.199997,96.199997,70731800,6801150363.058049,10270649800,9.435775171855406,-88.0,-0.9005654630260693,52.907495085254055,94.50290906602858,95.7057695,94.988053796385,-5.497090933971424
2023-03-16,95.75,100.989998,95.610001,100.040001,100.040001,84446900,6855774085.959884,10355096700,10.02530230167608,-88.0,-0.35901259492170823,60.42254838241547,92.61851306080543,95.62615411538461,95.36227210776389,-7.381486939194584
2023-03-17,99.790001,100.660004,97.459999,98.949997,98.949997,87300200,6849771961.056391,10267796500,10.572720350795278,-84.0,-0.01757961170693534,57.6121033071394,84.14917022112283,95.5838461923077,95.62802950718878,-15.850829778877173
2023-03-20,98.410004,98.480003,95.699997,97.709999,97.709999,62388900,6877599998.55782,10205407600,10.434035670539165,-68.0,0.15120798040385353,54.50612141271166,74.51437238320602,95.56346161538461,95.78224946961925,-25.48562761679397
2023-03-21,98.139999,100.849998,98.0,100.610001,100.610001,58597300,6926328396.047643,10264004900,10.960545117470701,-68.0,0.5130649943891825,59.94493998497786,97.04741921034156,95.67884623076922,96.1398606940919,-2.9525807896584495
2023-03-22,100.449997,102.099998,98.610001,98.699997,98.699997,57475400,6871817214.12485,10206529500,11.766212469218663,28.0,0.6383593159516039,55.25921314861176,75.67952635176191,95.6465383846154,96.32950042045546,-24.32047364823809
2023-03-23,100.43,101.059998,97.620003,98.709999,98.709999,57559300,6850734366.423647,10264088800,12.130203847243509,28.0,0.7300475130053456,55.27892711029318,75.75107144172796,95.60846153846154,96.50583364856986,-24.248928558272034
2023-03-24,98.07,98.300003,96.400002,98.129997,98.129997,56095400,6896791293.20979,10207993400,12.007723167412104,28.0,0.7472953994376894,53.79856385408476,71.60227167463225,95.49192280769232,96.6261420449721,-28.397728325367755
2023-03-27,99.07,99.339996,97.080002,98.040001,98.040001,46721300,6889762489.100223,10161272100,12.202425819876169,28.0,0.7451133457942234,53.55889109934342,70.95852323266215,95.487692,96.73087233793713,-29.041476767337862
2023-03-28,98.110001,98.440002,96.290001,97.239998,97.239998,38720100,6885260027.919646,10122552000,12.072331054036983,27.999999999999993,0.6710945362924292,51.368130907441255,65.23603906868351,95.4892305,96.76858534994179,-34.76396093131649
2023-03-29,98.690002,100.419998,98.559998,100.25,100.25,49783300,6925943261.8622265,10172335300,12.546096509098813,28.0,0.8455689102008108,58.28234747663107,86.76681930143752,95.70730734615384,97.02646791661276,-13.233180698562474
2023-03-30,101.550003,103.040001,101.010002,102.0,102.0,53633400,6924622162.245823,10225968700,13.664761682634294,52.0,1.1122303836594938,61.692413272149864,93.02948297982343,95.94615346153847,97.39487770056738,-6.970517020176566
2023-03-31,102.160004,103.489998,101.949997,103.290001,103.290001,56750300,6966632355.260049,10282719000,14.812045399210737,56.0,1.4113842630512323,64.02672855084111,98.14474008763827,96.23346119230769,97.83155350052535,-1.855259912361737
2023-04-03,102.300003,103.290001,101.43,102.410004,102.410004,41135700,6968844105.656903,10241583300,15.639609294694894,56.0,1.5594807410584224,61.283305826407954,89.63537229085843,96.57615365384616,98.17069798196792,-10.364627709141581
2023-04-04,102.75,104.199997,102.110001,103.949997,103.949997,48662500,7005864836.964523,10290245800,16.650573065404817,64.0,1.7805873293425947,64.17615539542905,97.08963776001758,96.96807653846153,98.59879420552585,-2.910362239982417
2023-04-05,103.910004,103.910004,100.75,101.099998,101.099998,45175400,6970696575.973968,10245070400,16.94859366220677,64.0,1.7061770457550693,55.858057028846225,63.5294235294118,97.23230711538461,98.78406856067208,-36.4705764705882
2023-04-06,100.75,102.379997,99.800003,102.059998,102.059998,43808000,7003637483.886156,10288878400,16.798816674699776,64.0,1.7050159740468303,57.84030954567417,74.82354117647056,97.61269173076923,99.02673000062231,-25.176458823529448
2023-04-10,100.959999,102.199997,99.57,102.169998,102.169998,37261200,7040048645.852805,10326139600,16.555373362329714,64.0,1.6934508497848668,58.07264268340821,74.33628285020636,97.99884561538462,99.25956466724287,-25.663717149793644
2023-04-11,100.800003,101.0,99.010002,99.919998,99.919998,60417800,7034887138.903151,10265721800,16.067873703537728,64.0,1.4856040903228092,51.78623427655585,45.8912621447597,98.19192238461538,99.30848565485451,-54.1087378552403
2023-04-12,100.400002,100.510002,97.709999,97.830002,97.830002,56735000,6983015255.267669,10208986800,15.02990997139331,64.0,1.1391078988317531,46.72635109196405,19.469049036181445,98.34884553846155,99.19896834708751,-80.53095096381855
2023-04-13,98.949997,102.57,98.709999,102.400002,102.400002,67925100,7044957387.309992,10276911900,14.861025339526568,64.0,1.2192136416939547,56.69095788097598,77.24404664679986,98.6892301153846,99.43608195100695,-22.755953353200145
2023-04-14,102.07,103.199997,101.110001,102.510002,102.510002,51450500,7062435967.988137,10328362400,14.928089799774678,64.0,1.2768553075638494,56.899929290790766,78.63469210351057,99.01961488461538,99.66377973241384,-21.365307896489426
2023-04-17,103.160004,103.730003,101.589996,102.739998,102.739998,39919500,7065420537.777629,10368281900,15.179765580465718,64.0,1.3258123585153356,57.36316869745145,81.54235476225276,99.42307634615385,99.89164775223503,-18.457645237747247
2023-04-18,103.949997,104.199997,101.519997,102.300003,102.300003,39790500,7048791850.272405,10328491400,15.58352939905281,64.0,1.31396073338027,56.12048368333884,70.72427449130197,99.86807634615386,100.07004443725465,-29.275725508698038
2023-04-19,101.580002,105.120003,101.389999,104.300003,104.300003,58398900,7081514049.657606,10386890300,16.286313904693547,100.0,1.449245520144757,60.3275896663115,88.93387911801408,100.32461492307692,100.38337470116171,-11.066120881985935
2023-04-20,103.529999,105.25,103.209999,103.809998,103.809998,57696900,7057756429.396293,10329193400,16.98548631250243,100.0,1.4996335380355106,58.83910997008336,80.90183277164013,100.6680765,100.6371986492238,-19.098167228359866
2023-04-21,106.099998,108.150002,105.080002,106.959999,106.959999,86774200,7077259255.896228,10415967600,18.551519186675595,100.0,1.7733036199951044,64.8441913419409,88.60150710684658,101.08192273076922,101.10555423076278,-11.39849289315342
2023-04-24,107.660004,109.230003,105.07,106.209999,106.209999,69575600,7045816375.716093,10346392000,20.28976441412168,96.0,1.9076798537811612,62.50594263006975,73.7846966025359,101.31923034615384,101.48366125070628,-26.215303397464098
2023-04-25,104.910004,105.449997,102.449997,102.57,102.57,65026800,6985991849.769693,10281365200,20.42031434315362,96.0,1.7008501468752968,52.5935826577776,42.1874940321201,101.45846123076922,101.564130787691,-57.81250596787991
2023-04-26,105.040001,106.620003,104.099998,104.980003,104.980003,73803800,6963733751.479809,10355169000,20.90501157666312,72.0,1.7116721241214066,57.409405085351125,63.10765169873205,101.73807676923077,101.81715835897315,-36.89234830126795
2023-04-27,108.160004,110.860001,106.800003,109.82,109.82,149961200,7036867426.953343,10505130200,22.411536922107615,84.0,2.0867412729709685,65.08131366367563,92.0912483511409,102.0923075,102.40996144349366,-7.908751648859093
2023-04-28,107.730003,109.480003,104.330002,105.449997,105.449997,130565000,6963091599.295252,10374565200,22.663771039104827,84.0,2.008214112975949,55.38126505659877,58.85929142824465,102.35192288461538,102.63514926249412,-41.14070857175536
2023-05-01,104.949997,105.230003,101.82,102.050003,102.050003,74728100,6898444245.373364,10299837100,21.907519051159813,84.0,1.6525797612650308,49.232969580848625,33.00382768002626,102.48038457692307,102.59180509490196,-66.99617231997374
2023-05-02,101.470001,103.900002,101.150002,103.629997,103.629997,73469400,6957486659.666455,10373306500,20.959682565446673,84.0,1.4811554485426228,51.90507204610109,40.49380403394178,102.69192303846154,102.6687081989833,-59.50619596605823
2023-05-03,103.739998,105.959999,103.279999,103.650002,103.650002,65051900,6910396997.096082,10438358400,20.681339972499917,84.0,1.3315652269106124,51.93956471888908,26.051292307692346,102.9076923076923,102.74139662868824,-73.94870769230765
2023-05-04,104.040001,105.389999,103.309998,104.0,104.0,45345500,6895136565.027299,10483703900,20.422878993335072,44.0,1.2271104466928193,52.58032827575439,29.35116677148989,103.16769238461538,102.83462650804466,-70.64883322851011
2023-05-05,104.269997,105.760002,103.550003,105.660004,105.660004,56912900,6946899077.018798,10540616800,20.294533150111594,44.0,1.263710462799196,55.60365821638333,46.446987275693864,103.37576946153845,103.04391372967099,-53.553012724306136
2023-05-08,105.040001,106.099998,104.699997,105.830002,105.830002,49430900,6977264068.813875,10590047700,20.28177828370416,44.0,1.2915455242751221,55.91365022960524,48.19773925826351,103.52307723076923,103.25029063858426,-51.80226074173649
2023-05-09,105.480003,106.790001,105.160004,106.620003,106.620003,44089400,7012156998.119512,10634137100,20.48948438367802,44.0,1.3616551761519986,57.40218556390674,56.333692722316435,103.65115423076924,103.4998989616521,-43.666307277683565
2023-05-10,108.099998,110.669998,108.050003,110.190002,110.190002,78627600,7061974670.245909,10712764700,21.719149503933398,44.0,1.6858531976948257,63.41387523929709,93.0999066014323,103.95038492307692,103.99546214967786,-6.900093398567706
2023-05-11,111.029999,113.279999,110.489998,112.18,112.18,74924800,7077819057.676021,10787689500,23.39677878970814,84.0,2.07938877357374,66.2713198008799,90.93158060962425,104.2669235,104.60172421266468,-9.068419390375748
2023-05-12,112.160004,112.639999,109.32,110.260002,110.260002,49810100,7056214745.461017,10737879400,24.38478013743072,84.0,2.2108553954324464,61.2970027654231,75.10306886308379,104.61923134615384,105.02085590061544,-24.896931136916216
2023-05-15,111.150002,112.290001,109.25,111.199997,111.199997,53011100,7071211179.647157,10790890500,25.267636388544467,84.0,2.363646732838191,62.77035369845593,82.85241125780982,104.97076976923078,105.4785700561254,-17.147588742190184
2023-05-16,111.050003,114.790001,111.050003,113.400002,113.400002,71472900,7089557174.484587,10862363400,26.627157734526858,96.0,2.631917874875853,66.02979099126145,89.80939074848904,105.402693,106.06534279270872,-10.190609251510963
2023-05-17,114.889999,115.830002,114.220001,115.5,115.5,65655200,7128297674.046016,10928018600,28.09166854220857,100.0,2.9796296599495236,68.8346179427775,97.7520299727521,106.00192384615386,106.76420628954511,-2.2479700272479115
2023-05-18,116.690002,118.599998,116.339996,118.150002,118.150002,73174100,7172331930.538267,11001192700,29.931833928749082,100.0,3.429493700563384,71.97879285127252,97.42122576990849,106.7834623076923,107.60759856439363,-2.578774230091507
2023-05-19,118.160004,118.309998,115.699997,116.25,116.25,54990200,7140517794.432956,10946202500,31.303476723357907,96.0,3.591301621835612,66.7769929687353,86.53295966371569,107.31615453846153,108.24777644851262,-13.467040336284315
2023-05-22,116.769997,116.769997,114.25,115.010002,115.010002,70741100,7112446092.437953,10875461400,31.83543308325469,48.0,3.578230476144796,63.549163869962946,76.5666042145303,107.79692376923077,108.7486820449191,-23.4333957854697
2023-05-23,114.269997,117.139999,113.779999,114.989998,114.989998,67576300,7093540777.809203,10807885100,32.09422422957892,48.0,3.525616234066277,63.49584149289445,76.38979725310662,108.26807761538461,109.21100174529546,-23.610202746893382
2023-05-24,115.349998,117.339996,115.019997,116.75,116.75,63487900,7124737623.331679,10871373000,32.38412034770412,48.0,3.584615306693479,66.18427536201986,87.70765040121276,108.82384673076922,109.76944606045876,-12.292349598787242
2023-05-25,116.629997,116.870003,114.309998,115.0,115.0,66496700,7094086834.564978,10804876300,32.26916187768466,48.0,3.4503881948578794,61.346389738596194,74.10073567620607,109.23538507692307,110.15689450042478,-25.899264323793922
2023-05-26,116.040001,121.5,116.019997,120.110001,120.110001,96779900,7141770424.135914,10901656200,33.23619925139525,72.0,3.7135392474669544,68.57079085664833,91.49327209137626,109.86230826923075,110.89416164854146,-8.506727908623743
2023-05-30,122.370003,122.919998,119.860001,121.660004,121.660004,64314800,7153120295.01265,10965971000,34.393221269492365,76.0,4.001039151961592,70.37923184443599,91.52660105131169,110.42769307692308,111.6916314523532,-8.47339894868832
2023-05-31,121.449997,122.040001,119.169998,120.580002,120.580002,72800800,7151852116.548724,10893170200,35.106430291363054,76.0,4.09453847141512,67.46627323393231,82.88225060457205,110.9803855,112.3500292706974,-17.117749395427946
2023-06-01,120.690002,123.489998,119.93,122.769997,122.769997,54375100,7184232751.172564,10947545300,36.051288519988475,84.0,4.295831972737233,70.16306404942773,94.94381249210852,111.75730846153846,113.12187873212721,-5.056187507891479
2023-06-02,124.919998,126.389999,124.019997,124.25,124.25,61215000,7134899288.525697,11008760300,37.41891818941991,88.0,4.52264812365641,71.86064959558949,87.5145908701628,112.49846219230768,113.9461840112289,-12.485409129837189
2023-06-05,123.360001,125.800003,123.029999,125.300003,125.300003,47950100,7165538908.107618,11056710400,38.17265222429629,88.0,4.732573858722347,73.03291016279609,92.89441796464615,113.09384692307692,114.78720764002675,-7.1055820353538515
2023-06-06,125.07,127.400002,125.0,126.610001,126.610001,45695200,7181151421.763857,11102405600,39.151165079704874,96.0,4.9476143878056575,74.46231856310624,94.19970024969888,113.90769323076924,115.66297011113588,-5.800299750301112
2023-06-07,127.010002,127.370003,120.629997,121.230003,121.230003,95663300,7102520318.465106,11006742300,38.09983653076231,96.0,4.630536735232127,60.32107807999592,54.69898942019318,114.64538553846153,116.0753429177184,-45.30101057980682
2023-06-08,123.010002,125.629997,122.260002,124.25,124.25,62159300,7113771740.25039,11068901600,37.12360287817278,92.0,4.5702558651505,64.40729171661063,76.87223710596832,115.43846257692306,116.68087307196149,-23.12776289403168
2023-06-09,124.080002,125.800003,123.190002,123.43,123.43,51330000,7071881657.966897,11017571600,36.260744539300305,88.0,4.405531469899643,62.52449504370654,70.85168042914532,116.19923173076924,117.18080839996435,-29.14831957085468
2023-06-12,124.019997,126.779999,123.529999,126.57,126.57,51338000,7116585240.328743,11068909600,35.71542263764606,84.0,4.47675273892078,66.5561646957642,93.90600721600423,117.06730865384614,117.87630407404106,-6.0939927839957715
2023-06-13,128.119995,128.410004,125.18,126.660004,126.660004,50564800,7112358529.234639,11119474400,35.61110243074837,100.0,4.488715559505195,66.66686033549237,87.58865776369183,117.87500096153848,118.52694851300097,-12.411342236308172
2023-06-14,126.699997,126.949997,124.120003,126.419998,126.419998,52422500,7145145741.967246,11067051900,35.01232417676775,96.0,4.427788908287795,66.03914770211026,85.88648827525336,118.66692388461539,119.11161884537127,-14.113511724746648
2023-06-15,125.209999,127.690002,124.32,127.110001,127.110001,60458500,7184793577.487818,11127510400,34.65310957044851,92.0,4.384638193991677,67.00112229084931,89.507649188576,119.45500073076923,119.70409159756599,-10.492350811424007
2023-06-16,127.709999,127.900002,125.300003,125.489998,125.489998,84188100,7112909573.035162,11043322300,34.376756707064565,80.0,4.171632258927872,62.52320782131742,68.39822398383731,120.0434621153846,120.13267725700554,-31.601776016162685
2023-06-20,124.970001,127.25,124.5,125.779999,125.779999,56930100,7108976179.267817,11100252400,33.70142880800191,80.0,3.9803412812120342,62.99992920376441,71.53676090686534,120.56653899999999,120.55099738611624,-28.463239093134664
2023-06-21,125.639999,126.730003,123.849998,124.830002,124.830002,52137700,7092321163.881766,11048114700,32.73759221960555,80.0,3.709326181506313,60.29419492465351,57.783015196690926,121.12692361538461,120.86796069084836,-42.216984803309074
2023-06-22,125.309998,130.330002,125.139999,130.149994,130.149994,90354600,7176408117.85659,11138469300,32.88979550719925,100.0,3.8791077167054766,68.46270653258028,98.14424837925326,121.85576965384614,121.55551871374848,-1.8557516207467415
2023-06-23,129.110001,130.839996,128.279999,129.330002,129.330002,71855200,7163496874.092164,11066614100,33.15797961737962,84.0,3.9025086150329713,66.20200420558436,85.2106351822365,122.46846196153845,122.13140636458192,-14.789364817763493
2023-06-26,129.330002,131.490005,127.099998,127.330002,127.330002,59989300,7109793568.149668,11006624800,32.78606202575636,88.0,3.716825459990048,60.91825903130356,61.69429156958258,122.92346203846154,122.51648752276103,-38.30570843041742
2023-06-27,128.630005,130.089996,127.550003,129.179993,129.179993,46801000,7123059790.374295,11053425800,32.440709976391915,88.0,3.676567848945112,63.79661319672293,78.72918693982544,123.34769246153846,123.01008052107503,-21.270813060174557
2023-06-28,128.940002,131.479996,128.440002,129.039993,129.039993,52149500,7091495351.170139,11001276300,32.53155021981494,88.0,3.5919606853179573,63.41597522768675,73.45599996013016,123.83961526923078,123.45674070469909,-26.544000039869843
2023-06-29,128.770004,129.259995,127.260002,127.900002,127.900002,40761000,7076821482.475099,10960515300,31.965248277691945,88.0,3.3937995436121184,60.262981073589714,56.74696744085514,124.3353845,123.78587117101767,-43.25303255914486
2023-06-30,129.470001,131.25,128.949997,130.360001,130.360001,54310500,7089100480.177493,11014825800,32.03235774957768,80.0,3.3961085460521474,64.37875724377716,85.80398054976358,124.92653846153847,124.27284375094229,-14.196019450236424
2023-07-03,130.820007,131.850006,130.070007,130.220001,130.220001,28264800,7065599222.641505,10986561000,32.26009689896627,100.0,3.3480474106869025,63.97266128142805,79.624957875042,125.44461542307694,124.71337391753916,-20.375042124957996
2023-07-05,130.240005,131.399994,129.639999,130.380005,130.380005,35895400,7059888921.317809,11022456400,32.22093761099957,96.0,3.2850021404071583,64.25021497097566,81.62500587499419,126.03615407692308,125.13312436809181,-18.37499412500581
2023-07-06,128.25,128.729996,127.370003,128.360001,128.360001,40639900,7078416119.560521,10981816500,30.975120302845056,88.0,3.037031855824381,58.158569612837475,56.37498112501896,126.35346176923078,125.37215226675167,-43.62501887498104
2023-07-07,128.589996,130.970001,128.130005,129.779999,129.779999,41928700,7085207279.32638,11023745200,30.54994061951911,88.0,2.9214192869253424,60.96066325039421,74.1249383750616,126.66576926923078,125.69865943217748,-25.875061624938397
2023-07-10,129.070007,129.279999,125.919998,127.129997,127.129997,61889300,7067892960.768766,10961855900,29.143828554623983,84.0,2.586150940501028,53.729149159558126,40.999946500053504,126.91769215384616,125.80468443720136,-59.000053499946496
2023-07-11,127.75,129.770004,127.349998,128.779999,128.779999,49951500,7076974946.596074,11011807400,28.00578156371129,68.0,2.4256285956899433,57.138486740330784,61.624950875049116,127.14884607692308,126.02507810851978,-38.375049124950884
2023-07-12,130.309998,131.259995,128.830002,130.800003,130.800003,54022800,7110544966.841071,11065830200,27.441076341343926,68.0,2.433360654932656,60.933549133268464,84.35168547514179,127.40076926923078,126.37877624862942,-15.648314524858217
2023-07-13,134.039993,134.669998,132.710007,134.300003,134.300003,61170900,7148620937.175068,11127001100,27.850508963402852,96.0,2.690890209553757,66.47277996164682,95.77148571428583,127.74692311538462,126.96553378576799,-4.228514285714164
2023-07-14,134.059998,136.649994,134.059998,134.679993,134.679993,54388100,7120271757.744443,11181389200,28.67374148217497,100.0,2.892305556227811,67.01953288577455,81.64024478667095,128.05730742307694,127.53697520904443,-18.359755213329056
2023-07-17,134.559998,135.619995,133.210007,133.559998,133.559998,48450200,7085893938.144844,11132939000,29.02856039953935,96.0,2.927804525203456,63.72111601820508,71.20226326272638,128.531538,127.98312504541151,-28.797736737273613
2023-07-18,132.710007,133.860001,131.350006,132.830002,132.830002,54969100,7095748910.004429,11077969900,28.514277979518145,92.0,2.864018514854422,61.5933349259286,64.39894292598069,128.8615380769231,128.34215296797362,-35.60105707401932
2023-07-19,133.389999,135.990005,132.529999,135.360001,135.360001,54531000,7130421708.53079,11132500900,28.58556565037224,88.0,2.983228614839021,65.84955862372104,87.97769356111611,129.32038426923077,128.86199356293855,-12.022306438883883
2023-07-20,134.070007,134.789993,129.330002,129.960007,129.960007,59820600,7084405994.6937895,11072680300,27.38245919872593,64.0,2.6118611818943123,52.48117233629997,37.65154246096633,129.45076915384618,128.94332789160978,-62.34845753903367
2023-07-21,131.339996,131.369995,128.419998,130.0,130.0,133265000,7093892981.580557,11205945300,25.943424558154046,64.0,2.2943293164032355,52.55799061690034,38.02426394194367,129.57923053846156,129.0215998996387,-61.97573605805633
2023-07-24,130.309998,131.660004,128.350006,128.800003,128.800003,45591100,7060698178.029497,11160354200,24.69763031426558,64.0,1.923678329862895,49.948805846388474,26.840690341357078,129.6707691923077,129.00518531448026,-73.15930965864293
2023-07-25,129.309998,129.580002,128.529999,129.130005,129.130005,39236700,7066303741.185317,11199590900,23.540821373512006,64.0,1.6376849434867324,50.67401445084302,29.91619940958048,129.74846165384616,129.01443121711134,-70.08380059041953
2023-07-26,126.510002,129.080002,126.110001,128.149994,128.149994,53910100,7086451681.320186,11145680800,22.156430172265512,64.0,1.316775459078201,48.429820310139675,20.78282228623374,129.8507691923077,128.95039883065863,-79.21717771376626
2023-07-27,131.0,132.630005,127.790001,128.25,128.25,52610700,7043841332.30721,11198291500,21.434812717619213,64.0,1.0583223478284367,48.67959302524154,21.714845000874153,129.94576923076923,128.89851743579504,-78.28515499912585
2023-07-28,129.690002,133.009995,129.330002,132.210007,132.210007,46317400,7070020996.071733,11244608900,20.875468625066425,60.0,1.1596679347657641,57.46475660529786,57.874858171158145,130.2296155769231,129.1438129590695,-42.12514182884186
2023-07-31,133.199997,133.869995,132.380005,133.679993,133.679993,41901500,7101236023.272588,11286510400,20.61028110355645,16.000000000000007,1.343117999348948,60.18911078404115,71.8216036765869,130.3653847692308,129.47982629543472,-28.178396323413097
2023-08-01,133.550003,133.690002,131.619995,131.690002,131.690002,42098500,7061985039.913353,11244411900,20.048329641425692,16.0,1.3127947736024623,55.048846320905305,52.941221118458024,130.456154,129.6435430142914,-47.05877888154197
2023-08-02,130.149994,130.229996,126.82,128.210007,128.210007,51027600,7052557911.698774,11193384300,19.35045650220059,16.0,0.9964701976061576,47.421779150177834,19.924168830093098,130.49000034615386,129.53735516138093,-80.0758311699069
2023-08-03,127.480003,129.839996,126.410004,128.910004,128.910004,88585200,7093105957.4906,11281969500,18.82058541701261,15.999999999999996,0.7931219833913588,48.953835390874474,28.340099862307643,130.47961615384617,129.49088470498234,-71.65990013769236
2023-08-04,141.059998,143.630005,139.320007,139.570007,139.570007,152938700,6957909574.30838,11434908200,19.825282913129918,76.0,1.4751357644664722,65.45976378650698,76.8265007245432,130.88461669230767,130.23748635646513,-23.17349927545681
2023-08-07,140.990005,142.539993,138.949997,142.220001,142.220001,71213100,7016427605.960003,11506121300,20.649650492629288,76.0,2.20406191471659,68.2115718622827,91.95203380090545,131.43538588461539,131.125080033764,-8.047966199094553
2023-08-08,140.619995,140.839996,138.419998,139.940002,139.940002,51710500,7029675975.216919,11454410800,21.25244961571499,76.0,2.5681601245738648,63.52241976060881,78.9383438496931,131.80384746153845,131.77803721644815,-21.061656150306902
2023-08-09,139.970001,140.320007,137.100006,137.850006,137.850006,50017300,7002958652.4529505,11404393500,21.402466335373642,76.0,2.6574321451221863,59.48556316466591,67.00914566001241,132.09730919230768,132.22781268189644,-32.990854339987585
2023-08-10,139.070007,140.410004,137.490005,138.559998,138.559998,58928400,6987217236.764384,11463321900,21.55957199503766,76.0,2.753728022815352,60.406091885459084,71.06161048821679,132.41192430769232,132.6968634462004,-28.938389511783214
2023-08-11,137.399994,139.330002,137.0,138.410004,138.410004,42832100,6996224948.342571,11420489800,21.540255846975505,76.0,2.7858266617736263,60.095439873865686,70.20548054669382,132.7984628846154,133.12005904277817,-29.79451945330618
2023-08-14,138.300003,140.589996,137.75,140.570007,140.570007,47148700,7042709946.447005,11467638500,21.799289020361048,76.0,2.9515357873190453,63.04295360640493,82.53426197847898,133.2134631923077,133.6719070396094,-17.465738021521027
2023-08-15,140.050003,141.279999,137.229996,137.669998,137.669998,42781500,7009224215.147917,11424857000,22.190731084854722,28.0,2.8163893895290357,56.959766378045835,65.38904382177438,133.61884784615384,133.96806192556429,-34.61095617822563
2023-08-16,137.190002,137.270004,135.009995,135.070007,135.070007,41675900,6969761628.555784,11383181100,21.74411095283924,28.0,2.471003164599182,52.105379582614184,50.29037454759729,133.86077123076922,134.04968748663362,-49.70962545240271
2023-08-17,135.460007,136.089996,133.529999,133.979996,133.979996,48354100,6938406923.428278,11334827000,20.831462023715748,28.0,2.085289396752728,50.1747664439252,43.96046202320194,133.98307865384615,134.0445251542904,-56.03953797679806
2023-08-18,131.619995,134.070007,131.149994,133.220001,133.220001,48469400,6958657763.568168,11286357600,19.43703858737435,28.0,1.6987016367961019,48.816625061599055,39.54701860934847,133.9415401153846,133.98344929100963,-60.45298139065154
2023-08-21,133.740005,135.190002,132.710007,134.679993,134.679993,41442500,6983055029.216888,11327800100,18.285222543424688,28.000000000000004,1.4929276637611792,51.530871390010894,48.025485015941584,133.9415401153846,134.03504512130522,-51.974514984058416
2023-08-22,135.080002,135.649994,133.729996,134.25,134.25,32935100,6967959930.86314,11294865000,17.35225996136021,28.0,1.2803938824516194,50.678479113652116,45.52842941182172,133.96807865384613,134.05096770491224,-54.47157058817828
2023-08-23,134.5,135.949997,133.220001,135.520004,135.520004,42801000,6997278031.699185,11337666000,16.31255952917015,28.0,1.2005982887481252,53.143767727254755,35.01607490570322,134.07154026923078,134.15978520825206,-64.98392509429678
2023-08-24,136.399994,136.779999,131.830002,131.839996,131.839996,43646300,6953807974.683656,11294019700,15.413258012456351,28.0,0.8308364499348784,45.973044896583644,6.057963657415773,133.93615546153845,133.98794897060375,-93.94203634258423
2023-08-25,132.470001,133.869995,130.580002,133.259995,133.259995,44147500,6981584634.380957,11338167200,14.976099514759472,28.0,0.6449450554238183,48.841526889049454,25.046670573832845,134.06307807692306,133.93402645426272,-74.95332942616716
2023-08-28,133.779999,133.949997,131.850006,133.139999,133.139999,34108400,6989380792.296871,11304058800,14.539157054613918,28.0,0.48238151778213023,48.60667128343413,23.925212315479925,134.18384726923074,133.8752096057988,-76.07478768452008
2023-08-29,133.380005,135.139999,133.25,134.910004,134.910004,38646100,7018621162.696485,11342704900,13.668258629240269,28.0,0.4907166775467715,52.253736237775335,40.46731975719227,134.41884730769232,133.9518610424063,-59.53268024280773
2023-08-30,134.929993,135.679993,133.919998,135.070007,135.070007,36137000,7029709155.077713,11378841900,12.731990238756383,28.000000000000004,0.504418632604029,52.58132161831067,41.96267531663792,134.6473089230769,134.03468666889472,-58.03732468336208
2023-08-31,135.059998,138.789993,135.0,138.009995,138.009995,58781300,7064295531.004027,11437623200,12.926494816229752,4.0,0.743934379357114,58.24956212372471,69.4392063848242,135.02653973076923,134.3291539526803,-30.560793615175793
2023-09-01,139.460007,139.960007,136.880005,138.119995,138.119995,40948300,7056318302.137747,11478571500,13.452613285052893,4.0,0.9318862108091537,58.44968876916258,70.4672440562365,135.4061549230769,134.60995699322248,-29.532755943763497
2023-09-05,137.729996,137.800003,135.820007,137.270004,137.270004,40636700,7075199998.225314,11437934800,13.486880818657236,4.0,1.0007165834760485,56.20763750676485,71.32194492433645,135.6007701923077,134.80699751224304,-28.678055075663554
2023-09-06,136.320007,137.449997,134.610001,135.360001,135.360001,41785500,7055484335.64762,11396149300,13.022057047196567,4.0,0.8908744243577758,51.433309922277274,50.95945044805426,135.66538588461538,134.84796073355838,-49.04054955194574
2023-09-07,133.899994,138.029999,133.160004,137.850006,137.850006,48498900,7100398237.097232,11444648200,12.151262045595209,4.0,0.9932962150843991,56.607926114443046,77.50533182018575,135.9023091153846,135.0703344569985,-22.49466817981426
2023-09-08,136.860001,138.850006,136.75,138.229996,138.229996,38348200,7116102437.525802,11482996400,11.5305641799049,4.0,1.092534185424796,57.354663363691785,81.55639575885094,136.2876933076923,135.3043834601838,-18.443604241149057
2023-09-11,138.75,143.619995,138.639999,143.100006,143.100006,56764500,7161012745.03629,11539760900,12.40597239696469,-60.0,1.5463250261709902,65.53967263706241,96.01235215387015,136.8334626153846,135.88183698165167,-3.98764784612984
2023-09-12,142.320007,143.0,140.610001,141.229996,141.229996,42668500,7140481707.568701,11497092400,13.218851455663067,39.99999999999999,1.7350626361439936,60.72040497644086,81.67177697104597,136.89730834615386,136.27799690893673,-18.32822302895402
2023-09-13,140.949997,144.979996,140.869995,144.850006,144.850006,60465200,7197122153.585429,11557557600,14.474647099945201,48.0,2.151936915910369,65.94140851826899,99.09729129053808,136.99846238461538,136.9129605453118,-0.9027087094619092
2023-09-14,145.080002,145.860001,142.949997,144.720001,144.720001,64033600,7210985166.878331,11493524000,15.849277659923672,52.0,2.443653552013245,65.60415746290302,92.53926652743881,137.1823085,137.49125983825166,-7.460733472561186
2023-09-15,142.690002,143.570007,140.089996,140.389999,140.389999,102861700,7125858364.029574,11390662300,15.896814069156234,52.0,2.29894530335298,55.43486343180663,60.95643146196682,137.28000053846154,137.70598125764042,-39.04356853803318
2023-09-18,140.479996,141.75,139.220001,139.979996,139.979996,42823500,7108762657.504987,11347838800,15.604357763013924,52.0,2.1266642959598414,54.572252528602114,53.70073709466231,137.33461584615384,137.87442679411149,-46.29926290533769
2023-09-19,138.699997,138.839996,135.559998,137.630005,137.630005,61482500,7124883378.834695,11286356300,14.883416086679807,52.0,1.7799871386465895,49.7899454467357,35.196866581937115,137.30461588461537,137.85632147602917,-64.80313341806288
2023-09-20,138.550003,139.369995,135.199997,135.289993,135.289993,46263700,7080616585.281749,11240092600,14.036256358915901,52.0,1.3014216035590493,45.51296488540458,16.77157089092241,137.10153842307693,137.66622307039736,-83.2284291090776
2023-09-21,131.940002,132.240005,129.309998,129.330002,129.330002,70234800,7011340811.618,11169857800,14.774207606855592,-20.0,0.4362052030937491,36.83418144229476,0.12087006872445961,136.78076934615385,137.0487252133309,-99.87912993127553
2023-09-22,131.110001,132.029999,128.520004,129.119995,129.119995,59904300,6971916336.154103,11109953500,15.625903207282494,-24.0,-0.2633945887590414,36.56956527679332,3.4601563079854527,136.55192273076923,136.46141186419527,-96.53984369201454
2023-09-25,129.360001,131.779999,128.770004,131.270004,131.270004,46017800,7002340191.3728,11155971300,16.416763407678904,-24.0,-0.6370017466065576,41.22489009872296,15.859287634248139,136.44769226923077,136.07686313351414,-84.14071236575187
2023-09-26,130.119995,130.389999,125.279999,125.980003,125.980003,73048200,6949305311.213426,11082923100,17.86500279977987,-32.0,-1.344449009916076,34.51312504358714,3.4013796500116595,136.16923080769232,135.32894756806866,-96.59862034998834
2023-09-27,125.760002,127.480003,124.129997,125.980003,125.980003,66553400,6956258758.258118,11149476500,19.41848467690068,-36.0,-1.8833954525669583,34.51312504358715,8.513601746230663,135.83461580769233,134.63643315561913,-91.48639825376934
2023-09-28,124.040001,126.580002,123.040001,125.980003,125.980003,54555000,6992320573.965232,11204031500,21.055046697164048,-40.0,-2.2841837429336636,34.51312504358715,12.883444347063943,135.516539,133.99521610705474,-87.11655565293606
2023-09-29,128.199997,129.149994,126.32,127.120003,127.120003,62377600,6965209668.617447,11266409100,21.532455242830604,-39.99999999999999,-2.4812209078314424,37.262340029009074,17.879062226117405,135.19346203846152,133.48594106208773,-82.12093777388259
2023-10-02,127.279999,130.470001,126.540001,129.460007,129.460007,48029700,6988552493.898973,11314438800,21.486126017150784,-40.0,-2.4206517474769385,42.59002150771753,28.133242769500374,135.101924,133.18772372415532,-71.86675723049963
2023-10-03,128.059998,128.520004,124.25,124.720001,124.720001,51565000,6948339053.084867,11262873800,21.958057099528073,-40.0,-2.723731638965802,35.933382424633606,7.361963190184015,134.7734626923077,132.5604850038475,-92.63803680981599
2023-10-04,126.059998,127.360001,125.68,127.0,127.0,44203900,6973598383.166277,11307077700,22.396278818878415,-40.0,-2.748267455500212,40.73191548325786,19.288835083633177,134.53730888461538,132.14859722578473,-80.71116491636683
2023-10-05,126.709999,126.730003,124.330002,125.959999,125.959999,39660600,6987809976.568029,11267417100,23.104423418215738,-40.0,-2.8191344290756035,39.28646431588833,15.606617616601653,134.1930779230769,131.69018254239327,-84.39338238339835
2023-10-06,124.160004,128.449997,124.129997,127.959999,127.959999,46795900,7023990183.323492,11314213000,23.058136454023977,-40.0,-2.682985939095346,43.44303890623571,30.1285964955039,133.9196160769231,131.41387265036414,-69.8714035044961
2023-10-09,126.220001,128.789993,124.760002,128.259995,128.259995,38773700,7052565357.593484,11352986700,22.87864459302253,-40.0,-2.52181025105844,44.06166712177438,31.96568228990166,133.5446160769231,131.1802520836705,-68.03431771009834
2023-10-10,128.820007,130.740005,128.050003,129.479996,129.479996,42178600,7055230666.817195,11395165300,21.95493679407832,-40.0,-2.2694724071428425,46.61884551536489,69.99991521742818,133.21230842307693,131.0543071885838,-30.00008478257182
2023-10-11,129.740005,132.050003,129.610001,131.830002,131.830002,40741800,7088625557.47712,11435907100,20.627545951188488,-40.0,-1.8584440176688588,51.242510033046464,97.55825803368306,133.0030775769231,131.11176606350352,-2.4417419663169477
2023-10-12,132.169998,134.479996,131.229996,132.330002,132.330002,55528600,7070685753.275028,11491435700,19.701304066058462,-40.0,-1.4753483391046984,52.19134481650881,81.20633793983308,132.88653915384617,131.20200576250326,-18.793662060166923
2023-10-13,132.979996,133.309998,128.949997,129.789993,129.789993,45786600,7042541608.33575,11445649100,18.49543769615909,-40.00000000000001,-1.3610108662797415,47.169529510716416,59.00345236164884,132.57653865384617,131.09741222454005,-40.99654763835117
2023-10-16,130.690002,133.070007,130.429993,132.550003,132.550003,42832900,7068500901.353665,11488482000,17.375704638395394,-40.0,-1.0357483919435992,52.51602715716568,83.12942444467853,132.35807738461537,131.2050115412408,-16.870575555321455
2023-10-17,130.389999,132.580002,128.710007,131.470001,131.470001,49344600,7089539234.630013,11439137400,16.88070204499938,-40.0,-0.8552637252478235,50.36800745860157,73.68884339547348,131.9107695,131.22464039003776,-26.311156604526527
2023-10-18,129.899994,130.669998,127.510002,128.130005,128.130005,42699500,7063595336.914637,11396437900,16.7772326545589,-40.0,-0.9705501917938761,44.32930797493566,38.64742402390579,131.40692369230769,130.99540813892384,-61.35257597609421
2023-10-19,130.570007,132.240005,127.470001,128.399994,128.399994,60961400,7026404850.008294,11457399300,16.08135369235724,-40.0,-1.028276361403556,44.904338442382446,41.256013647923936,130.7742309230769,130.80315523974429,-58.743986352076064
2023-10-20,128.050003,128.169998,124.970001,125.169998,125.169998,56343300,6977104363.467244,11401056000,16.171672131836825,-36.0,-1.3194486668082277,39.6304189372671,10.048319811431904,130.02230773076923,130.38588433309656,-89.9516801885681
2023-10-23,124.629997,127.879997,123.980003,126.559998,126.559998,48260000,6992696030.26468,11449316000,16.522176678112725,-32.0,-1.4216554739850267,42.746744892968756,24.57139733331247,129.4903846153846,130.10248534545977,-75.42860266668754
2023-10-24,127.739998,128.800003,126.339996,128.559998,128.559998,46477400,7030104506.162432,11495793400,16.473649742237434,-24.000000000000004,-1.3259866707875574,46.987135512269795,43.619029079352806,129.05115392307692,129.98822702357387,-56.380970920647194
2023-10-25,126.040001,126.339996,120.790001,121.389999,121.389999,74577500,6971651831.804617,11421215900,17.746990396309627,-100.0,-1.8078872532306889,36.53905004067431,4.38274813102561,128.4265383076923,129.35132124404987,-95.61725186897438
2023-10-26,120.629997,121.639999,118.349998,119.57,119.57,100419500,6945707683.537944,11320796400,19.370841938256433,-40.0,-2.310027091290337,34.4453017120437,7.563559524309884,127.8219231923077,128.6267789296758,-92.4364404756901
2023-10-27,126.199997,130.020004,125.519997,127.739998,127.739998,125309300,6944036756.237942,11446105700,18.28858818814073,-39.99999999999999,-2.025378667077362,48.66566394113401,58.21451434773891,127.7607691923077,128.56109145340352,-41.78548565226109
2023-10-30,129.720001,133.0,128.559998,132.710007,132.710007,72485500,7007053662.48438,11518591200,17.350561862216455,-40.0,-1.3828143271147297,55.053099002813056,89.02672523579972,127.89884657692308,128.86841853092918,-10.973274764200278
2023-10-31,132.75,133.570007,131.710007,133.089996,133.089996,51589400,7032015665.190402,11570180600,16.602791853983412,-40.0,-0.8333096467780479,55.50891553549423,91.38251598047324,127.96884626923078,129.18112797308257,-8.617484019526762
2023-11-01,133.960007,137.350006,133.710007,137.0,137.0,61529400,7081712282.172384,11631710000,16.673276518088418,16.0,-0.08138047959943151,60.00362674313763,98.15786393353093,128.3926923076923,129.76030367878016,-1.8421360664690638
2023-11-02,138.729996,138.809998,136.470001,138.070007,138.070007,52236700,7100910745.055243,11683946700,17.00742910340623,20.0,0.5940219104077755,61.160010558812395,96.38323069403712,128.85769246153845,130.37583725812976,-3.6167693059628694
2023-11-03,138.990005,139.490005,137.449997,138.600006,138.600006,44007200,7106519699.565226,11727953900,17.443460330405927,24.0,1.1586929691266903,61.74992201692329,95.78997774220231,129.3430771923077,130.98503494271276,-4.210022257797687
2023-11-06,138.759995,140.729996,138.360001,139.740005,139.740005,44970400,7113920154.256143,11772924300,18.079591467797137,28.0,1.6788346821500681,63.04990420216127,95.57644732586658,129.8284618846154,131.63355124325255,-4.423552674133409
2023-11-07,140.550003,143.369995,140.5,142.710007,142.710007,53553500,7142843181.131276,11826477800,19.133448925795516,32.0,2.3041443355769218,66.26654695341956,97.36215795709329,130.33807726923078,132.45402944745607,-2.6378420429067146
2023-11-08,142.970001,143.119995,141.220001,142.080002,142.080002,44521700,7138625510.008947,11781956100,20.112030851079727,32.0,2.7175444419873998,64.97443043074773,94.8441520596506,131.00576961538462,133.1670644513482,-5.155847940349401
2023-11-09,142.020004,142.649994,139.839996,140.600006,140.600006,36235400,7121991025.279349,11745720700,20.539952656803337,32.0,2.892401887841885,61.91993781545129,88.92889955182655,131.52884676923077,133.7176527142113,-11.071100448173445
2023-11-10,140.460007,143.649994,139.910004,143.559998,143.559998,49287800,7168906784.2584915,11795008500,21.138084261466968,43.99999999999999,3.2325613353023357,65.42117483092815,99.6442845287407,132.20576980769232,134.44671532797344,-0.3557154712593042
2023-11-13,142.080002,143.229996,140.669998,142.589996,142.589996,35680600,7186747070.320746,11759327900,21.693492180083204,44.0,3.384850642169596,63.36509153547057,95.81028392257461,132.768462,135.04992130367913,-4.189716077425385
2023-11-14,145.0,147.259995,144.679993,145.800003,145.800003,56674600,7179278725.777913,11816002500,22.975669237890095,52.0,3.721660764163431,67.05510939934224,94.9498714925498,133.4430776923077,135.84622365155474,-5.050128507450206
2023-11-15,147.059998,147.289993,142.589996,143.199997,143.199997,63875700,7131983564.393448,11752126800,23.390747382133412,56.0,3.735723363854703,61.63952079512589,81.21269291919019,133.97077003846155,136.39094760329144,-18.78730708080981
2023-11-16,140.910004,143.320007,139.520004,142.830002,142.830002,49653500,7168831567.520156,11702473300,22.76869052989023,56.0,3.6746534534834154,60.88592770724244,76.18797549065015,134.39384696153846,136.86791459564023,-23.81202450934985
2023-11-17,142.660004,145.229996,142.539993,145.179993,145.179993,49636700,7216622928.381055,11752110000,22.60768042504708,56.0,3.7723939344918733,63.904398405525114,86.45698397931801,134.8880773846154,137.4836241070743,-13.54301602068199
2023-11-20,145.130005,146.630005,144.729996,146.130005,146.130005,41951200,7236494654.02067,11794061200,22.74886733536363,56.0,3.8817654232080088,65.07768610401754,91.45810606873971,135.51653938461538,138.12409676580953,-8.541893931260288
2023-11-21,143.910004,144.050003,141.5,143.899994,143.899994,71226000,7299340631.69599,11722835200,21.87566699348943,56.0,3.745326077635667,60.136292171181644,68.66911731542858,135.9530775,138.55194100537918,-31.33088268457142
2023-11-22,144.570007,147.740005,144.570007,146.710007,146.710007,45669100,7315332058.926606,11768504300,21.844042062487087,76.0,3.8199079570005097,63.860123848066564,89.99030904543508,136.5392315769231,139.1562421901659,-10.009690954564915
2023-11-24,146.699997,147.199997,145.320007,146.740005,146.740005,22378400,7326759459.216182,11790882700,21.81467605512777,76.0,3.8372023416082754,63.89889435761432,89.33902373602398,137.2550008076923,139.71800239830176,-10.660976263976023
2023-11-27,147.529999,149.259995,146.880005,147.729996,147.729996,53762400,7311398528.24622,11844645100,22.197988627685024,84.0,3.8859969125504676,65.22478675305777,84.29157686079994,137.99846242307692,140.31148340583496,-15.708423139200058
2023-11-28,146.979996,147.600006,145.529999,147.029999,147.029999,42711700,7330587633.412579,11801933400,22.10788624660381,84.0,3.8241011956242517,63.45030671440042,77.10474270458772,138.8392316923077,140.80915122762497,-22.895257295412275
2023-11-29,147.850006,148.539993,145.970001,146.320007,146.320007,40610900,7301038292.098676,11761322500,22.224755377553674,84.0,3.6753903610453165,61.61918849123604,69.81529038373856,139.59923203846154,141.2173627663194,-30.184709616261436
2023-11-30,144.759995,146.929993,144.330002,146.089996,146.089996,65814000,7324326327.541107,11695508500,21.780440489065967,84.0,3.4986457771325377,61.0049632451249,67.45377896139752,140.27346273076924,141.57829856140685,-32.54622103860249
2023-12-01,146.0,147.25,145.550003,147.029999,147.029999,39924600,7353917436.453064,11735433100,21.44569447186942,84.0,3.3952860629315467,62.64381446651017,77.10474270458772,141.25961657692307,141.98212822352485,-22.895257295412275
2023-12-04,145.25,145.350006,142.809998,144.839996,144.839996,48294200,7382817583.409137,11687138900,20.241260955587297,80.0,3.1009124171851,56.66835936004978,54.62009153807238,142.2315395,142.1938221328934,-45.37990846192762
2023-12-05,143.550003,148.570007,143.130005,146.880005,146.880005,46822400,7400548100.852918,11733961300,19.934644574947814,76.0,2.9976755218887945,60.45263214006632,75.56476181548842,142.9676936153846,142.5409467897161,-24.435238184511583
2023-12-06,147.580002,147.850006,144.279999,144.520004,144.520004,39679000,7366204193.13425,11694282300,19.649929364354012,72.0,2.6943681820197014,54.52060961740446,51.33474969330052,143.42192426923077,142.6875436201075,-48.66525030669948
2023-12-07,146.149994,147.919998,145.339996,146.880005,146.880005,52352800,7376350401.410368,11746635100,19.403524063028147,68.0,2.614291363808661,58.86730698329815,69.33000601160192,143.95230923076923,142.99809631491436,-30.669993988398076
2023-12-08,145.479996,147.839996,145.399994,147.419998,147.419998,41858000,7403798350.6940155,11788493100,19.174719140368413,64.0,2.564836986420403,59.813725315801605,76.2886831756978,144.35307838461537,143.3256445878837,-23.71131682430221
2023-12-11,145.660004,146.190002,143.639999,145.889999,145.889999,50907300,7442727356.7689495,11737585800,18.29580903517101,60.0,2.374810565544493,55.889837798415485,56.572188513007895,144.6538473076923,143.51559676655896,-43.427811486992105
2023-12-12,145.520004,147.5,145.300003,147.479996,147.479996,44944300,7486854323.129677,11782530100,17.881935176450817,56.00000000000001,2.3257034658206805,58.906836445150404,72.40310344330385,144.9953853846154,143.8092559690361,-27.596896556696144
2023-12-13,148.119995,149.460007,146.820007,148.839996,148.839996,52766200,7514835959.1689205,11835296300,18.052513970349587,72.0,2.3692155276801543,61.34239561426615,90.67653893400778,145.34538503846153,144.18190337873713,-9.323461065992216
2023-12-14,149.929993,150.539993,145.520004,147.419998,147.419998,58400800,7500642893.327381,11776895500,17.69859945800493,76.0,2.2630303735508903,57.5097050627102,59.63781347853374,145.52653853846152,144.42176223957142,-40.36218652146626
2023-12-15,148.380005,150.570007,147.880005,149.970001,149.970001,110039100,7561593464.594242,11886934600,17.379154787885522,80.0,2.357466399534502,62.09038586346305,92.2679728850829,145.83000003846155,144.83274288849205,-7.732027114917107
2023-12-18,150.559998,154.850006,150.050003,154.070007,154.070007,62512800,7603789643.33913,11949447400,18.23071573369885,84.0,2.7316550307235445,68.05371904675229,93.52160729461305,146.348077,145.51698467452968,-6.478392705386937
2023-12-19,154.399994,155.119995,152.690002,153.789993,153.789993,43171300,7599703263.714046,11906276100,19.084212538357,88.0,2.971355490706742,67.27536761762994,89.1957569120449,146.74153834615385,146.129800106046,-10.804243087955108
2023-12-20,152.899994,155.630005,151.559998,152.119995,152.119995,50322100,7563228916.326608,11855954000,19.383490276751246,92.0,2.9920741816826535,62.67157885978467,72.62084178269153,147.10807676923076,146.5735182463389,-27.379158217308472
2023-12-21,153.300003,153.970001,152.100006,153.839996,153.839996,36305700,7594486557.344098,11892259700,19.661391033831617,92.0,3.111417119835494,65.30501867987746,86.03737891874788,147.41730726923078,147.1117758577212,-13.962621081252118
2023-12-22,153.770004,154.350006,152.710007,153.419998,153.419998,29480100,7590531601.785162,11862779600,20.03052680177432,92.0,3.1359575628915763,64.11555714082877,82.31994399999985,147.81038423076922,147.57905157196407,-17.68005600000015
2023-12-26,153.559998,153.979996,153.029999,153.410004,153.410004,25067200,7585518488.97912,11837712400,20.373295729149685,80.0,3.118649755452452,64.08564541892224,81.48457140054792,148.2173073846154,148.01097397404078,-18.515428599452083
2023-12-27,153.559998,154.779999,153.119995,153.339996,153.339996,31434700,7562415895.931514,11806277700,20.944776605716562,80.0,3.0639646555448223,63.860892166774725,80.90068512059132,148.53115365384613,148.40571634633406,-19.09931487940868
2023-12-28,153.720001,154.080002,152.949997,153.380005,153.380005,27057000,7555951241.020253,11833334700,21.37754257654484,80.0,2.989394829058284,63.938728249304276,81.23437135894682,148.80999980769232,148.77418217253154,-18.76562864105319
2023-12-29,153.100006,153.889999,151.029999,151.940002,151.940002,39789000,7541482597.220952,11793545700,20.73679601687855,48.0,2.7820319641009235,59.01225491539693,69.22434400783443,149.11923088461538,149.00868734493662,-30.77565599216557
2024-01-02,151.539993,152.380005,148.389999,149.929993,149.929993,47339400,7530685694.632535,11746206300,19.537071492815244,48.0,2.4275215147571316,52.88679527920509,44.82080448774346,149.24307649999997,149.07693220827463,-55.17919551225654
2024-01-03,149.199997,151.050003,148.330002,148.470001,148.470001,49425500,7486348075.537357,11696780800,18.447377225771707,48.0,2.0056405015703263,48.91509445872228,29.178998102967476,149.3096148076923,149.03197434099502,-70.82100189703252
2024-01-04,145.589996,147.380005,144.050003,144.570007,144.570007,56039800,7447810319.175289,11640741000,18.89954381288905,48.0,1.3411400097393766,40.2250168324404,4.490534630304898,149.18807676923078,148.70145824166207,-95.5094653696951
2024-01-05,144.690002,146.589996,144.529999,145.240005,145.240005,45124800,7433791271.998035,11685865800,19.319412786640868,48.0,0.8586834533506078,42.12718800262849,10.276354010992328,149.11923084615384,148.44505429783524,-89.72364598900766
2024-01-08,146.740005,149.399994,146.149994,149.100006,149.100006,46757100,7471916637.281236,11732622900,18.45982729002558,48.00000000000001,0.7788251661132506,51.66943399392388,43.609690222851434,149.22615388461537,148.4935692387363,-56.390309777148566
2024-01-09,148.330002,151.710007,148.210007,151.369995,151.369995,43812600,7507216774.566264,11776435500,17.466974275173644,48.0,0.8884643750741361,56.23908883782538,63.21235523102656,149.42923076923077,148.70663781364473,-36.78764476897344
2024-01-10,152.059998,154.419998,151.880005,153.729996,153.729996,44421800,7527503759.357246,11820857300,17.379546628489532,48.0,1.1525012781053192,60.42818739630469,83.59232580443414,149.68692296153847,149.07873842004142,-16.407674195565857
2024-01-11,155.039993,157.169998,153.119995,155.179993,155.179993,49072700,7528351844.0354805,11869930000,18.004263201177036,100.0,1.4619031562282885,62.78534090817745,84.83227318303096,150.08461515384616,149.53068320374203,-15.167726816969047
2024-01-12,155.389999,156.199997,154.009995,154.619995,154.619995,40460300,7510431051.305336,11829469700,18.584357161529717,84.0,1.6429799649430663,61.267466287023396,80.56399411737576,150.38230707692307,149.9076692627241,-19.43600588262424
2024-01-16,153.529999,154.990005,152.149994,153.160004,153.160004,41384600,7498482154.086769,11788085100,18.359828124834273,84.0,1.6496593225977563,57.373120585786864,69.43600969360118,150.71461476923076,150.14858294696677,-30.563990306398818
2024-01-17,151.490005,152.149994,149.910004,151.710007,151.710007,34953400,7519704205.638071,11753131700,17.33506639590816,84.0,1.5204236247762424,53.72095929982677,58.38419907934411,150.90038407692307,150.2642439879322,-41.61580092065589
2024-01-18,152.770004,153.779999,151.820007,153.5,153.5,37850200,7546740057.263384,11790981900,16.877090773034485,84.0,1.5446352846052207,57.33184891886788,72.0274436080197,151.13423030769232,150.50392961845574,-27.972556391980298
2024-01-19,153.830002,155.759995,152.740005,155.339996,155.339996,51033700,7583578940.084321,11842015600,16.99946117875368,20.0,1.6927821601452706,60.724231221552046,86.0518087087687,151.49769173076922,150.86215675782938,-13.94819129123129
2024-01-22,156.889999,157.050003,153.899994,154.779999,154.779999,43687500,7564301032.842628,11798328100,17.44425986384539,19.999999999999993,1.7448885593843784,59.18201863224358,81.78353726506764,151.7784610769231,151.15236729428648,-18.216462734932374
2024-01-23,154.850006,156.210007,153.929993,156.020004,156.020004,37986000,7595955971.754406,11836314100,17.857287214287688,20.0,1.8647456692226285,61.51289825926329,91.23479848887143,152.05461523076923,151.5129329761912,-8.765201511128573
2024-01-24,157.800003,158.509995,156.479996,156.869995,156.869995,48547300,7566062275.478052,11884861400,18.818559047047238,52.0,2.005205699218692,63.0696773817119,88.65836163671449,152.41807665384616,151.90975238536222,-11.341638363285504
2024-01-25,156.949997,158.509995,154.550003,157.75,157.75,43638600,7592950782.140995,11928500000,18.89578878515382,52.0,2.1626012133270933,64.66332735545996,94.56369658474866,152.71730738461537,152.34236331977985,-5.43630341525136
2024-01-26,158.419998,160.720001,157.910004,159.119995,159.119995,51047400,7585865631.619126,11979547400,19.521458124854338,60.0,2.370559109413989,67.04739266004744,89.01849532398985,152.9115376923077,152.84441011090726,-10.981504676010157
2024-01-29,159.339996,161.289993,158.899994,161.259995,161.259995,45270400,7629999611.5125065,12024817800,20.237763705704175,64.0,2.677186417067105,70.40611394231172,99.77065724688079,153.19884546153847,153.46778676935858,-0.22934275311920166
2024-01-30,160.699997,161.729996,158.490005,159.0,159.0,45207400,7599024070.775696,11979610400,21.01012496067127,68.0,2.7066277388230446,63.09237511222186,76.90357150833945,153.46346103846156,153.87758034199868,-23.096428491660543
2024-01-31,157.0,159.009995,154.809998,155.199997,155.199997,50284400,7558078184.929682,11929326000,20.22012700468427,68.0,2.3957153984457875,53.10356231835325,44.754624199407274,153.51576876923076,153.97553713148028,-55.245375800592726
2024-02-01,155.869995,159.759995,155.619995,159.279999,159.279999,76542400,7616871770.518861,12005868400,19.70610378173874,68.0,2.4502917540083615,60.36011712311446,79.27243097964877,153.74115342307692,154.36846023285213,-20.727569020351226
2024-02-02,169.190002,172.5,167.330002,171.809998,171.809998,117154900,7702755047.083107,12123023300,21.616844827504966,80.0,3.464671533961905,73.77897664287181,96.9455417344917,154.4488455,155.6604259933816,-3.054458265508291
2024-02-05,170.199997,170.550003,167.699997,170.309998,170.309998,55081300,7748559322.81965,12067942000,23.39110437000218,80.0,4.100271970860405,70.69373572963828,90.30543431703134,155.1015378846154,156.74557947535334,-9.694565682968653
2024-02-06,169.389999,170.710007,167.649994,169.149994,169.149994,42505500,7747725704.605773,12025436500,25.05992499972546,80.0,4.4589868434064215,68.31458053719722,83.80073919754224,155.7080759230769,157.66442499569752,-16.199260802457758
2024-02-07,169.479996,170.880005,168.940002,170.529999,170.529999,47174100,7777877956.655435,12072610600,26.633619384528636,80.0,4.799302463282572,69.62428759754998,90.0303567890579,156.4230758076923,158.6174304774977,-9.969643210942088
2024-02-08,169.649994,171.429993,168.880005,169.839996,169.839996,42316500,7767423143.182195,12030294100,28.176458585907458,80.0,4.956195630270628,68.1083884299719,85.69890783906207,157.18884515384613,159.44873162731267,-14.301092160937934
2024-02-09,170.899994,175.0,170.580002,174.449997,174.449997,56986000,7810227023.20929,12087280100,30.093759123006272,100.0,5.390386132836511,72.4277235303903,97.38964016480865,158.18807576923078,160.55993646973397,-2.6103598351913395
2024-02-12,174.800003,175.389999,171.539993,172.339996,172.339996,51050400,7780392420.354125,12036229700,31.922902506201947,100.0,5.500815807122194,67.8951436261909,85.364666096865,159.25615226923077,161.43253347197592,-14.635333903134999
2024-02-13,167.729996,170.949997,165.75,168.639999,168.639999,56345100,7786677080.584717,11979884600,31.4486158156114,96.0,5.229490967236387,60.71933224211838,67.61035846647952,160.15615203846153,161.9664198073851,-32.38964153352047
2024-02-14,169.210007,171.210007,168.279999,170.979996,170.979996,42815500,7822770390.0852375,12022700100,31.0581589165746,92.0,5.14398561442286,63.35701046652973,78.57141503540261,160.99769011538461,162.63409211794917,-21.42858496459739
2024-02-15,170.580002,171.169998,167.589996,169.800003,169.800003,49855200,7834468418.818852,11972844900,30.46115549473613,72.0,4.924242826726527,61.12790172907686,72.83772726736024,161.70653657692307,163.1649003314344,-27.16227273263976
2024-02-16,168.740005,170.419998,167.169998,169.509995,169.509995,48074600,7855621154.065745,11924770300,29.759635967942415,72.0,4.672828405292336,60.563919034210805,71.42855338053681,162.3134596153846,163.63490734392076,-28.571446619463188
2024-02-20,167.830002,168.710007,165.740005,167.080002,167.080002,41980300,7851521957.215912,11882790000,28.608469340098623,72.0,4.228754093282191,55.909241316739255,59.621007792953996,162.77115226923075,163.89009954066736,-40.378992207046
2024-02-21,168.940002,170.229996,167.139999,168.589996,168.589996,44575600,7848781016.779141,11927365600,27.92353578250976,72.0,3.953097055743939,58.06597763292281,65.60444297330453,163.30846,164.23824001913647,-34.39555702669547
2024-02-22,173.100006,174.800003,171.770004,174.580002,174.580002,55392400,7896129596.70369,11982758000,28.257890686914088,72.0,4.169912139658521,65.31428842847376,91.60624348574743,164.13230607692307,165.00429646216338,-8.39375651425257
2024-02-23,174.279999,175.75,173.699997,174.990005,174.990005,59715200,7911568516.694344,12042473200,28.742609415525262,100.0,4.324967933156756,65.75067041960213,92.40763856525399,165.0276906153846,165.74397857607718,-7.592361434746004
2024-02-26,175.699997,176.369995,174.259995,174.729996,174.729996,44368600,7886966064.911026,11998104600,29.307810022638346,100.0,4.376421549907093,65.19054299161651,84.57196102724471,165.8442289230769,166.40960949636775,-15.42803897275529
2024-02-27,174.080002,174.619995,172.860001,173.539993,173.539993,31141700,7879888204.749571,11966962900,29.277269345377864,96.0,4.271931448501732,62.56358783670422,73.37719038305792,166.5442288076923,166.93778605219237,-26.622809616942078
2024-02-28,172.440002,174.050003,172.270004,173.160004,173.160004,28180500,7879888220.581321,11938782400,29.017182414162573,92.0,4.111070492147121,61.70848063145744,69.8025021660415,167.2511520769231,167.39869108536328,-30.197497833958494
2024-02-29,173.009995,177.220001,172.850006,176.759995,176.759995,53805400,7922366007.239704,11992587800,29.450971370771647,96.0,4.225368791388945,66.39469200127792,95.9929776979017,168.04884403846154,168.092121004966,-4.0070223020983
2024-03-01,176.75,178.729996,176.070007,178.220001,178.220001,31956200,7942068395.499129,12024544000,30.13763676859899,100.0,4.3832341051380865,68.0997951454317,96.07393877332169,168.86999811538465,168.84233433793148,-3.9260612266783204
2024-03-04,177.529999,180.139999,177.490005,177.580002,177.580002,37381500,7907225937.365262,11987162500,31.027689648019457,88.0,4.405912318415773,66.50678669894273,82.22223564815387,169.63269050000002,169.48956897956617,-17.777764351846137
2024-03-05,176.929993,176.929993,173.300003,174.119995,174.119995,37228300,7886816916.852863,11949934200,30.25964016428003,88.0,4.097458367924872,58.53476426592767,58.19439924766633,170.2096135769231,169.8325634995983,-41.80560075233367
2024-03-06,175.539993,176.460007,173.259995,173.509995,173.509995,32090900,7859740201.174672,11917843300,29.532643972901365,88.0,3.7604365164813203,57.232254635931156,53.95828637150829,170.68076742307693,170.1049658329614,-46.04171362849171
2024-03-07,174.830002,177.990005,173.720001,176.820007,176.820007,34063300,7875136543.076553,11951906600,29.21196197514606,88.0,3.7175806212878513,62.15352195865656,76.94449039353776,171.3661523076923,170.60237628977907,-23.055509606462245
2024-03-08,176.440002,178.789993,174.330002,175.350006,175.350006,37853500,7854597302.86497,11914053100,29.095026766345086,84.0,3.5243734370617403,58.91137635134277,66.73614586228311,172.14115265384618,170.95405256461027,-33.26385413771689
2024-03-11,174.309998,174.470001,171.470001,171.960007,171.960007,28484800,7835417651.470837,11885568300,27.93781137245626,36.0,3.062409216519228,52.15478634917447,37.076984615384625,172.62884526923077,171.02856770797246,-62.923015384615375
2024-03-12,173.5,176.759995,171.979996,175.389999,175.389999,36610600,7851042315.884825,11922178900,27.424910861061853,36.0,2.939189782002785,57.4697962797428,45.213366831226445,172.7665376153846,171.3516366925671,-54.786633168773555
2024-03-13,175.899994,177.619995,175.550003,176.559998,176.559998,30772600,7850298983.763155,11952951500,27.148015450590695,36.0,2.9024885523161004,59.13731068557012,58.70816809877021,173.00692223076925,171.73744123385842,-41.29183190122979
2024-03-14,177.690002,179.529999,176.470001,178.75,178.75,43705800,7871723409.530753,11996657300,27.315203304224703,36.0,3.01535824925881,62.13031618536068,83.9677125646397,173.37615323076923,172.2568900313504,-16.03228743536031
2024-03-15,176.639999,177.929993,173.899994,174.419998,174.419998,72115500,7818218508.918991,11924541800,26.534456912718092,36.0,2.7240126015728094,53.74788131766438,34.02534810273311,173.52576857692307,172.41712025125037,-65.9746518972669
2024-03-18,175.800003,176.690002,174.279999,174.479996,174.479996,31250700,7792154562.834152,11955792500,25.80947812060481,36.0,2.4694936285815174,53.840811790377,34.717366716809,173.70423011538463,172.56992586226886,-65.282633283191
2024-03-19,174.220001,176.089996,173.520004,175.899994,175.899994,26880900,7815060800.841585,11982673400,24.8574370533003,36.00000000000001,2.355217993006221,56.08950638797212,51.09566345920726,173.75999923076927,172.81659757617487,-48.90433654079274
2024-03-20,176.139999,178.529999,174.639999,178.149994,178.149994,29947200,7839157057.018449,12012620600,24.62305281163712,36.0,2.4183328882904505,59.45958458083468,77.04722653915263,173.9834606923077,173.2116639779397,-22.952773460847375
2024-03-21,179.990005,181.419998,178.149994,178.149994,178.149994,32824300,7806332757.018449,12045444900,25.061042437426355,88.0,2.4402225311679615,59.45958458083468,67.13562828209896,174.34922973076922,173.57746620179603,-32.86437171790104
2024-03-22,177.75,179.259995,176.75,178.869995,178.869995,27964100,7825606800.663754,12073409000,24.93029096682495,88.0,2.4869997097054295,60.58233317751124,74.37182141863957,174.65269123076922,173.96950537203335,-25.628178581360423
2024-03-25,178.009995,180.990005,177.240005,179.710007,179.710007,29815500,7835068284.466954,12103224500,25.198941277508744,88.0,2.562316123548669,61.90779585527421,82.81415562235846,175.03384523076923,174.3947277148457,-17.18584437764155
2024-03-26,180.149994,180.449997,177.949997,178.300003,178.300003,29659000,7813713946.830154,12073565500,25.448402280286555,88.0,2.4796455745820083,58.36036355847497,68.64325687736398,175.37192246153847,174.68400736559784,-31.356743122636015
2024-03-27,179.880005,180.0,177.309998,179.830002,179.830002,33272600,7842781140.696776,12106838100,25.407812781848776,84.0,2.5086683345131746,60.97362281335018,84.02013588546825,175.8623070769231,175.0651921533313,-15.97986411453175
2024-03-28,180.169998,181.699997,179.259995,180.380005,180.380005,38051600,7839662440.355056,12144889700,25.789187364312102,52.0,2.546693034350824,61.89931572546594,87.09684734969608,176.31576896153845,175.4588819938253,-12.90315265030392
2024-04-01,180.789993,183.0,179.949997,180.970001,180.970001,29174500,7830001433.750308,12174064200,26.442254025239777,56.0,2.5945275309831572,62.91549396714374,81.57896312923295,176.56153815384616,175.86711303131972,-18.42103687076705
2024-04-02,179.070007,180.789993,178.380005,180.690002,180.690002,32582700,7859880405.1378,12141481500,26.346361171416827,56.0,2.5801013328349143,62.06942275373321,75.63292220798398,176.7807688076923,176.22436406603677,-24.367077792016023
