Date,Open,High,Low,Close,Adj_Close,Volume,Accumulation_Distribution_Line,On_Balance_Volume,Average_Directional_Index,Aroon_Oscillator,MACD,RSI,Stochastic_Oscillator,Simple_Moving_Average,Exponential_Moving_Average,Williams_%R
2014-04-03,19.335358,19.375,19.201429,19.2425,16.949091,162344000,-85515146.97731955,162344000,0.0,0.0,0.0,100.0,23.66236295233592,19.2425,19.2425,-76.33763704766409
2014-04-04,19.278929,19.285713,18.949286,18.99357,16.729822,275251200,-288303529.5411488,-112907200,0.0,-4.0,-0.019857663817663962,0.0,10.402288860595993,19.118035,19.22406074074074,-89.59771113940401
2014-04-07,18.857857,18.960714,18.638929,18.695356,16.467159,289850400,-476499790.77893245,-402757600,0.0,-8.0,-0.05897851536919063,0.0,7.665972440158546,18.977142,19.184897426611794,-92.33402755984146
2014-04-08,18.756786,18.790001,18.525,18.694286,16.466215,243888400,-408790184.11178386,-646646000,0.0,-12.0,-0.08904199148085468,0.0,19.916000000000338,18.906428,19.148555839455366,-80.08399999999966
2014-04-09,18.665714,18.946072,18.643572,18.940001,16.682642,206169600,-210895993.3124479,-440476400,0.0,-12.0,-0.09198007685061071,34.94492247082749,48.82364705882347,18.9131426,19.13310733282904,-51.17635294117653
2014-04-10,18.952856,19.008572,18.684643,18.695715,16.46747,239652000,-434165224.59461355,-680128400,0.0,-12.0,-0.11272099186280471,25.43037020568741,20.084117647058942,18.876904666666665,19.10070790076763,-79.91588235294105
2014-04-11,18.535713,18.672501,18.469286,18.557501,16.345734,271717600,-469979293.0246066,-951846000,0.0,-24.0,-0.1387120450277699,21.811822013780784,9.739829570923956,18.83127557142857,19.06047035256262,-90.26017042907604
2014-04-14,18.639286,18.648571,18.471786,18.63143,16.410851,205674000,-304189423.850183,-746172000,0.0,-24.0,-0.15159717163817987,27.735030021926647,17.902340032284084,18.806294875,19.02868958570613,-82.09765996771591
2014-04-15,18.581072,18.629999,18.261786,18.498571,16.293823,266490000,-227938485.04574525,-1012662000,0.0,-32.0,-0.17056319195529923,24.188628058245186,21.27039365297218,18.772103333333334,18.98942154232049,-78.72960634702783
2014-04-16,18.501785,18.610357,18.362143,18.536072,16.326855,214765600,-141722141.70330596,-797896400,0.0,-32.0,-0.18048733673987982,27.025042714284666,24.639108024153508,18.748500200000002,18.955840094741195,-75.3608919758465
2014-04-17,18.571428,18.848572,18.542856,18.747856,16.513399,284334400,-44731704.272491395,-513562000,0.0,-32.0,-0.1693113779615345,40.5521896828466,43.663662153009064,18.748441636363637,18.94043386550111,-56.336337846990936
2014-04-21,18.762142,19.004999,18.712856,18.970358,16.709387,182548800,94525468.1286954,-331013200,0.0,-32.0,-0.1408763632154013,50.858559027433714,63.65101409073194,18.766934666666668,18.94265046805658,-36.34898590926806
2014-04-22,18.868214,18.993929,18.803572,18.989286,16.726055,202563200,287207224.9708363,-128450000,0.0,-32.0,-0.1154828631924758,51.626856913038864,65.35131609915071,18.784038615384613,18.946104951904243,-34.648683900849285
2014-04-23,18.895,18.968929,18.730356,18.741072,16.507427,394940000,-72253680.24476254,-523390000,0.0,-32.0,-0.11407217385038493,42.28956038972066,43.05425551601028,18.780969571428574,18.930917325837264,-56.94574448398972
2014-04-24,20.293215,20.357143,20.026072,20.2775,17.860731,759911600,322046678.91082436,236521600,0.0,24.000000000000007,0.010897091860378794,73.83500801901661,96.19907252081623,18.880738266666665,19.03066419059006,-3.8009274791837764
2014-04-25,20.161785,20.428213,20.14143,20.42643,17.991913,390275200,707469006.3095902,626796800,0.0,28.0,0.1205637576809444,75.24740785189474,99.91769858850542,18.977344,19.13405425054635,-0.08230141149457826
2014-04-28,20.457144,21.276787,20.448214,21.217501,18.688694,669485600,1281148628.3653412,1296282400,0.0,32.0,0.2682163675667866,81.08733818387695,98.03363249299088,19.10911794117647,19.28838363939477,-1.9663675070091258
2014-04-29,21.205,21.285,21.053928,21.154642,18.633331,337377600,1237866787.3183935,958904800,0.0,36.0,0.37582762183556184,79.48263061960479,95.68809882462831,19.222758166666665,19.426624999439603,-4.311901175371678
2014-04-30,21.165714,21.408215,21.064285,21.074642,18.562868,456640800,808728262.5813808,502264000,0.0,40.0,0.4494737313414596,77.38369310141115,89.39836239749894,19.320225736842104,19.548700332814448,-10.601637602501055
2014-05-01,21.142857,21.242857,20.941429,21.124287,18.60659,244048000,860778363.5142715,746312000,0.0,40.0,0.5060117518222498,77.77590571848387,90.97618284092856,19.4104288,19.665410456309672,-9.023817159071434
2014-05-02,21.155001,21.22143,21.061071,21.16357,18.641201,191514400,914090066.0167805,937826400,0.0,40.0,0.5476750926340088,78.09954910967262,92.22467756304054,19.493911714285712,19.776385237323773,-7.775322436959443
2014-05-05,21.076429,21.464287,21.071428,21.462856,18.904819,287067200,1199065965.253911,1224893600,0.0,52.0,0.5979506662884191,80.43700995389341,99.95531617320339,19.58340918181818,19.901308997522012,-0.044683826796624984
2014-05-06,21.492857,21.586071,21.22893,21.22893,18.698763,374564400,824501565.253911,850329200,0.0,56.0,0.6118653446069651,73.8062794402916,88.92217816278769,19.65495356521739,19.99965129400186,-11.07782183721231
2014-05-07,21.258928,21.331785,20.990356,21.154642,18.633331,282864400,813849899.4879682,567464800,0.0,56.0,0.6098682254023267,71.78256474391353,85.82324942536096,19.71744058333333,20.085206161112836,-14.176750574639037
2014-05-08,21.008928,21.22893,20.942858,20.999643,18.600119,230297200,674980217.7491027,337167600,0.0,56.0,0.5889888730294324,67.61670278448985,79.58983229587759,19.76872868,20.152942223252627,-20.410167704122426
2014-05-09,20.876429,20.9375,20.72607,20.912144,18.522612,291597600,896637423.8069035,45570000,0.0,56.0,0.5589383049534682,65.31239549698068,76.40076128044993,19.812706192307694,20.20917939190058,-23.599238719550062
2014-05-12,20.981787,21.202143,20.978571,21.172501,18.753223,213208800,1053310206.3306562,258778800,0.0,56.0,0.5497939646665628,68.7274706493292,85.51781252681027,19.886936999999996,20.280536548056094,-14.482187473189727
2014-05-13,21.142857,21.23357,21.09643,21.205713,18.78264,159737200,1148153149.652806,418516000,37.17863331809524,56.0,0.5390135275225028,69.14478658110951,75.61806129362898,19.972019423076922,20.349068137088977,-24.381938706371017
2014-05-14,21.158215,21.335714,21.133572,21.209642,18.786123,166404000,1106991328.715047,584920000,36.9473718517076,56.0,0.5247381362840251,69.19715439904635,73.94307651520333,20.06872273076923,20.41281434915646,-26.056923484796673
2014-05-15,21.239286,21.307142,21.001429,21.029285,18.626369,230846000,918213845.107873,354074000,36.23296620811766,56.0,0.49318633817656377,63.84079320354766,51.06713761043798,20.158530384615382,20.458478841811537,-48.93286238956202
2014-05-16,21.022499,21.340357,20.907143,21.339643,18.90127,276256400,1193559623.2461576,630330400,35.21974000433948,56.0,0.48760381443793577,68.37705908385715,71.34561471440132,20.25082430769231,20.52375026093661,-28.654385285598682
2014-05-19,21.351786,21.690357,21.333214,21.592501,19.125227,317755200,1337187076.9305344,948085600,35.022935392771444,92.0,0.49784431219898195,71.51271957914686,89.85198390105847,20.36223915384615,20.60291698234871,-10.148016098941527
2014-05-20,21.589643,21.657143,21.454643,21.596786,19.129034,234836000,1432032988.5157204,1182921600,34.84018825345827,92.0,0.5005358781120641,71.56417739935438,90.29635367893611,20.47913473076923,20.676536909582136,-9.703646321063884
2014-05-21,21.565357,21.667856,21.502144,21.653929,19.179644,196859600,1595803088.066751,1379781200,34.69326968000306,92.0,0.5014989582079288,72.28319650658223,96.22228651843307,20.59538469230769,20.748936323687165,-3.7777134815669284
2014-05-22,21.664286,21.780357,21.575001,21.688213,19.210003,200760000,1616399572.6106682,1580541200,34.800203642078486,100.0,0.4992733262806688,72.72874289318528,91.26006485899971,20.71806323076923,20.81851237378441,-8.739935141000286
2014-05-23,21.6875,21.954643,21.659643,21.933214,19.427015,232209600,1814873447.062192,1812750800,35.25487789364044,100.0,0.511384112362947,75.73109127814047,98.25578130074474,20.848722538461537,20.901082864615198,-1.7442186992552529
2014-05-27,21.995714,22.352142,21.986786,22.343929,19.790802,348866000,2148054819.148593,2161616800,36.352530214955664,100.0,0.547808470548631,79.75486844088087,99.49491781421723,20.98703303846154,21.00796035612518,-0.5050821857827547
2014-05-28,22.357857,22.493929,22.277857,22.286072,19.739553,315481600,1856562272.2790306,1846135200,37.57687843109171,96.0,0.565487868323185,77.79804172717621,88.24244467460355,21.1145605,21.102635292708502,-11.757555325396451
2014-05-29,22.423214,22.745358,22.420357,22.692142,20.099222,376474000,2109747787.7266777,2222609200,39.045801879712705,100.0,0.6052879905873176,81.2712689520544,97.36461564670323,21.256978038461536,21.220376530285648,-2.6353843532967587
2014-05-30,22.785,23.006071,22.460714,22.607143,20.023937,564020800,1848607492.5086858,1658588400,40.710008166665126,100.0,0.6227920067134924,78.5028923693396,80.99372632124597,21.405673076923076,21.32309997248671,-19.006273678754035
2014-06-02,22.64143,22.672501,22.232143,22.451786,19.886335,369350800,1847708351.2245452,1289237600,41.25122380103526,96.0,0.6170154836589177,73.57011777352064,73.59199553295772,21.489299461538458,21.4067063448951,-26.408004467042264
2014-06-03,22.445,22.812143,22.4375,22.769285,20.167549,292709200,2073447497.6343288,1581946800,41.95287739159043,92.0,0.6307857578052278,76.78113618445933,88.71871736429269,21.579409269230766,21.507638097125092,-11.281282635707319
2014-06-04,22.765715,23.138929,22.718214,23.029285,20.39784,335482000,2234067235.019496,1917428800,43.02235416331241,68.0,0.6551267331870392,79.02812307067477,95.0871633749831,21.64909326923077,21.620352682523233,-4.912836625016889
2014-06-05,23.078571,23.191786,22.950357,23.119642,20.477882,303805600,2356305987.570346,2221234400,44.078226500091795,72.0,0.673939432039603,79.76114774253928,96.84221998798054,21.724670192307695,21.731411150484476,-3.157780012019452
2014-06-06,23.210714,23.259287,23.016787,23.05607,20.421566,349938400,2119741856.990545,1871296000,45.140957725506226,76.0,0.6759272339093911,77.7033172122432,89.44915379635131,21.800878961538462,21.829534028226366,-10.550846203648684
2014-06-09,23.174999,23.469999,22.9375,23.424999,20.748341,301660000,2370416972.511887,2172956000,46.37421123934074,80.0,0.6992119876944471,80.7992898052656,97.76714386937088,21.889367884615385,21.947716618728116,-2.232856130629114
2014-06-10,23.682501,23.762501,23.3925,23.5625,20.870127,251108000,2350056240.7625146,2424064000,47.81914003146988,84.0,0.7204555413699794,81.81289354988202,91.15179593312028,21.98163442307692,22.067330202526033,-8.848204066879719
2014-06-11,23.532499,23.690001,23.3675,23.465,20.78377,182724000,2277816177.246433,2241340000,49.039825593864016,84.0,0.7211112538921789,78.64265092743437,86.39995428571427,22.05863996153846,22.170861298635216,-13.600045714285736
2014-06-12,23.51,23.530001,22.975,23.0725,20.436127,218996000,2135764579.1484118,2022344000,48.44494421423196,84.0,0.6820966553965562,67.33145610021523,67.18746582032651,22.1295465,22.237649350588164,-32.81253417967349
2014-06-13,23.049999,23.110001,22.719999,22.82,20.212479,218100000,2029511277.883289,1804244000,46.956785852029476,84.0,0.6236140308726768,61.23015954930611,46.92273253309235,22.193598730769228,22.28078643572978,-53.07726746690765
2014-06-16,22.877501,23.1875,22.862499,23.049999,20.416193,142244000,2051394465.184251,1946488000,45.727827390054706,84.0,0.5890350967770708,64.3950839620527,53.442135761697536,22.27245857692308,22.33776514419424,-46.557864238302464
2014-06-17,23.077499,23.174999,22.950001,23.02,20.38962,118904000,2006474777.0092444,1827584000,44.586651675363846,64.0,0.5528376059981497,63.66506186237332,51.481875482730125,22.353529961538463,22.38830105943911,-48.518124517269875
2014-06-18,23.067499,23.0725,22.8375,23.045,20.411758,134056000,2109155968.4986067,1961640000,43.087464467999375,64.0,0.5201719068864854,64.03101826610137,53.115480168692635,22.425549153846152,22.436945425406584,-46.884519831307365
2014-06-19,23.0725,23.075001,22.834999,22.965,20.340904,142112000,2120998536.4772065,1819528000,41.69536206116094,64.0,0.48226947132165776,61.883129167957335,47.88794517361293,22.493214038461538,22.47606057908017,-52.11205482638707
2014-06-20,22.9625,23.137501,22.725,22.727501,20.130543,403592000,1722300505.6651576,1415936000,39.95215377833754,64.0,0.4281320933569468,55.88927212310625,21.88685140614989,22.551593230769228,22.4946857954446,-78.11314859385011
2014-06-23,22.83,22.905001,22.65,22.7075,20.112829,174776000,1626344745.5857866,1241160000,38.03086178456137,64.0,0.3792422491583025,55.4025973355673,5.168534679968908,22.616139961538465,22.510449810596853,-94.83146532003109
2014-06-24,22.6875,22.934999,22.547501,22.57,19.991037,156144000,1488332884.8794086,1085016000,35.83919981948884,60.0,0.3256477302088463,52.047203764697606,1.8517695473250886,22.663461384615385,22.514860935737826,-98.14823045267491
2014-06-25,22.5525,22.674999,22.4125,22.59,20.008757,147476000,1540301378.0012867,1232492000,33.29179374245318,56.00000000000001,0.28154207883580895,52.49785292223827,13.14813840878626,22.701826730769234,22.520426792349838,-86.85186159121375
2014-06-26,22.592501,22.762501,22.450001,22.725,20.128332,130516000,1639492702.6988876,1363008000,31.244056028971233,52.0,0.25454714310096804,55.53542916657954,23.148131001384463,22.745219576923077,22.535580363286886,-76.85186899861554
2014-06-27,22.705,23.0,22.692499,22.995001,20.367474,256116000,1887281419.9648452,1619124000,30.127628257573946,48.0,0.2520349838431777,60.9181880453979,43.14819026059963,22.79679926923077,22.56961152156193,-56.85180973940037
2014-06-30,23.025,23.432501,23.022499,23.2325,20.577837,197929200,1892108937.8793945,1817053200,30.202024219439842,44.0,0.2661403635261834,64.93885426471493,64.18781668272682,22.856194923076924,22.6187143718166,-35.812183317273174
2014-07-01,23.379999,23.5175,23.282499,23.379999,20.708481,152892000,1866084227.8058221,1969945200,30.455713137569017,40.0,0.2859249503031691,67.19601218979052,86.57701424875705,22.9118405,22.675105825756113,-13.422985751242948
2014-07-02,23.467501,23.514999,23.272499,23.370001,20.699631,113860000,1843783631.6821096,1856085200,30.646045809366644,24.0,0.29736972968338904,66.88170672711024,86.65167420814477,22.951304807692306,22.72657954236677,-13.348325791855226
2014-07-03,23.4175,23.525,23.299999,23.5075,20.821417,91567200,1921107108.3208814,1947652400,30.847020779916967,24.0,0.3139161895432956,69.02735168709009,98.42696629213498,22.99828280769231,22.784425502191453,-1.5730337078650192
2014-07-07,23.535,23.997499,23.525,23.9925,21.251001,225872000,2142199694.4893162,2173524400,32.008832026263214,96.0,0.3619920063618203,75.14439023559538,99.68460547924626,23.04829657692308,22.87391250202912,-0.3153945207537374
2014-07-08,24.067499,24.200001,23.48,23.8375,21.11371,260888000,2140387612.4394288,1912636400,33.41445335078508,100.0,0.38316830721551653,70.36168361050113,79.72023512154668,23.095617999999998,22.945289353730665,-20.279764878453324
2014-07-09,23.860001,23.987499,23.690001,23.8475,21.122568,145744000,2148960846.545205,2058380400,34.719673152126816,32.0,0.39619055652008583,70.49217066420638,80.27967536801377,23.149299307692306,23.012119771972838,-19.72032463198624
2014-07-10,23.440001,23.887501,23.379999,23.76,21.045063,158744000,2227941540.217349,1899636400,34.48912469366542,32.0,0.3948981244194485,67.68419152220753,75.38457321142762,23.187403730769233,23.067518307382258,-24.61542678857237
2014-07-11,23.84,23.9725,23.715,23.805,21.084915,136072000,2186987831.4794846,2035708400,34.460143933762915,31.999999999999993,0.3929750152304088,68.3817489711941,77.902054320529,23.21723892307692,23.122146580909497,-22.097945679470996
2014-07-14,23.965,24.2225,23.9125,24.112499,21.357283,171240000,2236701565.4149675,2206948400,34.93699498619968,48.0,0.411519792757737,72.71578309147968,93.92259668508284,23.255425730769225,23.195506019360646,-6.077403314917157
2014-07-15,24.200001,24.2125,23.7575,23.83,21.107063,181911600,2112761793.9863946,2025036800,34.70761806473494,48.0,0.3988239598488583,64.0319916645395,78.31491712707171,23.28519226923077,23.24250557348208,-21.685082872928295
2014-07-16,24.2425,24.275,23.684999,23.695,20.98749,213585200,1906417482.002516,1811451600,34.188879716830925,56.0,0.3735628490530267,60.32453391567631,68.21916066803331,23.295576923076926,23.276023679150075,-31.780839331966693
2014-07-17,23.7575,23.82,23.1425,23.272499,20.613272,229192000,1765180406.8969817,1582259600,31.8181408802711,56.0,0.31581047052007705,50.47464886156633,36.65084571826491,23.284423038461536,23.275762591805623,-63.34915428173509
2014-07-18,23.405001,23.684999,23.254999,23.6075,20.909988,199952000,1893057615.9760518,1782211600,29.616740532036975,56.0,0.293687627276082,56.53478113723561,46.70662937594481,23.28990380769231,23.300335733153357,-53.29337062405519
2014-07-21,23.747499,23.75,23.43,23.485001,20.801479,156316000,1790476217.9510524,1625895600,27.770784253666047,56.0,0.2632360477854796,53.93580193593124,30.24291390728495,23.305769230769233,23.31401464180866,-69.75708609271504
2014-07-22,23.67,23.7225,23.530001,23.68,20.974209,220788000,1913772906.307875,1846683600,26.05668199517876,56.0,0.25193360746907345,57.30084691806454,47.461368653421744,23.338846153846156,23.34112466834135,-52.538631346578256
2014-07-23,23.855,24.469999,23.7925,24.297501,21.521145,371672000,2096182112.8395443,2218355600,26.33523605332868,76.0,0.2894667199565717,65.81674944455423,87.00579058816614,23.386827,23.411967359575325,-12.994209411833872
2014-07-24,24.26,24.33,24.105,24.2575,21.485722,182916000,2161218912.839546,2035439600,26.593893393039313,76.0,0.31238327566664736,64.91358899954133,83.99253031452373,23.43442315384615,23.47459940701419,-16.00746968547627
2014-07-25,24.2125,24.459999,24.16,24.4175,21.627436,173876000,2285831041.133308,2209315600,27.094367219989458,76.0,0.33954145150027415,66.87180276838039,96.04527009059888,23.487211615384616,23.54444389538351,-3.954729909401125
2014-07-28,24.455,24.809999,24.387501,24.754999,21.926371,221272000,2449493490.3188667,2430587600,28.180752757467257,88.0,0.38387280348958086,70.5992899885681,96.70164719738963,23.55605773076923,23.63411464387362,-3.2983528026103537
2014-07-29,24.8325,24.860001,24.5625,24.594999,21.784645,172572000,2314625010.1591377,2258015600,29.27100390679424,92.0,0.40146719261522534,66.76404445092237,84.5704893330485,23.62788457692308,23.705291262845943,-15.429510666951503
2014-07-30,24.610001,24.674999,24.4175,24.5375,21.733725,132040000,2305651895.8557825,2125975600,29.687642811692115,92.0,0.40609003090323625,65.38929210930016,81.22266013236681,23.69826919230769,23.766936354486987,-18.777339867633184
2014-07-31,24.290001,24.362499,23.8325,23.9,21.169064,227372000,2136195514.5644963,1898603600,28.128302100882458,92.0,0.3542294052781365,52.48529984771412,44.10477781381201,23.74942303846154,23.776792920821283,-55.89522218618799
2014-08-01,23.725,24.155001,23.702499,24.032499,21.286428,194044000,2225175766.39101,2092647600,26.325630529091665,88.0,0.3201307794433319,54.49527658887197,51.819416699029695,23.80490376923077,23.79573411187156,-48.180583300970305
2014-08-04,24.092501,24.145,23.7925,23.897499,21.166847,159832000,2160561923.3725696,1932815600,24.651721212428786,84.0,0.2789978870719807,52.07801679979948,43.959159266865086,23.849999884615382,23.803272251732928,-56.040840733134914
2014-08-05,23.84,23.92,23.59,23.780001,21.062775,223732000,2194462067.2028694,1709083600,23.248747757141068,80.0,0.23421873906512047,49.99923357808904,37.11794054268379,23.880192192307693,23.801548455308264,-62.88205945731621
2014-08-06,23.6875,23.870001,23.6775,23.74,21.027344,154232000,2140380196.293108,1554851600,21.945986691516758,32.0,0.19327523861455376,49.278070444425644,30.218093186176542,23.899711423076926,23.796989310470614,-69.78190681382345
2014-08-07,23.7325,23.987499,23.525,23.620001,21.025124,186844000,2030294705.3666408,1368007600,21.162737725760813,32.0,0.14942186089842124,47.08407522669506,13.286773925332826,23.90894226923077,23.78387906525057,-86.71322607466718
2014-08-08,23.565001,23.705,23.32,23.684999,21.082985,167460000,2180355393.8861237,1535467600,20.965747142857243,32.0,0.11854601384562713,48.423567857176316,23.701218375832283,23.921057576923076,23.77655461597275,-76.29878162416772
2014-08-11,23.817499,24.02,23.709999,23.997499,21.361151,146340000,2305451615.059605,1681807600,19.757150438680167,32.0,0.11793335858950016,54.40013991256387,43.99341299129032,23.93990369230769,23.792920866641435,-56.00658700870968
2014-08-12,24.01,24.219999,23.9025,23.9925,21.356701,135180000,2246909336.7532163,1546627600,18.626042478092323,31.999999999999996,0.11571060750746653,54.29175905692725,43.668802812465664,23.93990369230769,23.807704506149477,-56.331197187534336
2014-08-13,24.0375,24.309999,24.01,24.309999,21.639322,127664000,2374573336.7532163,1674291600,17.82128162864751,32.00000000000001,0.13797805201576097,59.773391213193406,64.28560760674836,23.95807673076923,23.84491150569396,-35.714392393251636
2014-08-14,24.3325,24.3925,24.200001,24.375,21.697178,112464000,2466589230.5292897,1786755600,17.29976424326674,32.0,0.15903692105199596,60.80962363122811,68.50644902178632,23.978365192307688,23.884177320086998,-31.493550978213676
2014-08-15,24.475,24.547501,24.215,24.495001,21.804003,195804000,2600560574.3869,1982559600,17.22820594037258,32.0,0.1832963777493113,62.71895513794488,76.29871668914488,24.006634461538457,23.92942351859907,-23.701283310855118
2014-08-18,24.622499,24.842501,24.495001,24.790001,22.066589,190288000,2733351480.861722,2172847600,17.860546790253093,32.0,0.22374699051501779,66.97812940744424,96.55172640280705,24.044519115384617,23.993169998702843,-3.448273597192941
2014-08-19,24.852501,25.17,24.83,25.1325,22.371456,277596000,2949713069.0970144,2450443600,19.09506220857252,92.0,0.2802111003398302,71.10550854759771,97.9729729729729,24.083749923076923,24.077564813613744,-2.0270270270271022
2014-08-20,25.110001,25.272499,24.987499,25.1425,22.380363,210796000,2968205425.56017,2661239600,20.425236986681764,96.0,0.32205379492804553,71.21862080523813,93.341917204567,24.134230692307693,24.15644890149421,-6.6580827954330095
2014-08-21,25.1425,25.235001,25.0275,25.145,22.382591,133912000,2985952068.169121,2795151600,21.660399280640345,96.0,0.35136583433558854,71.24892295400235,93.46995824325646,24.189999923076922,24.229674908790933,-6.530041756743552
2014-08-22,25.0725,25.3675,25.047501,25.33,22.547258,176736000,3121265438.723402,2971887600,23.057149026335917,100.0,0.3850847730812639,73.47449609122908,98.1684981684981,24.26913457692308,24.311180471102716,-1.8315018315019014
2014-08-25,25.4475,25.5425,25.32,25.385,22.596226,161080000,3054299596.0267744,3132967600,24.66469791296708,43.99999999999999,0.4115017789580051,74.11599348628314,92.9133858267717,24.337499961538462,24.39072265842844,-7.086614173228295
2014-08-26,25.355,25.375,25.215,25.2225,22.451574,132608000,2934123596.026775,3000359600,25.683180450403025,44.0,0.4145464214089216,68.8202962123047,85.60179977502811,24.404326846153843,24.452335794841147,-14.398200224971891
2014-08-27,25.254999,25.6425,25.174999,25.532499,22.72752,209476000,3045021969.557529,3209835600,27.11413129677524,52.0,0.43693691425326975,72.81137316366497,95.26368137782575,24.47557680769231,24.532347884112173,-4.736318622174252
2014-08-28,25.397499,25.695,25.389999,25.5625,22.754221,273840000,3080936192.2649956,3483675600,28.53192642565515,56.0,0.4518932272879752,73.16931299644241,93.32494039045824,24.524230615384617,24.608655448252012,-6.675059609541771
2014-08-29,25.715,25.725,25.549999,25.625,22.809853,178380000,3055454500.046093,3662055600,29.901248631481135,60.0,0.46344711097855296,73.93904931941512,94.5130315500685,24.57682676923077,24.683940229862976,-5.486968449931486
2014-09-02,25.764999,25.934999,25.68,25.825001,22.987886,214256000,3084864822.314023,3876311600,31.527916309206,64.0,0.4831723462235473,76.28377766749685,94.28581521341044,24.630961423076922,24.76846324987313,-5.7141847865895485
2014-09-03,25.775,25.799999,24.645,24.735001,22.017633,501684000,2661366278.204462,3374627600,29.38092192661971,64.0,0.406168785845999,49.922056526501756,30.83577041587367,24.63019226923077,24.765984564697344,-69.16422958412633
2014-09-04,24.7125,25.022499,24.4475,24.530001,21.835152,342872000,2416884998.438755,3031755600,27.64460837868716,64.0,0.3248563805832916,46.65643979473149,18.314022275594258,24.627692346153847,24.748504300645692,-81.68597772440575
2014-09-05,24.700001,24.8475,24.577499,24.7425,22.024303,233828000,2468847449.792639,3265583600,26.032317227035502,64.0,0.2743995003280837,50.28666335285108,19.831946105509868,24.63557696153846,24.7480595376349,-80.16805389449013
2014-09-08,24.825001,24.827499,24.512501,24.59,21.888559,185426800,2374661810.5187383,3080156800,24.69805011663527,64.0,0.21957545454035454,47.77396532106802,9.579838373000474,24.662115423076923,24.736351423736018,-90.42016162699953
2014-09-09,24.77,25.77,24.035,24.497499,21.806223,759385200,2020135279.8153389,2320771600,24.500307694079684,64.0,0.16674086078027628,46.26391598193639,24.342065443192382,24.680000038461536,24.718658651607424,-75.65793455680762
2014-09-10,24.502501,25.2775,24.440001,25.25,22.476049,403478400,2397116559.221762,2724250000,24.316689730278068,64.0,0.1834746250904118,57.91723112882789,63.947402077579994,24.73201930769231,24.758017270006874,-36.052597922420006
2014-09-11,25.102501,25.360001,24.905001,25.3575,22.571741,249412400,2643787067.299126,2973662400,24.29644408672682,64.0,0.2030697438508824,59.27592244354374,69.6052997922631,24.792692346153846,24.802423398154513,-30.39470020773691
2014-09-12,25.3025,25.547501,25.27,25.415001,22.622925,250504400,2655071911.3335624,3224166800,24.613352880408744,64.0,0.22069483411790713,60.01948328762586,72.63166980614196,24.85711546153846,24.847799516809737,-27.368330193858036
2014-09-15,25.702499,25.762501,25.360001,25.407499,22.616255,245266000,2467692343.472694,2978900800,25.26893081238166,64.0,0.23139017453659605,59.865904529921984,72.23682749306714,24.925865384615385,24.889258737786793,-27.763172506932875
2014-09-16,24.950001,25.315001,24.7225,25.215,22.444902,267632400,2644983941.9132037,2711268400,24.111951499055284,60.0,0.22177674410067993,55.91239240719992,62.105295844892495,24.984711576923075,24.913387720172956,-37.894704155107505
2014-09-17,25.317499,25.450001,25.147499,25.395,22.605122,243706000,2800068552.924039,2954974400,23.300222939463406,56.00000000000001,0.22607645821384637,58.66147158954988,71.578985041571,25.038461615384616,24.94906270386385,-28.421014958428998
2014-09-18,25.4825,25.5875,25.389999,25.4475,22.651855,149197600,2737746575.807977,3104172000,22.811136107112844,52.0,0.23105684439123308,59.45556833352111,74.34214439060234,25.094423153846154,24.98598398505912,-25.657855609397657
2014-09-19,25.5725,25.5875,25.125,25.24,22.467152,283609600,2595175263.375543,2820562400,21.683218196903347,-20.0,0.21577302336906357,54.96168376349486,63.42108601109777,25.130192423076927,25.004799986165853,-36.57891398890223
2014-09-22,25.450001,25.535,25.145,25.264999,22.489401,211153600,2513961257.4596453,3031716000,20.635865851708818,-20.0,0.20333379010817154,55.399067405682885,69.68836809539268,25.16442315384616,25.024073987190604,-30.311631904607328
2014-09-23,25.15,25.735001,25.135,25.66,22.841017,253608800,2704167117.768544,3285324800,20.103022954901565,-20.0,0.2227808091760366,61.72414094620886,93.65994236311242,25.20923080769231,25.07117961776908,-6.340057636887577
2014-09-24,25.540001,25.7125,25.299999,25.4375,22.642956,240687200,2623938829.0788207,3044637600,19.608240265009123,-20.000000000000007,0.21772897728703455,56.83477764584361,80.83573487031703,25.234134615384615,25.098314460897296,-19.164265129682978
2014-09-25,25.127501,25.1775,24.43,24.467501,21.779518,400368000,2263742602.6386857,2644269600,19.29055054822271,-20.0,0.1339109098265645,41.42786135858748,24.928011527377443,25.208557730769233,25.051587537867867,-75.07198847262255
2014-09-26,24.6325,25.1875,24.6,25.1875,22.42042,249482000,2513224602.6386857,2893751600,18.97013785857655,-19.999999999999996,0.12415125116293524,51.85959693146769,66.42651296829972,25.210288499999997,25.06165512765543,-33.573487031700274
2014-09-29,24.6625,25.110001,24.657499,25.0275,22.277994,199065200,2639701933.1256223,2694686400,18.6726117896194,-20.0,0.10232643310837375,49.73957510579875,44.84049167692931,25.20576926923077,25.059125118199475,-55.15950832307069
2014-09-30,25.202499,25.385,25.1325,25.1875,22.42042,221056400,2514947331.1454234,2915742800,17.660753892268193,-20.0,0.09682463624957549,51.858967067532674,56.84798735610705,25.2002885,25.06863436870322,-43.15201264389295
2014-10-01,25.147499,25.172501,24.674999,24.795,22.071037,205965200,2408342656.1893444,2709777600,17.665595499357547,-20.0,0.06010015567645155,46.66089222975576,27.392099518124326,25.17759619230769,25.048365156206682,-72.60790048187567
2014-10-02,24.817499,25.055,24.51,24.975,22.231266,191031200,2543291302.060905,2900808800,17.969985528890753,-20.0,0.04500148678666349,49.17681922477874,40.900532157199244,25.16807696153846,25.042930700191373,-59.099467842800756
2014-10-03,24.860001,25.0525,24.76,24.905001,22.168955,173878400,2541806350.8020997,2726930400,18.2526334134573,-20.000000000000004,0.027075242080574213,48.22419571457865,36.39851616971931,25.143942423076922,25.03271368536238,-63.60148383028069
2014-10-06,24.987499,25.1625,24.855,24.905001,22.168955,148204800,2441799197.6625857,2875135200,18.184499601018533,-20.0,0.012721913697390619,48.22419571457864,36.39851616971931,25.118654,25.02325348644665,-63.60148383028069
2014-10-07,24.8575,25.030001,24.682501,24.6875,21.975349,168376800,2278266804.1270475,2706758400,18.477108443594055,-20.0,-0.016019057699089956,45.077468013048,19.73178564614128,25.08259630769231,24.99838285782097,-80.26821435385872
2014-10-08,24.690001,25.2775,24.577499,25.200001,22.431549,229618800,2457042169.9570966,2936377200,18.005005392666174,-16.0,0.002528911237561715,52.87972312305885,59.00386283228903,25.058557846153846,25.013317535019418,-40.99613716771097
2014-10-09,25.385,25.594999,25.1525,25.254999,22.480501,309506000,2290922055.5478005,3245883200,16.72550636727956,0.0,0.021419281074106067,53.64082390437059,63.21826573312981,25.07855776923077,25.03121986575872,-36.78173426687019
2014-10-10,25.172501,25.5075,25.075001,25.182501,22.41597,265326400,2157492321.2048287,2980556800,15.729548552553798,0.0,0.030192017771408786,52.43842712769479,57.662867691288994,25.10365392307692,25.04242587570252,-42.337132308711006
2014-10-13,25.3325,25.445,24.952499,24.952499,22.211237,214333600,1943158721.2048287,2766223200,15.109065313472184,0.0,0.018373438058226554,48.70812470151786,40.740662768031214,25.111730807692307,25.035764625650483,-59.259337231968786
2014-10-14,25.0975,25.129999,24.6425,24.6875,21.975349,254754400,1735435999.2185287,2511468800,15.24132248727344,0.0,-0.012235038219145622,44.75756906452456,22.103023264397645,25.115480807692304,25.009967245972668,-77.89697673560235
2014-10-15,24.4925,24.7875,23.795,24.385,21.706076,403734400,1811708241.0321307,2107734400,16.78194816267411,-88.0,-0.06020766164763813,40.69956593197866,32.77779598766443,25.111153923076923,24.96367337590062,-67.22220401233557
2014-10-16,23.887501,24.43,23.852501,24.065001,21.42124,288618000,1735493465.9727788,1819116400,18.212529146974727,-88.0,-0.12263390893038917,36.889308432639936,15.000063888924222,25.06557703846154,24.897105051759834,-84.99993611107578
2014-10-17,24.375,24.75,24.202499,24.4175,21.735008,272718800,1676965378.7524822,2091835200,18.614951317160518,-88.0,-0.1420262461584052,43.19777555716199,34.583352546306905,25.029423192307693,24.861578751629473,-65.41664745369309
2014-10-20,24.58,24.99,24.555,24.940001,22.200108,310069200,1915755728.4959307,2401904400,18.35972760210753,-88.0,-0.11392014858881083,51.0141518199545,63.61120200622318,25.01115396153846,24.86738780706433,-36.38879799377682
2014-10-21,25.754999,25.754999,25.317499,25.6175,22.803179,378495600,2056341538.7615275,2780400000,17.585864434088794,16.0,-0.03655596218996493,58.909751142086606,92.98474131874548,25.019230923076922,24.92295167320771,-7.015258681254522
2014-10-22,25.709999,26.0275,25.65,25.747499,22.918896,273052400,1924334627.225637,3053452400,17.329553763522217,20.0,0.034843887121837724,60.23421486336458,87.45796192609188,25.039711653846155,24.9840292529701,-12.542038073908122
2014-10-23,26.02,26.262501,25.907499,26.2075,23.328365,284298800,2120539735.9292483,3337751200,17.466463017584,24.0,0.12708209513396795,64.58432512471333,97.7709836794392,25.07096165384615,25.074656715713058,-2.229016320560793
2014-10-24,26.295,26.372499,26.1325,26.305,23.415154,188215600,2202885188.2669644,3525966800,17.76574869829471,28.0,0.205678046196077,65.44711597182638,97.38122109843684,25.103942423076923,25.16579325528987,-2.6187789015631644
2014-10-27,26.2125,26.370001,26.174999,26.2775,23.390671,136750800,2209897977.8793797,3389216000,18.04365683038323,28.0,0.2627184289803921,64.96637470741382,96.31429536927071,25.14384626923077,25.248141903046175,-3.6857046307293
2014-10-28,26.35,26.684999,26.3375,26.684999,23.753401,192243600,2402141577.8793797,3581459600,18.806384522728138,36.0,0.33692128809653,68.64212537044065,100.0,25.198461653846152,25.354575762079794,-0.0
2014-10-29,26.6625,26.842501,26.59,26.834999,23.88693,210751600,2600369991.807247,3792211200,19.750424055008697,40.0,0.4031836844057963,69.8942839121922,99.75383108980115,25.243653923076923,25.464236742666476,-0.24616891019884143
2014-10-30,26.74,26.8375,26.475,26.745001,23.806812,162619200,2679998221.430419,3629592000,20.29568379825223,39.99999999999999,0.44332465377167907,68.1362896072689,96.80065732546109,25.293942423076924,25.559108169135627,-3.199342674538917
2014-10-31,27.002501,27.01,26.8025,27.0,24.0338,178557200,2841345088.900296,3808149200,21.08058747407022,48.0,0.4900637989583778,70.4074533543654,99.68895800933122,25.391346230769233,25.665840897347802,-0.3110419906687889
2014-11-03,27.055,27.575001,27.002501,27.35,24.345352,209130400,2886092784.514621,4017279600,22.59121177927855,52.0,0.549018242635043,73.22808156201049,94.04759416730316,25.474519307692308,25.790593423470188,-5.952405832696843
2014-11-04,27.34,27.372499,26.93,27.15,24.167311,166297600,2885153623.7427306,3850982000,23.7751356451993,52.0,0.5729965874798921,69.1708195041395,88.58291470785758,25.556153923076923,25.891290206916842,-11.417085292142424
2014-11-05,27.275,27.325001,27.032499,27.215,24.225187,149743600,2922269305.003029,4000725600,24.874493520697133,52.0,0.5904383495380507,69.75728732918915,89.32540292044303,25.63413469230769,25.989342784182263,-10.67459707955697
2014-11-06,27.15,27.1975,26.950001,27.174999,24.294468,139874000,3036710435.5853724,3860851600,25.620608109993157,52.0,0.5941839426088258,68.88878120184714,86.75490504804468,25.725673115384616,26.077169170539133,-13.245094951955332
2014-11-07,27.1875,27.33,27.137501,27.252501,24.36375,134766000,3062964388.935779,3995617600,26.52419487550594,52.0,0.596529692819729,69.67653211427101,85.7142983704997,25.813269307692305,26.164230787536233,-14.285701629500295
2014-11-10,27.254999,27.3325,27.1675,27.2075,24.323519,108782000,3006925176.814566,3886835600,27.367323188785715,52.0,0.5879796487648008,68.59053168448891,80.90904887841616,25.90182696153846,26.241509988459477,-19.090951121583853
2014-11-11,27.174999,27.4375,27.1,27.424999,24.517965,109769200,3108562674.4785657,3996604800,28.327336140333575,52.0,0.5919306211005164,70.94746495486748,91.00438860043342,25.99874996153846,26.329175841166183,-8.995611399566581
2014-11-12,27.344999,27.8575,27.342501,27.8125,24.864388,187769600,3263518105.9073634,4184374400,29.84293287589572,80.0,0.6191922248267829,74.60387140157218,97.391304347826,26.118942269230768,26.439051704783502,-2.60869565217401
2014-11-13,27.950001,28.362499,27.9,28.205,25.215284,238091600,3339450700.55427,4422466000,31.828612817972637,84.0,0.6648052508251183,77.66950532352577,92.80004571428564,26.234519153846154,26.569862689614354,-7.199954285714349
2014-11-14,28.2875,28.547501,27.8025,28.545,25.519241,176254400,3514521713.540293,4598720400,33.85260499780372,88.0,0.7200883310138444,79.92962858083749,99.88683263039253,26.361057653846157,26.716169157050327,-0.1131673696074686
2014-11-17,28.567499,29.32,28.325001,28.497499,25.476778,186986800,3392368846.0897737,4411733600,36.332975710772196,92.0,0.7514058971900361,78.73071876570984,71.08959578207383,26.48855757692308,26.848119515787342,-28.910404217926164
2014-11-18,28.485001,28.922501,28.4725,28.8675,25.80756,176896000,3526022911.534072,4588629600,38.63617708710007,92.0,0.7968951710068239,81.10781001707518,84.09490333919153,26.63913453846154,26.997703255358648,-15.905096660808463
2014-11-19,28.860001,28.934999,28.450001,28.6675,25.628759,167476800,3508757190.8506875,4421152800,40.689570673051335,92.0,0.8074990730455376,76.153376714574,74.08142999006954,26.792211461538464,27.12139190310986,-25.918570009930463
2014-11-20,28.727501,29.215,28.7125,29.077499,25.995304,173582000,3587343375.598946,4594734800,42.79828932746659,88.0,0.8393111777990008,78.98708476958817,89.85351464435143,26.972692192307697,27.26628872510172,-10.146485355648565
2014-11-21,29.377501,29.3925,29.0075,29.1175,26.031059,228717200,3489321718.456089,4823452000,44.87529119282465,100.0,0.8578613547106997,79.24620332024801,88.83248730964472,27.167019076923076,27.403415486205297,-11.167512690355279
2014-11-24,29.2125,29.692499,29.155001,29.657499,26.513824,189803200,3654406270.2006536,5013255200,46.98940228289748,100.0,0.9056956146305701,82.4012193249063,98.72379122974748,27.3685575,27.570384635375273,-1.2762087702525262
2014-11-25,29.7675,29.9375,29.362499,29.4,26.283613,275361600,3414962295.949477,4737893600,49.08944297023613,100.0,0.9123100505833932,76.43418007320413,82.00836217853123,27.540095923076926,27.70591169942155,-17.991637821468775
2014-11-26,29.485001,29.775,29.4575,29.75,26.596514,163073200,3552354677.051841,4900966800,51.039480751336306,96.0,0.9350158331608682,78.69273259189987,93.39207048458151,27.69903823076923,27.857325647612544,-6.607929515418506
2014-11-28,29.817499,29.85,29.512501,29.7325,26.580866,99257600,3582499373.013607,4801709200,52.894027831497176,92.0,0.9407538014690253,78.28871387483197,92.77533039647582,27.8523075,27.996227451493095,-7.224669603524172
2014-12-01,29.702499,29.8125,27.817499,28.7675,25.718163,335256000,3566534977.6353583,4466453200,49.7196008992119,88.0,0.8575484626623755,59.9964854061434,58.766519823788464,27.95076903846154,28.053358751382493,-41.233480176211536
2014-12-02,28.375,28.9375,28.1875,28.657499,25.619823,237395600,3626674563.2470927,4229057600,46.771918747804136,84.0,0.7738114540513266,58.323601527423925,50.67431625214507,28.04124976923077,28.098109880909718,-49.32568374785493
2014-12-03,28.9375,29.0875,28.7775,28.9825,25.910368,172253600,3682240240.6664505,4401311200,44.28477148090748,80.0,0.7253131771731383,61.7197559625435,55.26932084309145,28.14528823076923,28.16362026010159,-44.73067915690855
2014-12-04,28.942499,29.299999,28.8225,28.872499,25.812025,168178000,3549282133.5751266,4233133200,42.321870204384915,72.0,0.6702752659190239,59.939402323028155,50.11704918032796,28.22942284615385,28.216129796390362,-49.88295081967204
2014-12-05,28.997499,29.02,28.66,28.75,25.702515,153275600,3472644333.5751266,4079857600,40.1369644748183,72.0,0.6097439307094596,57.93518385549513,43.98587547836058,28.30307673076923,28.255675737398484,-56.01412452163942
2014-12-08,28.525,28.6625,27.905001,28.1,25.121412,230659600,3360739718.968904,3849198000,37.856226253575024,68.0,0.5035185947964465,48.64119074853841,13.32551258230539,28.355192076923075,28.244144201294894,-86.6744874176946
2014-12-09,27.547501,28.575001,27.3375,28.530001,25.505823,240832000,3584056678.577017,4090030000,36.566010486252715,60.0,0.44885758694669065,53.908856737144795,45.86542307692305,28.41403826923077,28.265318778976752,-54.13457692307695
2014-12-10,28.602501,28.7125,27.885,27.987499,25.02084,178261200,3449956432.6284966,3911768800,35.09512279350812,60.0,0.35764031199948576,47.31527741061162,24.999961538461566,28.438557461538462,28.244739536089583,-75.00003846153844
2014-12-11,28.065001,28.450001,27.834999,27.905001,24.94709,165606800,3322049696.0871515,3746162000,33.80331875688769,52.00000000000001,0.2755170759354364,46.38614805132442,21.82696153846153,28.467595961538457,28.219573718601467,-78.17303846153847
2014-12-12,27.615,27.967501,27.395,27.432501,24.524668,224112400,3127297730.784732,3522049600,33.22410446368532,52.0,0.17034340578912577,41.37480813457676,3.653884615384609,28.475961384615385,28.1612720357421,-96.34611538461539
2014-12-15,27.674999,27.9,26.5875,27.057501,24.189425,268872400,3050989592.6855316,3253177200,33.595847352279606,-52.0,0.05608661686208549,37.8773002165298,14.029880597014916,28.471442230769227,28.079511218279723,-85.97011940298508
2014-12-16,26.592501,27.540001,26.565001,26.6875,23.858639,243162800,2868928741.0695324,3010014400,33.96353697820592,-56.0,-0.06358572337262913,34.75551674442052,3.729042231063119,28.449711423076923,27.976399276184928,-96.27095776893687
2014-12-17,26.780001,27.459999,26.705,27.352501,24.453146,213647200,3021737061.2681026,3223661600,34.304963059423216,-56.0,-0.10357296744971478,43.73169872578528,23.972610037324237,28.45528838461539,27.93018458906012,-76.02738996267577
2014-12-18,27.967501,28.1625,27.665001,28.1625,25.177288,236024800,3257761861.2681026,3459686400,33.073001845145654,-56.0,-0.06910638127136437,52.33381175047552,49.19167026687312,28.483653807692306,27.94739313801863,-50.808329733126875
2014-12-19,28.065001,28.309999,27.915001,27.945,24.982849,353719200,2957770641.059393,3105967200,31.64362019380571,-56.0,-0.05866553590346868,50.118187260713675,50.45703872543969,28.48874996153846,27.947215868535768,-49.542961274560305
2014-12-22,28.040001,28.372499,27.9925,28.235001,25.242105,180670000,3007694172.463423,3286637200,30.192469072783005,-56.0,-0.026682850377014233,52.9767724618758,61.06037371873768,28.489903846153847,27.968533285681268,-38.93962628126232
2014-12-23,28.307501,28.3325,28.115,28.135,25.152704,104113600,2922727901.199058,3182523600,28.844971603261918,-56.0,-0.009298400458828127,51.87285004049297,57.40402735212246,28.474134615384614,27.980864153408582,-42.59597264787754
2014-12-24,28.145,28.1775,28.002501,28.002501,25.03425,57918400,2864809501.199058,3124605200,27.790233429528563,-56.0,-0.006141861059010267,50.37502437313844,58.55399533767629,28.45509623076923,27.982466882785726,-41.44600466232371
2014-12-26,28.025,28.629999,28.002501,28.497499,25.476778,134884000,2942730355.499789,3259489200,25.84547425927285,-56.0,0.03588822378197776,55.53997727792599,89.98830732866477,28.44086542307692,28.020617409986784,-10.01169267133523
2014-12-29,28.4475,28.692499,28.424999,28.477501,25.4589,110395600,2875669258.611565,3149093600,24.0835016228884,-56.0,0.0668135127738374,55.28961010238989,89.05708454346203,28.433557769230767,28.05446063887665,-10.942915456537975
2014-12-30,28.41,28.48,28.0275,28.129999,25.148237,119526000,2810292630.8723392,3029567600,23.04540943553125,-56.0,0.0625603629780187,50.988328329487814,72.87537735756817,28.39711546153846,28.060056073033934,-27.124622642431827
2014-12-31,28.205,28.282499,27.5525,27.594999,24.669943,165613600,2663962378.894461,2863954000,22.857190145721233,-56.0,0.01583712182199548,45.16302497691198,48.413582527457194,28.33855773076923,28.025607400957348,-51.586417472542806
2015-01-02,27.8475,27.860001,26.8375,27.3325,24.435265,212818400,2657197778.352848,2651135600,23.608641834463537,-56.00000000000001,-0.0418899773381014,42.591843307963806,36.075192550122246,28.249134692307692,27.974266111997544,-63.924807449877754
2015-01-05,27.0725,27.1625,26.352501,26.5625,23.746889,257142000,2533388196.9311423,2393993600,24.812551090270922,-96.0,-0.14806488434571463,36.09953540765312,8.974323909678542,28.140000076923076,27.869690844442168,-91.02567609032145
2015-01-06,26.635,26.8575,26.157499,26.565001,23.749128,263188400,2576627357.396911,2657182000,26.117688946845213,-100.0,-0.2293634937181146,36.13358820853709,16.075029585798713,28.017500115384617,27.773047152261267,-83.92497041420128
2015-01-07,26.799999,27.049999,26.674999,26.9375,24.08213,160423600,2640797652.9894447,2817605600,26.872646520033502,-96.0,-0.26073013646038845,41.162767972442005,30.769270216962468,27.91000011538462,27.711154770612286,-69.23072978303753
2015-01-08,27.307501,28.0375,27.174999,27.9725,25.007435,237458000,2842464923.4714494,3055063600,25.639772145690767,-84.0,-0.19976975528740937,52.382681286734545,71.59767258382637,27.87942319230769,27.73051367649286,-28.402327416173623
2015-01-09,28.1675,28.3125,27.5525,28.002501,25.03425,214798000,2882033541.360923,3269861600,24.05593865056007,-84.0,-0.14733895231384864,52.664457734210316,72.78114398422079,27.854230961538462,27.750660885641537,-27.2188560157792
2015-01-12,28.15,28.157499,27.200001,27.3125,24.417383,198603200,2730099183.2734904,3071258400,23.080614719765755,-84.0,-0.15962442631104423,45.93226843523717,45.56216962524649,27.790000192307694,27.718204523742166,-54.4378303747535
2015-01-13,27.8575,28.200001,27.227501,27.555,24.63418,268367600,2642482474.0342097,3339626000,22.1020722245489,-80.0,-0.14808598655031702,48.427460199266186,55.12824457593681,27.73932715384615,27.706115299761265,-44.87175542406319
2015-01-14,27.26,27.622499,27.125,27.450001,24.540316,195826400,2702510963.4969015,3143799600,21.34515918930486,-68.0,-0.14573429743236588,47.40729832519491,50.986272189349066,27.689327192307694,27.68714387014932,-49.013727810650934
2015-01-15,27.5,27.514999,26.665001,26.705,23.874289,240056000,2485047957.701593,2903743600,21.285567163757996,-68.0,-0.20166129544613298,40.83436041536351,21.597672583826306,27.635673346153848,27.614392472360482,-78.40232741617369
2015-01-16,26.7575,26.895,26.299999,26.497499,23.688776,314053200,2379483506.46,2589690400,21.68447003871364,-68.0,-0.25973339593616984,39.20396718891844,13.412228796844175,27.557500192307693,27.531659622556003,-86.58777120315582
2015-01-20,26.959999,27.2425,26.625,27.18,24.298935,199599600,2538678329.132065,2789290000,21.367902400910655,-20.0,-0.24782703140914464,46.736850335690995,44.025858331169665,27.526442538461538,27.505610761625928,-55.97414166883033
2015-01-21,27.237499,27.764999,27.067499,27.387501,24.48444,194303600,2522661583.919735,2983593600,20.158281369312277,-20.0,-0.21912165713402132,48.81340705696932,57.07663244703829,27.506538692307693,27.496861890394378,-42.92336755296171
2015-01-22,27.565001,28.1175,27.43,28.1,25.121412,215185600,2726892280.647009,3198779200,18.95067646209167,-20.000000000000007,-0.13729705156651306,55.263003301741016,90.13921571266098,27.532211730769234,27.541538787402203,-9.860784287339019
2015-01-23,28.075001,28.4375,27.8825,28.245001,25.251043,185859200,2783822795.4549356,3384638400,18.29312223049781,-20.0,-0.06005778450859012,56.465223568251346,91.55706510655033,27.57788480769231,27.593647099446482,-8.44293489344968
2015-01-26,28.434999,28.59,28.200001,28.275,25.277866,222460000,2646923412.4821568,3607098400,17.897195967247406,-19.999999999999996,0.0035348125824690158,56.72433195131819,87.0503650358211,27.638942500000002,27.64411768467267,-12.949634964178903
2015-01-27,28.105,28.120001,27.2575,27.285,24.392805,382274800,2289025527.987182,3224823600,17.16912461651867,-20.0,-0.025656569327185963,46.82066883513559,43.013125321779356,27.636346307692307,27.617516374696915,-56.986874678220644
2015-01-28,29.407499,29.530001,28.827499,28.827499,25.771799,585908400,1703117127.9871821,3810732000,17.132423533812023,60.0,0.07481342569320049,58.86992742365427,78.25072554134644,27.661923192307693,27.707144717311955,-21.749274458653563
2015-01-29,29.08,29.797501,28.889999,29.725,26.574167,337745600,1986897240.8684769,4148477600,17.3612839981004,64.0,0.22427218047334918,63.98338936748084,97.92706337265858,27.73038473076923,27.856615478992552,-2.072936627341429
2015-01-30,29.6,30.0,29.2125,29.290001,26.185282,334982000,1717849056.6957798,3813495600,17.771566778037062,68.0,0.304112912218784,60.08437276128893,80.81084302409649,27.77096165384615,27.962792184252365,-19.189156975903515
2015-02-02,29.512501,29.7925,29.02,29.657499,26.513824,250956400,1881091890.4656186,4064452000,17.85042002060319,68.0,0.39251659763507973,62.181128375166,90.74321871804904,27.82951930769231,28.08832602245589,-9.256781281950966
2015-02-03,29.625,29.772499,29.4025,29.6625,26.518284,207662800,1965280300.8742971,4272114800,17.923640888700312,68.0,0.45770456087992173,62.210219852718424,90.8783808436809,27.893365423076922,28.204931502273975,-9.121619156319108
2015-02-04,29.625,30.127501,29.577499,29.889999,26.721668,280598800,2003542614.1066132,4552713600,18.388305099865956,80.0,0.5217098134406406,63.58259708513151,93.79485627963096,27.946923115384614,28.329751316920348,-6.205143720369036
2015-02-05,30.004999,30.057501,29.8125,29.985001,26.912403,168984800,2072516410.0698972,4721698400,18.819779010234054,80.0,0.5734894749803416,64.16780539837382,96.2769451198197,28.004903884615388,28.452362404555878,-3.7230548801802934
2015-02-06,30.004999,30.0625,29.612499,29.7325,26.68577,174826400,1990931326.5398622,4546872000,18.839919916974377,80.0,0.5873795633663725,61.3461506696486,88.7223158537286,28.06653853846154,28.547187411625814,-11.277684146271397
2015-02-09,29.637501,29.959999,29.6075,29.93,26.863041,155559200,2120013172.3300629,4702431200,18.848829493219846,80.0,0.6073233128042475,62.72676523143657,93.54572317272998,28.15634626923077,28.649617973727604,-6.454276827270022
2015-02-10,30.0425,30.5375,30.040001,30.504999,27.379118,248034000,2335639657.8064156,4950465200,19.58218560815818,96.0,0.6618965602236138,66.48048695590634,99.00911585365854,28.278365461538463,28.78705360530334,-0.9908841463414597
2015-02-11,30.692499,31.23,30.625,31.219999,28.020851,294247200,2620158704.923111,5244712400,20.968168381944558,100.0,0.754147434296069,70.46379035410695,99.7482441787288,28.45750003846154,28.967271782688275,-0.25175582127121554
2015-02-12,31.514999,31.870001,31.3925,31.615,28.375374,297898000,2599882343.411826,5542610400,22.785615399152157,72.0,0.84933953866285,72.41412563323088,94.47152423381588,28.651730769230767,29.16339979878544,-5.528475766184119
2015-02-13,31.82,31.82,31.4125,31.77,28.514488,217088800,2763697818.258451,5759699200,24.473244772273496,72.0,0.9266058365153107,73.16299614499032,97.83195710960283,28.837596153846157,29.356481295171704,-2.1680428903971825
2015-02-17,31.872499,32.220001,31.73,31.9575,28.682779,252609600,2745653796.6960435,6012308800,26.350656127981274,80.0,0.9915397640462693,74.07966982594667,92.26231848942156,28.990865384615386,29.549149347381206,-7.737681510578433
2015-02-18,31.907499,32.195,31.862499,32.18,28.882477,179566800,2909019129.632786,6191875600,28.093966672567067,80.0,1.0488636130913633,75.16379492136404,98.79876949022842,29.15153842307692,29.744027173501117,-1.201230509771576
2015-02-19,32.119999,32.2575,32.0825,32.112499,28.821896,149449600,2810807684.494495,6042426000,29.763682734904755,88.0,1.0764379037894685,74.15054152024692,95.52120463320462,29.33615376923077,29.91946953101955,-4.478795366795384
2015-02-20,32.154999,32.375,32.012501,32.375,29.057499,195793600,3006601284.494495,6238219600,31.41285548215021,92.0,1.1067148448915205,75.5319260693733,100.0,29.521538384615383,30.101360676869955,-0.0
2015-02-23,32.505001,33.25,32.415001,33.25,29.842831,283896400,3290497684.494495,6522116000,33.57038710833471,96.0,1.187624529858759,79.47022827886946,100.0,29.74461526923077,30.33459321932403,-0.0
2015-02-24,33.235001,33.400002,32.7925,33.0425,29.656599,276912400,3241495974.5004525,6245203600,35.66479255957016,100.0,1.220928419450079,76.33251290074283,90.64743703275043,29.98836526923077,30.53517890678151,-9.352562967249565
2015-02-25,32.889999,32.900002,32.037498,32.197498,28.898184,298846800,3053525154.206056,5946356800,35.83568515396796,96.0,1.1656999293070989,65.06604432778572,68.29259417661487,30.207596,30.658313654427324,-31.70740582338514
2015-02-26,32.197498,32.717499,31.6525,32.605,29.263927,365150000,3341531401.3011236,6311506800,35.23252450674766,92.0,1.1416526970947096,67.5532204465025,79.03753247855892,30.416249846153846,30.802512642988262,-20.962467521441095
2015-02-27,32.5,32.642502,32.060001,32.115002,28.824141,248059200,3140316770.0115614,6063447600,34.672446762900236,76.0,1.0707138263061466,61.85087085070614,66.11735471728151,30.598076807692305,30.899734076840982,-33.88264528271848
2015-03-02,32.3125,32.57,32.075001,32.272499,28.965498,192386800,3101449505.309211,6255834400,34.152374572184776,76.0,1.0154969352175982,62.93391742263148,66.44337308232953,30.758557538461538,31.001420367445355,-33.55662691767047
2015-03-03,32.240002,32.380001,32.022499,32.34,29.026083,151265200,3218864493.197393,6407099600,33.55127081088071,76.0,0.9660479187212445,63.4133284392137,61.80175725999488,30.9160575,31.100574414301256,-38.19824274000512
2015-03-04,32.275002,32.389999,32.080002,32.134998,28.842085,126665200,3137142175.478191,6280434400,33.00719403639413,76.0,0.89994328279138,60.839670934165426,36.98616489547726,31.06451896153846,31.177198383612275,-63.01383510452274
2015-03-05,32.145,32.1875,31.440001,31.602501,28.364151,226068400,3009364515.666473,6054366000,31.10967615440308,72.0,0.7954177442960031,54.63671708790621,9.559789122224723,31.230576692307693,31.208702281122477,-90.44021087777527
2015-03-06,32.099998,32.342499,31.565001,31.65,28.406786,291368400,2781703090.1708446,6345734400,29.607003852653005,68.0,0.7082490204686138,55.0766995178386,10.714229227434048,31.339134423076924,31.241391001039332,-89.28577077256595
2015-03-09,31.99,32.392502,31.264999,31.785,28.527954,354114000,2754221718.4015455,6699848400,27.62334222079139,60.0,0.6426524531341222,56.371883042521375,24.35598451149719,31.41836519230769,31.281658334295678,-75.64401548850282
2015-03-10,31.602501,31.805,30.950001,31.127501,27.937824,275426400,2593153781.978695,6424422000,26.08657766507746,60.0,0.5314853937907529,48.96713387440028,7.244895002083608,31.48903826923077,31.270239272496,-92.7551049979164
2015-03-11,31.1875,31.192499,30.5275,30.559999,27.42848,275756000,2344350587.152839,6148666000,25.338769878696734,56.00000000000001,0.39306106645574346,43.63895129906504,1.1313830242764453,31.523749807692305,31.21762888194074,-98.86861697572355
2015-03-12,30.577499,31.225,30.407499,31.112499,27.924366,193450800,2484557639.559135,6342116800,24.82547376573401,52.0,0.3242037038262495,49.41040463045001,23.558873625189296,31.579519,31.209841483278467,-76.44112637481071
2015-03-13,31.1,31.35,30.645,30.897499,27.731396,207309200,2425745930.8805532,6134807600,24.07366358258886,40.0,0.24941000143760306,47.37726605882606,16.374252590557088,31.618268999999998,31.18670500303562,-83.62574740944292
2015-03-16,30.969999,31.237499,30.717501,31.237499,28.036556,143497200,2569243130.8805532,6278304800,23.37555412681122,40.0,0.21509117476345097,50.82340041127231,33.299859619025476,31.666442,31.190467521329275,-66.70014038097453
2015-03-17,31.475,31.83,31.4125,31.76,28.50551,204092400,2704897360.820676,6482397200,21.92540466690003,40.0,0.2274330151211501,55.63202924052977,58.54982683982698,31.74442276923077,31.232655112341924,-41.45017316017303
2015-03-18,31.75,32.290001,31.592501,32.1175,28.82638,261083600,2836842087.462685,6743480800,21.359484756610332,36.0,0.26302923745130613,58.613913133017654,76.51000915882436,31.828557384615383,31.29819917809437,-23.489990841175644
2015-03-19,32.1875,32.3125,31.85,31.875,28.608728,183238000,2673413600.9761977,6560242800,20.8702550048556,-48.0,0.2685758020979918,55.870904072504835,67.86128653813336,31.881249730769227,31.340925164902195,-32.13871346186664
2015-03-20,32.0625,32.099998,31.290001,31.475,28.249722,274780400,2524149960.2224674,6285462400,19.460651551965096,-48.0,0.23795187636991955,51.58280863231028,53.778306632282195,31.891057461538463,31.3508566341687,-46.221693367717805
2015-03-23,31.780001,31.9625,31.629999,31.8025,28.543661,150838800,2529821028.3960958,6436301200,18.15173405999534,-48.0,0.23737242599755604,54.65166184974712,70.27702225135164,31.898269000000003,31.38431169830435,-29.72297774864835
2015-03-24,31.807501,32.009998,31.639999,31.672501,28.426983,131369200,2421531683.9546247,6304932000,16.86985953147674,-48.0,0.22384305119302894,53.20993611074657,63.727964139097004,31.894519038461535,31.40565905398551,-36.272035860902996
2015-03-25,31.635,31.705,30.844999,30.844999,27.684275,206620800,2214910883.9546247,6098311200,17.031115541239092,-48.0,0.1446806401502414,45.06111256629166,22.04026895677237,31.85173053846154,31.364128679616215,-77.95973104322763
2015-03-26,30.690001,31.219999,30.65,31.059999,27.877245,190291600,2298371924.6027665,6288602800,17.460971799260093,-48.0,0.09816102306372798,47.318541351631104,32.871486844100495,31.808653576923078,31.3416005552002,-67.12851315589951
2015-03-27,31.1425,31.174999,30.727501,30.8125,27.655107,158184800,2200279235.920359,6130418000,17.860124038851023,-48.00000000000001,0.04085187551088865,45.024994888922706,21.259883853079284,31.758653615384613,31.302407921481667,-78.74011614692071
2015-03-30,31.012501,31.6,31.0,31.592501,28.355177,188398800,2383968693.9163575,6318816800,17.271074499371668,-48.0,0.057708299787030626,52.7911492193307,62.204796742888746,31.728557499999997,31.32389629766821,-37.795203257111254
2015-03-31,31.522499,31.622499,31.09,31.1075,27.91988,168362400,2226672387.9371924,6150454400,16.675662669830952,-48.0,0.03156771709982564,48.22888802892258,36.745440028640445,31.646153653846156,31.30786694228538,-63.254559971359555
2015-04-01,31.205,31.280001,30.775,31.0625,27.879488,162485600,2249194778.0203815,5987968800,16.67774768414845,-44.0,0.007137713944889157,47.81598629163136,25.037481259370335,31.56999980769231,31.289691613227205,-74.96251874062966
2015-04-02,31.2575,31.389999,31.047501,31.33,28.119577,128880400,2332920490.2873135,6116849200,16.420534630866765,-40.0,0.009255087952332985,50.527425835035466,40.90225563909769,31.536634499999998,31.292677419654822,-59.09774436090231
2015-04-06,31.1175,31.877501,31.0825,31.8375,28.575071,148776000,2466724965.0288544,6265625200,15.357165796909271,-36.0,0.05129285860828503,55.27537536462693,71.42857142857137,31.507115269230773,31.33303464782854,-28.571428571428633
2015-04-07,31.91,32.029999,31.495001,31.502501,28.274406,140049200,2330602392.791949,6125576000,14.663118623519692,-32.0,0.0569203329557304,51.74514275441839,51.27825563909771,31.48355753846154,31.345587710952355,-48.72174436090229
2015-04-08,31.4625,31.6,31.2425,31.4,28.182404,149316800,2312851444.540199,5976259200,13.735231386606213,-12.000000000000004,0.052503940117340164,50.67863069857158,45.11278195488718,31.449999884615384,31.34961825088181,-54.88721804511282
2015-04-09,31.4625,31.645,31.165001,31.639999,28.397816,129936000,2440079897.499476,6106195200,13.030735978978443,-12.0,0.06759068715145133,53.11528262577309,68.27588727708593,31.423076769230764,31.371127936001677,-31.72411272291407
2015-04-10,31.487499,31.8025,31.315001,31.775,28.518976,160752000,2582695737.220173,6266947200,12.169675635645495,-12.0,0.08940983440436767,54.47765318416286,81.52179820420172,31.40923069230769,31.40104438518674,-18.478201795798284
2015-04-13,32.092499,32.142502,31.6525,31.7125,28.462883,145460400,2472858146.92299,6121486800,12.062490736462081,-12.0,0.10049993741558083,53.69968223783131,71.1891843361013,31.413461423076924,31.424115171469204,-28.810815663898694
2015-04-14,31.75,31.8225,31.477501,31.575001,28.339478,102098400,2428467705.496783,6019388400,11.556128916221796,-12.0,0.09707488493245364,51.942283806774014,61.976533364779456,31.410576846153845,31.43529189950852,-38.023466635220544
2015-04-15,31.602501,31.782499,31.502501,31.695,28.447172,115881600,2471923615.8961425,6135270000,11.085935797427245,20.000000000000004,0.10285774256039559,53.376344750110846,70.01665659409505,31.407115307692308,31.454529536581965,-29.983343405904954
2015-04-16,31.57,31.775,31.5275,31.5425,28.310305,113476000,2372202282.56281,6021794000,10.649327901403735,20.0,0.09405106129955243,51.282008517423165,57.597061768860954,31.423076807692308,31.461045867205524,-42.402938231139046
2015-04-17,31.387501,31.535,31.115,31.1875,27.991684,207828000,2236124425.419954,5813966000,10.520017664026758,20.0,0.05776034451342582,46.68940351152519,30.164489704585506,31.447211461538465,31.440783210375486,-69.8355102954145
2015-04-20,31.3925,32.029999,31.2925,31.9,28.631168,188217200,2357987507.56271,6002183200,10.267054469658543,16.0,0.08550681603981047,55.33512748734109,82.26679010341473,31.47749996153846,31.474799268866192,-17.73320989658527
2015-04-21,32.025002,32.049999,31.6675,31.727501,28.476345,129740400,2268950762.9469066,5872442800,10.073912498741274,-20.0,0.09251046391900175,53.090268119024714,69.65262208026024,31.509423115384614,31.493517915616845,-30.347377919739763
2015-04-22,31.747499,32.217499,31.58,32.154999,28.860039,150618000,2390035775.444181,6023060800,10.248703836764681,-20.000000000000004,0.13104580668567678,57.673128086984434,94.65811052668464,31.544711576923078,31.54251651446004,-5.341889473315357
2015-04-23,32.075001,32.605,32.035,32.4175,29.095638,183083600,2452669638.6020756,6206144400,11.14756030759973,76.0,0.18068416575716384,60.24165151266895,87.68472906403937,31.570000038461536,31.607330105981518,-12.315270935960614
2015-04-24,32.622501,32.657501,32.307499,32.57,29.232508,178103600,2541720929.7375526,6384248000,12.075410469822913,80.0,0.2296807813743449,61.695892140341364,94.32732944743614,31.587403884615387,31.678638987019923,-5.672670552563847
2015-04-27,33.077499,33.282501,32.787498,33.162498,29.764305,387816800,2741501780.6608753,6772064800,13.90234347609859,84.0,0.3127157961014895,66.77994455017364,94.46353196607505,31.63692303846154,31.78855446946289,-5.536468033924958
2015-04-28,33.615002,33.634998,32.392502,32.639999,29.295334,475696000,2455316785.7860446,6296368800,14.535521466267342,88.0,0.332527174635846,59.30452216778944,60.515881361810685,31.681730692307692,31.85162443468786,-39.48411863818932
2015-04-29,32.540001,32.897499,32.075001,32.16,28.864525,253544400,2254176210.3682294,6042824400,14.372867896296388,88.0,0.3059689079646297,53.39159990081934,41.46828687959261,31.69548069230769,31.874467069155425,-58.53171312040739
2015-04-30,32.16,32.16,31.145,31.2875,28.081429,332781600,2014835749.284487,5710042800,14.175401253656366,88.0,0.21207318441351575,44.67262180336323,6.84524352797116,31.680672961538463,31.830988026995765,-93.15475647202884
2015-05-01,31.525,32.532501,31.325001,32.237499,28.934078,234050400,2134525344.1485853,5944093200,13.322363018485502,88.0,0.21187476642430525,53.56435684188369,44.543646463211445,31.73423065384615,31.861099950922007,-55.456353536788555
2015-05-04,32.375,32.642502,32.064999,32.174999,28.877989,203953200,2008268197.6755795,5740140000,12.401279331230905,84.0,0.2043190284963039,52.9613159775983,42.06348576467121,31.77711526923077,31.884351732335194,-57.93651423532879
2015-05-05,32.037498,32.112499,31.445,31.450001,28.227282,197085600,1814135785.8769102,5543054400,12.463364517448653,72.0,0.13823627053566412,46.43118239002637,13.293701026746897,31.80163453846154,31.852177604014067,-86.7062989732531
2015-05-06,31.639999,31.6875,30.84,31.252501,28.05002,288564000,1806475475.703458,5254490400,13.297638843040989,72.0,0.06913170209885422,44.81028335801888,14.758543655487353,31.78855761538462,31.80775711482784,-85.24145634451264
2015-05-07,31.192499,31.52,31.004999,31.315001,28.223516,175763600,1842311727.0715125,5430254000,14.072322145376729,72.0,0.019187875521879505,45.45916517058149,16.994681212651972,31.79653842307692,31.77125666187763,-83.00531878734802
2015-05-08,31.67,31.905001,31.5275,31.905001,28.75527,222201600,2064513327.0715125,5652455600,14.040719055735272,-24.0,0.026904958682123947,51.28222868777482,38.10381975228596,31.82894230769231,31.781163649886693,-61.89618024771404
2015-05-11,31.8475,31.889999,31.407499,31.58,28.462355,168143200,2016597568.0795937,5484312400,14.181897941379619,-24.0,0.006718491543484362,48.22770358788355,26.47586867682902,31.838557692307692,31.766262638783974,-73.52413132317098
2015-05-12,31.4,31.719999,31.205,31.467501,28.360958,192640000,2020339280.044082,5291672400,14.599906475370526,-24.0,-0.018147959822041315,47.18012988594048,22.450856852133633,31.82432696153846,31.7441321470222,-77.54914314786636
2015-05-13,31.5375,31.797501,31.467501,31.502501,28.392504,138776800,1910999983.074385,5430449200,14.822303962637733,-23.999999999999993,-0.034631385138943926,47.56175785383412,23.703093884145826,31.82432696153846,31.726233543539074,-76.29690611585417
2015-05-14,31.852501,32.237499,31.790001,32.237499,29.054945,180814000,2091813983.074385,5611263200,14.14004886011591,-24.0,0.011481229044555619,54.926637003747935,49.99999999999993,31.85653846153846,31.764105058832477,-50.000000000000064
2015-05-15,32.267502,32.372501,32.052502,32.192501,29.014393,152832000,2072709445.7727077,5458431200,13.252760051046428,-24.0,0.043888921307473794,54.42268497050112,48.390052515243255,31.877788538461537,31.795838091511555,-51.609947484756745
2015-05-18,32.095001,32.68,32.09,32.547501,29.334341,203531600,2184825000.117112,5661962800,12.738902506095046,-24.0,0.09709849306551632,57.71859556271751,82.98915333616172,31.90750011538461,31.851516825473663,-17.010846663838276
2015-05-19,32.672501,32.720001,32.41,32.517502,29.307302,178532800,2130115239.8208566,5483430000,12.332856365511478,-24.0,0.1352872858324723,57.341234719618235,89.22878232511565,31.93846173076923,31.90084906062376,-10.77121767488436
2015-05-20,32.5,32.744999,32.334999,32.514999,29.305046,145819600,2112332361.7720768,5337610400,11.795618948272946,-24.0,0.16346587519879563,57.30756869651519,87.92650284855809,31.974615500000002,31.946341648725706,-12.07349715144191
2015-05-21,32.517502,32.907501,32.4575,32.8475,29.604727,158921600,2228874256.29764,5496532000,11.613623304993581,-24.000000000000007,0.21020455489949086,60.6155732237379,97.09789741335037,32.01894242307692,32.01309411919047,-2.9021025866496197
2015-05-22,32.900002,33.2425,32.849998,33.134998,29.863832,182384000,2311352295.21719,5678916000,12.05242984266799,-23.999999999999996,0.2673619984837998,63.26596683577579,95.52541103017704,32.080192346153844,32.09619811036155,-4.474588969822962
2015-05-26,33.150002,33.227501,32.279999,32.404999,29.205906,282790400,2103176618.9855828,5396125600,11.226648283016164,-24.0,0.2508630725343721,53.433325992872845,65.14043704474493,32.12701923076923,32.11907225033477,-34.85956295525508
2015-05-27,32.584999,33.064999,32.512501,33.009998,29.751181,183332800,2250007975.241716,5579458400,10.459851120482325,-24.0,0.28333975365622166,59.10587230625476,89.60885380609899,32.16971146153846,32.18506675030997,-10.391146193901001
2015-05-28,32.965,32.987499,32.775002,32.945,29.6926,122933200,2323768358.0555916,5456525200,9.74782518384376,-24.0,0.30037047814022344,58.2844144484206,85.398773006135,32.21653834615385,32.24135810213886,-14.601226993864993
2015-05-29,32.807499,32.862499,32.474998,32.57,29.354624,203538000,2220031478.9610868,5252987200,9.647456878453763,-24.0,0.2803760830420501,53.651517649236105,66.9938650306749,32.23249992307692,32.26570194642487,-33.0061349693251
2015-06-01,32.57,32.8475,32.512501,32.634998,29.413191,128451200,2185520181.1482606,5381438400,9.55425773773448,-24.0,0.26670081528089185,54.32914778706979,70.18395092024558,32.24086523076923,32.29305720965266,-29.816049079754418
2015-06-02,32.465,32.665001,32.330002,32.490002,29.282516,134670400,2179490547.2400985,5246768000,9.850051259971027,-24.000000000000004,0.2413806161485752,52.48566695298776,57.60572259477316,32.237788384615385,32.30764571264135,-42.39427740522684
2015-06-03,32.665001,32.735001,32.474998,32.529999,29.318565,123934000,2107990510.9558995,5370702000,9.933427462576558,-24.0,0.22198272091785753,52.9598332335114,50.946541099167476,32.2134615,32.32411632651977,-49.053458900832524
2015-06-04,32.395,32.645,32.227501,32.34,29.147322,153800400,2037076015.830406,5216901600,10.53397599637726,48.0,0.18909860675227463,50.387442563056254,24.159536402582678,32.20192307692308,32.32529289492572,-75.84046359741733
2015-06-05,32.375,32.422501,32.09,32.162498,28.987343,142507200,1956712911.551018,5074394400,11.365375601297284,48.0,0.14702002606126996,48.03981983223498,6.2904989154009705,32.20201915384616,32.31323401382011,-93.70950108459903
2015-06-08,32.224998,32.302502,31.7075,31.950001,28.79582,210699200,1917760249.2070272,4863695200,12.822641935949692,48.0,0.0954257075590661,45.31769499828515,15.798110749185716,32.22749996153846,32.28632786464825,-84.20188925081429
2015-06-09,31.674999,32.02,31.405001,31.855,28.710203,224301600,2021704697.4067793,4639393600,14.63887853424975,48.00000000000001,0.046336908646409825,44.114197726422184,24.48975482435645,32.212788461538466,32.254377652452085,-75.51024517564356
2015-06-10,31.98,32.334999,31.9625,32.220001,29.039171,156349200,2081517556.0925758,4795742800,15.374540319736136,48.0,0.03646585640833422,49.64709251111418,44.353765634702626,32.214519307692306,32.25183123375193,-55.646234365297374
2015-06-11,32.294998,32.544998,32.119999,32.147499,28.973825,141563600,1958273994.4926684,4654179200,15.48062073344566,48.0,0.02253292537955076,48.617456387152,40.40807641255883,32.24134615384615,32.244102920140676,-59.59192358744117
2015-06-12,32.047501,32.0825,31.7775,31.7925,28.653872,147544800,1825241797.7713573,4506634400,16.184782286885635,44.0,-0.016958982695761904,43.824845490595244,21.261947873799848,32.26211534615384,32.21065085198211,-78.73805212620016
2015-06-15,31.525,31.809999,31.4275,31.73,28.597549,175955600,1927595782.8944554,4330678800,17.37680031278199,32.0,-0.05269242654171791,43.02077206562968,19.578276600333343,32.278076846153844,32.17504708516862,-80.42172339966665
2015-06-16,31.7575,31.9625,31.592501,31.9,28.750761,125976400,2011012473.2736187,4456655200,18.054586761328185,32.0,-0.06652697740060631,45.92687105402199,31.279597193803696,32.2778845,32.15467322700798,-68.7204028061963
2015-06-17,31.93,31.969999,31.684999,31.825001,28.68317,131672400,2008704279.2020388,4324982800,18.662316249243833,32.0,-0.08259069699203536,44.84031109985287,28.816506094691135,32.28730761538462,32.13025306204443,-71.18349390530886
2015-06-18,31.807501,32.077499,31.805,31.969999,28.81385,141628800,2038588845.2782443,4466611600,18.905154803238386,-44.0,-0.08266823573754323,47.42982065307207,39.16799942322342,32.30663446153846,32.11838239078188,-60.83200057677658
2015-06-19,31.9275,31.955,31.6,31.65,28.52544,218867600,1881374090.3486638,4247744000,19.509540979038828,-44.0,-0.10731388306536616,42.6690232194402,18.420977443609043,32.3123075,32.083687398872115,-81.57902255639095
2015-06-22,31.872499,32.014999,31.77,31.9025,28.753016,136157200,1892489564.9310071,4383901200,19.87969215486375,-44.0,-0.10525775053798725,47.174772685693306,37.405939849624204,32.299422923076925,32.070266110066775,-62.594060150375796
2015-06-23,31.870001,31.9025,31.719999,31.7575,28.62233,121075600,1821172115.0299096,4262825600,20.32291646156867,-44.0,-0.1140142535374693,44.988182232663505,28.427361634969092,32.28269211538462,32.04709825006183,-71.57263836503091
2015-06-24,31.8025,32.450001,31.780001,32.0275,28.865671,221123600,1763415290.7803602,4483949200,19.121654669495094,-44.00000000000001,-0.09803699231441243,49.66655411141447,54.605319136805115,32.26269207692308,32.045646527835025,-45.394680863194885
2015-06-25,32.215,32.299999,31.875,31.875,28.728226,127752400,1635662890.7803602,4356196800,18.00619729114106,-44.0,-0.0965672065434795,47.22374285232286,41.22809095111662,32.23798046153846,32.03300604429169,-58.77190904888338
2015-06-26,31.9175,31.997499,31.627501,31.6875,28.559238,176267200,1516562787.5365596,4179929600,17.561995661440303,-44.0,-0.10927244895607302,44.3363746238582,24.78067924740163,32.20615357692308,32.00741300397379,-75.21932075259838
2015-06-29,31.365,31.6175,31.120001,31.1325,28.059027,196645600,1329798105.304838,3983284000,18.153471208893876,-100.0,-0.16225493290945892,37.104585597219625,0.8771246535958885,32.140192038461535,31.942604633309063,-99.12287534640411
2015-06-30,31.3925,31.530001,31.215,31.3575,28.261822,177482800,1312894471.7201853,4160766800,18.702698502957908,-96.0,-0.18396764902211515,41.28580447936917,16.666631578873712,32.07182673076923,31.899263549360242,-83.33336842112628
2015-07-01,31.725,31.735001,31.497499,31.65,28.52544,120955200,1347270923.2869067,4281722000,18.588341068800364,-92.0,-0.17554920553178377,46.28507806944813,39.84954887218041,32.042788307692305,31.880799582740966,-60.15045112781959
2015-07-02,31.6075,31.672501,31.442499,31.610001,28.489399,108844000,1396961089.84198,4172878000,18.598648505145032,-88.0,-0.17014380159454845,45.71188508281778,36.84210526315799,31.98894226923077,31.860740428463856,-63.15789473684201
2015-07-06,31.235001,31.557501,31.2125,31.5,28.390253,112241600,1471788280.9469342,4060636400,19.080676521745783,-84.0,-0.1727448463548953,44.09463277260572,28.57135338345872,31.93336534615385,31.83401891524431,-71.42864661654127
2015-07-07,31.4725,31.5375,30.942499,31.422501,28.320396,187787200,1586986224.07913,3872849200,20.02576196672174,-100.0,-0.1789963561089607,42.94193770376233,31.8408864465851,31.88923076923077,31.803536106707696,-68.1591135534149
2015-07-08,31.120001,31.16,30.635,30.6425,27.617403,243046400,1350884006.9362698,3629802800,21.39977319201721,-96.0,-0.24407672009166959,33.460998769249855,0.4132229128246616,31.812596230769227,31.717533432136754,-99.58677708717534
2015-07-09,30.9625,31.014999,29.805,30.0175,27.054106,314380000,1146926825.467524,3315422800,23.672874250138673,-100.0,-0.34214165802579544,28.106218326754075,8.03402342759033,31.717499999999998,31.591605029756252,-91.96597657240967
2015-07-10,30.485001,30.9625,30.3025,30.82,27.777386,245418000,1286368870.9220707,3560840800,25.783610946965744,-96.0,-0.3510570178542345,41.13268673336627,38.3742766070788,31.65173080769231,31.53444910162616,-61.6257233929212
2015-07-13,31.2575,31.440001,31.08,31.415001,28.313648,165762000,1429108434.8732834,3726602800,26.288260192561886,-76.0,-0.30657686936820383,48.57289027983748,60.869580011500936,31.616153923076922,31.525601094098295,-39.13041998849906
2015-07-14,31.51,31.592501,31.26,31.4025,28.302378,127072400,1410954907.2977269,3599530400,26.34186091316779,-76.0,-0.269231227456153,48.434381881681375,60.39695259094419,31.586923230769234,31.51648249453546,-39.60304740905581
2015-07-15,31.43,31.7875,31.395,31.705,28.57501,134596800,1488969613.030209,3734127200,25.876192388303867,-76.0,-0.21277260513239327,52.00117617287324,76.1523351311964,31.577500115384616,31.5304467541995,-23.847664868803612
2015-07-16,31.934999,32.142502,31.8375,32.127499,28.955797,144889600,1619605020.1475394,3879016800,24.586142092854367,-76.0,-0.13241025880885005,56.52440311355241,99.35816097697456,31.587980846153847,31.57467284648102,-0.6418390230254389
2015-07-17,32.27,32.404999,32.077499,32.404999,29.205906,184658800,1804263820.1475394,4063675600,22.8408374626046,-76.0,-0.045802605605970825,59.24122337833157,100.0,31.595096153846153,31.63617848748242,-0.0
2015-07-20,32.7425,33.2425,32.674999,33.017502,29.757938,235600800,1853046592.3435361,4299276400,22.664389245637874,28.0,0.07143499853424018,64.51255145512017,93.45460363636366,31.62855780769231,31.73849874766891,-6.545396363636345
2015-07-21,33.212502,33.23,32.580002,32.6875,29.460512,307025600,1647574036.9645967,3992250800,22.293004058149073,28.0,0.13614880236449878,60.00945138607066,83.85454545454546,31.662980884615386,31.808795136730474,-16.145454545454538
2015-07-22,30.497499,31.375,30.497499,31.305,28.2145,461802400,2035698645.144416,3530448400,22.498862780146844,28.0,0.07501404693391223,45.63733043727271,43.63636363636363,31.64663473076923,31.771476978454142,-56.36363636363637
2015-07-23,31.549999,31.772499,31.264999,31.290001,28.200985,203998000,1851800578.1335793,3326450400,22.069177494741744,28.0,0.025065084167110285,45.50998314063171,43.2000290909091,31.62317323076923,31.735812091161243,-56.7999709090909
2015-07-24,31.33,31.434999,30.975,31.125,28.052271,168649200,1793140225.9354212,3157801200,21.9787949000768,27.999999999999993,-0.027516833489691805,44.053651243858134,38.400000000000006,31.596250115384613,31.690566751075224,-61.599999999999994
2015-07-27,30.772499,30.9025,30.530001,30.692499,27.66247,177822000,1770463444.3440635,2979979200,22.340384458100043,28.0,-0.10290141474798986,40.40390822940256,25.81815272727278,31.5471155,31.616635806551134,-74.18184727272721
2015-07-28,30.844999,30.977501,30.637501,30.844999,27.799915,134472400,1800124891.727594,3114451600,22.548257579623595,28.0,-0.1486255007509527,42.221571831314535,30.254516363636412,31.51615392307692,31.55947752458438,-69.74548363636359
2015-07-29,30.7875,30.875,30.567499,30.747499,27.71204,148046800,1825400611.0039546,2966404800,22.81586127507112,28.0,-0.19053325473332094,41.353163611565854,15.136020408163354,31.471730807692307,31.499330967207758,-84.86397959183665
2015-07-30,30.58,30.6425,30.4275,30.592501,27.57234,134513200,1897350783.219769,2831891600,23.218106434877466,28.0,-0.23356015879662095,39.94654952494042,5.8614920071048,31.426923153846154,31.43215837704422,-94.13850799289521
2015-07-31,30.65,30.66,30.227501,30.325001,27.331249,171540000,1803152696.1490476,2660351600,23.81138521212247,28.0,-0.28594807327588256,37.57132273398934,3.233831918352217,31.361442423076923,31.35014671948539,-96.76616808164778
2015-08-03,30.375,30.6425,29.379999,29.610001,26.686834,279904000,1625234325.9552813,2380447600,25.16462162769966,-40.0,-0.3807711051525011,32.08053826699472,5.954742794888572,31.274327076923075,31.22124703656055,-94.04525720511143
2015-08-04,29.355,29.424999,28.3125,28.66,25.830624,496554400,1438887223.2202678,1883893200,27.165415407584227,-43.99999999999999,-0.5265069380455465,26.53229565582953,7.0486815415821535,31.15788476923077,31.031525033852358,-92.95131845841784
2015-08-05,28.237499,29.360001,28.025,28.85,26.001867,397250400,1532620095.8919747,2281143600,29.191005326083847,-48.0,-0.6195306596791816,29.170697746001096,15.81217057977964,31.07009630769231,30.86993058690033,-84.18782942022037
2015-08-06,28.9925,29.125,28.530001,28.782499,26.058441,211612000,1500610437.3278441,2069531600,31.071910250404922,-48.0,-0.6907370095667424,28.775325619345224,14.518428366075758,30.971057807692304,30.715306024907715,-85.48157163392425
2015-08-07,28.645,29.0625,28.625,28.879999,26.146725,154681600,1526242681.0691023,2224213200,32.81846482298878,-48.0,-0.730876035722904,30.24596986620331,16.426493756003904,30.864519307692305,30.579357356396034,-83.57350624399609
2015-08-10,29.1325,29.997499,29.1325,29.93,27.097345,219806400,1711744504.5468166,2444019600,32.560508964941825,-48.0,-0.6702341555236231,43.72259128424383,50.83390282425694,30.799903884615386,30.53125681147781,-49.16609717574307
2015-08-11,29.452499,29.545,28.3325,28.372499,25.68725,388331200,1349034516.3716424,2055688400,33.003052293171514,-48.0,-0.7393298088657971,33.41102154915177,9.272824355657,30.67961538461538,30.371348825442418,-90.727175644343
2015-08-12,28.1325,28.855,27.407499,28.809999,26.083345,404870000,1728730710.1082964,2460558400,34.04307585723601,-68.0,-0.7501388841752998,37.845341076032746,34.82309124767225,30.57913453846154,30.255693282817056,-65.17690875232775
2015-08-13,29.01,29.1,28.635,28.7875,26.062975,194143200,1661928748.8179736,2266415200,34.593495877954695,-68.0,-0.7518537336721955,37.706279178150005,38.65546854035377,30.507788384615388,30.146938224830606,-61.34453145964622
2015-08-14,28.58,29.077499,28.502501,28.99,26.246313,171718000,1781385164.3185487,2438133200,35.19794307245807,-68.0,-0.7284752968544126,39.848616456139155,44.327734270176805,30.46826915384615,30.061239097065375,-55.67226572982319
2015-08-17,29.01,29.4125,28.875,29.290001,26.517925,163538800,1870381305.858269,2601672000,35.17097960029655,-68.0,-0.6779254412637954,42.97738243180037,54.2898761961424,30.409423038461536,30.004110349134606,-45.7101238038576
2015-08-18,29.1075,29.360001,29.002501,29.125,26.368528,138242800,1826877553.4509969,2463429200,35.145942090432285,-68.0,-0.6437576804305323,41.69287144561288,52.80554871466602,30.321346076923078,29.938991064013525,-47.19445128533398
2015-08-19,29.025,29.129999,28.67,28.752501,26.031282,193146000,1703013174.2632136,2270283200,35.412032769563055,-68.0,-0.6393668173226388,38.86851789089373,41.35285431118999,30.219423038461535,29.851102911123633,-58.64714568881
2015-08-20,28.52,28.5875,27.907499,28.1625,25.497128,274006400,1634512077.950709,1996276800,36.24010075476544,-68.0,-0.6757060577102152,34.8424735522228,23.338509014371272,30.08317303846154,29.726021214003364,-76.66149098562873
2015-08-21,27.6075,27.975,26.4125,26.440001,23.937645,513102000,1139471925.1212673,1483174800,37.83926496051258,-96.0,-0.8338839462450984,26.283009403105396,0.7671131846897958,29.864423115384618,29.482612309262375,-99.23288681531021
2015-08-24,23.717501,27.200001,23.0,25.780001,23.340117,648825200,1349567808.628247,834349600,40.35936094826333,-100.0,-1.0009591130887223,23.86393464598784,39.72849442350757,29.6096155,29.20834480487257,-60.27150557649243
2015-08-25,27.7775,27.7775,25.875,25.934999,23.480444,414406400,961299615.8225708,1248756000,41.957388763609515,-96.0,-1.1080870060506598,25.595894968488054,41.943542971567425,29.337211538461535,28.96587474525238,-58.056457028432575
2015-08-26,26.772499,27.4725,26.262501,27.422501,24.827166,387098400,1316407025.9100175,1635854400,43.441271735002395,-88.0,-1.0607302155672684,39.75893012237798,63.201166588233875,29.134711576923074,28.85155076412257,-36.79883341176612
2015-08-27,28.057501,28.309999,27.504999,28.23,25.558241,338464400,1587599839.486166,1974318800,43.75353431934672,-88.0,-0.9471233487718251,45.79141979215941,74.74098960214212,29.016442346153845,28.805509966780157,-25.25901039785787
2015-08-28,28.0425,28.327499,27.885,28.3225,25.641983,212657600,1795452568.3230693,2186976400,44.02175593833062,-84.0,-0.8399427739460883,46.45291118572448,81.32161955691367,28.902307692307694,28.769731450722368,-18.678380443086322
2015-08-31,28.0075,28.6325,28.0,28.190001,25.522026,224917200,1705664199.6818035,1962059200,43.878827277804774,-76.0,-0.7569671124849435,45.59463810840818,80.93568810916176,28.78942311538462,28.726788454372564,-19.064311890838244
2015-09-01,27.5375,27.969999,26.84,26.93,24.381275,307383600,1447244402.3046374,1654675600,44.29372547892672,-76.0,-0.7838441855568661,38.340114034804,61.286549707602326,28.64471161538461,28.593693013307927,-38.71345029239768
2015-09-02,27.557501,28.084999,27.282499,28.084999,25.426964,247555200,1694799602.3046374,1902230800,44.53014578159257,-72.0,-0.7038323518034488,46.710278734034716,79.29823001949316,28.53855776923077,28.556011975285116,-20.701769980506842
2015-09-03,28.122499,28.195,27.51,27.592501,24.981079,212935600,1533155680.9487233,1689295200,44.60062684994642,-64.0,-0.6724117259077182,43.96940266808814,71.61794931773875,28.417211692307692,28.484640791930666,-28.382050682261244
2015-09-04,27.2425,27.612499,27.127501,27.317499,24.732105,199985200,1489858912.7756608,1489310000,44.861740540414395,-64.0,-0.6620690962069844,42.470810184705165,67.88519372874315,28.291250076923077,28.398185844380247,-32.11480627125685
2015-09-08,27.9375,28.139999,27.58,28.077499,25.420168,219374400,1660265725.3335404,1708684400,44.36838724958223,-60.0,-0.5857941687068973,47.76895829790713,82.83033977656437,28.20480769230769,28.374431263315042,-17.169660223435628
2015-09-09,28.440001,28.504999,27.442499,27.5375,24.93128,340043200,1381030890.5913286,1368641200,43.42518116055869,-40.00000000000001,-0.5624357364067514,44.62431461684322,80.55925432756327,28.12509611538462,28.312436354921335,-19.44074567243673
2015-09-10,27.567499,28.32,27.475,28.1425,25.479021,251571200,1526912414.8516824,1620212400,42.54934693503683,-40.0,-0.4894633380359039,48.69903932193027,91.30048823790497,28.10519226923077,28.29984847677901,-8.69951176209502
2015-09-11,27.9475,28.5525,27.940001,28.5525,25.85022,199662000,1726574414.8516824,1819874400,41.40730681046265,-40.0,-0.3940067485654595,51.313607204316135,98.57967154904568,28.09374996153846,28.31856340442501,-1.420328450954316
2015-09-14,29.145,29.2225,28.715,28.827499,26.099186,233453600,1596621490.896608,2053328000,39.459040144704566,-40.0,-0.29279147478017364,53.04228218686743,88.20011949215831,28.095480730769232,28.356262337430564,-11.79988050784169
2015-09-15,28.9825,29.1325,28.605,29.07,26.318737,173364800,1728904584.7354708,2226692800,37.75461837911426,-40.0,-0.19081029475147204,54.57399517052181,94.84797123242272,28.102788461538463,28.40913179391719,-5.152028767577282
2015-09-16,29.0625,29.135,28.860001,29.102501,26.34816,148694000,1842453683.8012843,2375386800,36.16849323910697,-36.0,-0.10614336117056666,54.78685953332048,94.96331584470094,28.07096157692308,28.46049247584925,-5.036684155299054
2015-09-17,28.915001,29.122499,28.43,28.48,25.784584,256450400,1623035886.0144286,2118936400,35.1287325073519,-20.0,-0.08825745752546155,49.95813281007202,68.83525708289613,28.07509623076923,28.461937477638195,-31.164742917103865
2015-09-18,28.0525,28.575001,27.967501,28.362499,25.678202,297141200,1712298569.8583791,1821795200,34.593110110807636,-20.000000000000004,-0.08261180130750034,49.078833672830996,63.90342077649526,28.05788469230769,28.45457166447981,-36.09657922350474
2015-09-21,28.4175,28.842501,28.415001,28.8025,26.076559,200888000,1875592554.0080864,2022683200,33.679692076767694,-20.0,-0.042147326477955716,52.45360845685283,82.37145855194117,28.058461615384616,28.480344133777603,-17.628541448058833
2015-09-22,28.344999,28.545,28.129999,28.35,25.666882,201384800,1887724624.496591,1821298400,33.10943676364081,-20.0,-0.04606094504195468,48.866786366465966,58.35320207790084,28.033846230769235,28.470689012757042,-41.64679792209916
2015-09-23,28.407499,28.68,28.325001,28.58,25.875118,143026800,1950172718.6410804,1964325200,32.35766159040289,-16.0,-0.03025468101041895,50.71168444195152,69.33172760464319,28.006538499999998,28.478786122923186,-30.66827239535682
2015-09-24,28.3125,28.875,28.092501,28.75,26.029026,200878000,2086872361.8636277,2165203200,31.90231870721303,56.0,-0.003964819663657693,52.08769609893926,77.4462899504964,27.99211542307692,28.498876039743692,-22.553710049503596
2015-09-25,29.110001,29.172501,28.504999,28.6775,25.963388,224607600,1978354408.3593667,1940595600,30.966215469459936,56.0,0.010894357399063637,51.428288456088275,69.3820396730113,27.98923076923077,28.51210744420712,-30.6179603269887
2015-09-28,28.4625,28.6425,28.110001,28.110001,25.449602,208436000,1769918408.3593667,1732159600,30.53435893738942,56.0,-0.02285856492956384,46.469262459308986,37.50009129208351,27.987211576923077,28.48232178167326,-62.49990870791649
2015-09-29,28.2075,28.377501,26.965,27.264999,24.68457,293461600,1601112559.4539146,1438698000,31.155225546953115,56.00000000000001,-0.11645023268071952,40.246294879827495,13.288992248062,28.018942269230767,28.39214972377154,-86.711007751938
2015-09-30,27.5425,27.885,27.182501,27.575001,24.965233,265892000,1632338733.287614,1704590000,31.731744541547975,52.0,-0.16372046544665864,43.24889516730604,27.021085271317848,28.08798073076923,28.331620188677352,-72.97891472868214
2015-10-01,27.2675,27.405001,26.827499,27.395,24.802265,255716400,1879198299.1419322,1448873600,32.54544086776404,48.0,-0.2132488419390981,41.93134670462418,23.695230189883006,28.14413461538462,28.262240915441993,-76.304769810117
2015-10-02,27.002501,27.752501,26.887501,27.594999,24.983334,232079200,2026762035.1918757,1680952800,32.65372338128532,-52.0,-0.23366860310053283,43.97365572922041,32.72918317340461,28.150769153846156,28.212815588372216,-67.27081682659538
2015-10-05,27.469999,27.842501,27.2675,27.695,25.073872,208258800,2128174477.50276,1889211600,32.58809739190257,-52.0,-0.23902681366176637,45.01497835476424,36.99361450437997,28.130192230769232,28.174458878122422,-63.00638549562004
2015-10-06,27.657499,27.934999,27.442499,27.827499,25.193836,192787200,2236800767.8580885,2081998800,32.34983291933461,-52.0,-0.22993116878909703,46.43554830545125,42.64388687088538,28.11115373076923,28.14875814640965,-57.35611312911462
2015-10-07,27.934999,27.942499,27.352501,27.695,25.073872,187062400,2266921086.910017,1894936400,32.22644083025322,-52.0,-0.23075437387416642,45.17854858416267,36.99361450437997,28.09211523076923,28.11514643186079,-63.00638549562004
2015-10-08,27.547501,27.547501,27.0525,27.375,24.784157,247918400,2342047222.1735826,1647018000,32.433949018802075,-52.0,-0.25429672117586577,42.206946857386036,23.347570705696636,28.109230615384618,28.06032077024147,-76.65242929430336
2015-10-09,27.5,28.07,27.372499,28.030001,25.377167,211064400,2528904158.856396,1858082400,31.577816649702957,-52.0,-0.21759281981764644,49.52523200141511,51.27935925001337,28.107115307692307,28.058074861334696,-48.72064074998663
2015-10-12,28.182501,28.1875,27.860001,27.9,25.259472,121868800,2436804183.3792176,1736213600,30.562239495277858,-52.0,-0.19672696183251404,48.22010945054558,45.7356113129114,28.118942192307692,28.04636561234694,-54.2643886870886
2015-10-13,27.705,28.112499,27.67,27.9475,25.302481,132197200,2470414015.711495,1868410800,29.87150693708776,-52.0,-0.17434799091159547,48.75152871051288,47.761195939278586,28.143172999999997,28.039042233654573,-52.238804060721414
2015-10-14,27.8225,27.879999,27.389999,27.5525,24.944859,177849600,2410526611.0159836,1690561200,29.589064492232684,-52.0,-0.1863377089546212,44.647923289267425,30.916860625278726,28.122980730769232,28.00300206819868,-69.08313937472127
2015-10-15,27.7325,28.025,27.622499,27.965,25.318314,150694000,2516293318.909878,1841255200,29.019060840226352,-52.0,-0.1607018731312948,49.43468304281385,62.67219687482272,28.139423038461537,28.00018710018396,-37.32780312517728
2015-10-16,27.945,28.0,27.6325,27.76,25.132723,156930400,2468253400.542532,1684324800,28.489771734791898,-52.00000000000001,-0.15513873255027377,47.247904254979716,60.161277211255374,28.124711499999997,27.982395463133297,-39.838722788744626
2015-10-19,27.700001,27.9375,27.5275,27.932501,25.288893,119036800,2584387444.624482,1803361600,28.154691158388413,-52.0,-0.13525142032809967,49.28103775731163,81.25008731611216,28.100865384615382,27.978699576975274,-18.74991268388784
2015-10-20,27.834999,28.5425,27.705,28.442499,25.750629,195871200,2733482964.932065,1999232800,26.53729641063588,-16.0,-0.07744526493661752,54.8246090567844,94.16904130085062,28.08605769230769,28.01305508979192,-5.830958699149379
2015-10-21,28.5,28.895,28.424999,28.440001,25.748363,167180800,2576974679.9335217,1832052000,24.88741420401061,-15.999999999999996,-0.03147224558503936,54.793018800331744,77.33503229640458,28.061826961538465,28.044680712770294,-22.66496770359542
2015-10-22,28.5825,28.875,28.525,28.875,26.142195,166616400,2743591079.9335217,1998668400,23.355380726430006,-16.0,0.039605934768307094,59.20162201715174,98.91451831750342,28.053076923076922,28.10618584515768,-1.085481682496584
2015-10-23,29.174999,29.807501,29.0825,29.77,26.952494,237467600,2956492444.9418464,2236136000,23.357096424383624,64.0,0.16623862952071633,66.45091491764445,98.638802671941,28.102692307692312,28.229431338108963,-1.361197328059006
2015-10-26,29.52,29.532499,28.73,28.82,26.092405,265335200,2750671756.4864087,1970800800,22.675272377316286,64.0,0.18777434615556388,55.23247410319907,64.15605656767463,28.120288499999997,28.273177164915705,-35.84394343232537
2015-10-27,28.85,29.135,28.497499,28.637501,25.927177,279537600,2593913016.6770587,1691263200,21.617732658376895,64.0,0.18794885524377136,53.368507358485004,57.531775850535155,28.113942384615385,28.30016411566269,-42.46822414946485
2015-10-28,29.2325,29.825001,29.014999,29.817499,26.995491,342205600,2929779801.6835165,2033468800,21.57675646312804,76.0,0.28007460617904556,62.24139643033107,99.69410830246015,28.170384653846153,28.412559292280267,-0.30589169753985074
2015-10-29,29.674999,30.172501,29.567499,30.1325,27.280682,204909200,3107592982.4663897,2238378000,21.94462050873509,80.0,0.3741894525678866,64.19973304815129,98.5624089398678,28.230096192307695,28.539962307666915,-1.4375910601322177
2015-10-30,30.247499,30.305,29.862499,29.875,27.047554,197461200,2921288649.7331305,2040916800,22.436448936116022,84.0,0.4231205777720497,61.39646410970206,85.24871861107424,28.273365423076925,28.638853988580475,-14.751281388925756
2015-11-02,30.200001,30.34,29.9025,30.295,27.427803,128813200,3023603134.30456,2169730000,22.93432289394708,88.0,0.4901393160058305,64.14639107777239,98.47457678827911,28.33557696153846,28.761531470907848,-1.5254232117208824
2015-11-03,30.1975,30.872499,30.174999,30.6425,27.742414,182076000,3085600860.6873546,2351806000,23.9874188810463,92.0,0.5647820389410612,66.28627870913911,93.12409360959441,28.43298076923077,28.900862473062823,-6.875906390405583
2015-11-04,30.782499,30.955,30.405001,30.5,27.613403,179544400,2968080349.6602445,2172261600,25.05064820085477,96.0,0.6054590208539494,64.58401106591904,86.7250182348651,28.557403884615386,29.0193171046878,-13.274981765134894
2015-11-05,30.4625,30.672501,30.045,30.23,27.486109,158210800,2903157044.022803,2014050800,25.2180326477616,96.0,0.6088901716876478,61.36826579588008,78.84755652808174,28.659519230769227,29.10899731915537,-21.152443471918254
2015-11-06,30.2775,30.452499,30.155001,30.264999,27.517929,132169200,2868725292.0836306,2146220000,25.373461062746514,92.0,0.6074314189597736,61.63493271584724,78.76920000000004,28.769903807692305,29.19462707329201,-21.230799999999963
2015-11-09,30.24,30.452499,30.012501,30.1425,27.406549,135485600,2813299112.873724,2010734400,25.185128267511406,76.0,0.5895942261506484,60.071935668073834,67.88538818759359,28.867884615384614,29.264839882677787,-32.114611812406416
2015-11-10,29.225,29.5175,29.014999,29.192499,26.54277,236511600,2743874977.3762846,1774222800,23.65621198253483,76.0,0.4931166394637181,49.57285314807282,28.280761635498873,28.92548073076923,29.25948129877573,-71.71923836450114
2015-11-11,29.092501,29.355,28.8025,29.0275,26.392757,180872000,2710319538.462258,1593350800,22.561071849995592,76.0,0.3987469104131165,48.00359140767591,21.56666467277121,28.971634615384616,29.242297498866414,-78.43333532722879
2015-11-12,29.065001,29.205,28.9125,28.93,26.304104,130102400,2595784947.009265,1463248400,21.54415601263773,76.0,0.31248861089583,47.05567195077389,17.59921969512928,29.019134615384612,29.219164350802235,-82.40078030487072
2015-11-13,28.799999,28.8925,28.067499,28.084999,25.535803,183249600,2420309563.0405173,1279998800,21.770974459858223,72.0,0.1739387111498587,39.73276114760198,0.6060603961695014,29.04644226923077,29.13515210259466,-99.3939396038305
2015-11-16,27.844999,28.559999,27.75,28.545,25.954052,152426800,2567091295.3967304,1432425600,22.344458241118847,60.0,0.10010124882865767,44.771493606627196,24.804992199688055,29.06624992307692,29.09143713203209,-75.19500780031194
2015-11-17,28.73,28.762501,28.33,28.422501,25.84267,110467600,2503876133.96959,1321958000,22.466270994481878,60.0,0.03133863021427885,43.723135272351115,20.98287051482062,29.086346115384615,29.041886307437125,-79.01712948517938
2015-11-18,28.940001,29.372499,28.875,29.3225,26.66099,186698800,2653048212.102009,1508656800,21.466049348366276,60.0,0.048902440357267096,52.51974592817439,49.06396255850242,29.13923073076923,29.062672506886226,-50.93603744149758
2015-11-19,29.41,29.9375,29.190001,29.695,26.999668,173183200,2713864904.588287,1681840000,20.191099716015035,48.00000000000001,0.09182106721736005,55.61229833514813,60.686427457098326,29.22163457692308,29.10951158045021,-39.313572542901674
2015-11-20,29.799999,29.98,29.7125,29.825001,27.117868,137148400,2692075997.286606,1818988400,19.068775149293742,48.0,0.13477082823632713,56.67293921392206,64.74262090483624,29.293173076923075,29.162510796713157,-35.25737909516376
2015-11-23,29.817499,29.932501,29.334999,29.4375,26.765543,129930000,2606724776.7049174,1689058400,17.97482205055485,48.0,0.13597331532256973,52.63559258425362,52.6521060842434,29.357692307692307,29.182880367326995,-47.3478939157566
2015-11-24,29.3325,29.8375,29.280001,29.719999,27.022396,171212800,2705766415.0963783,1860271200,17.042956849063533,44.0,0.15790141414714398,55.144391339475604,67.40798377827761,29.42644223076923,29.22266693271018,-32.59201622172238
2015-11-25,29.8025,29.807501,29.48,29.5075,26.829184,85553200,2634580884.202732,1774718000,16.17765344767874,-32.0,0.15633061505930712,52.87560436102476,65.03240149210048,29.46740380769231,29.243765678435352,-34.96759850789952
2015-11-27,29.5725,29.602501,29.4,29.452499,26.779179,52185600,2609453835.166925,1722532400,15.511224585885616,-32.0,0.1489308423829776,52.276097836598346,62.99721109980059,29.506346038461537,29.259227405958658,-37.00278890019941
2015-11-30,29.497499,29.852501,29.4375,29.575001,26.890556,156721200,2556584537.7946296,1879253600,14.406950764215921,-32.0,0.1512083214270703,53.53960793345844,81.83860986547086,29.533269153846156,29.28261804255431,-18.16139013452915
2015-12-01,29.6875,29.702499,29.215,29.334999,26.672344,139409600,2485806925.1029115,1739844000,13.791783544659381,-31.999999999999996,0.1321240406618749,50.707119929628746,71.07618834080715,29.516538346153844,29.286498113476217,-28.923811659192847
2015-12-02,29.334999,29.5275,29.02,29.07,26.431398,133546400,2378575086.6792665,1606297600,13.566718341968159,-32.00000000000001,0.09452676039670393,47.70602208333869,59.19282511210763,29.526153730769234,29.27046121618168,-40.80717488789237
2015-12-03,29.137501,29.1975,28.555,28.799999,26.185911,166278000,2339107806.4364643,1440019600,14.10255814020417,-32.0,0.042454432435139466,44.79688083915479,47.08515695067262,29.532403653846153,29.235612163131186,-52.91484304932738
2015-12-04,28.8225,29.8125,28.7775,29.7575,27.056498,231108000,2545653603.537914,1671127600,13.367644962814854,-32.0,0.07755505944604835,55.224605797076954,90.02242152466367,29.530096,29.274270521417765,-9.977578475336328
2015-12-07,29.745001,29.965,29.452499,29.57,26.886013,128336800,2476164307.588833,1542790800,12.413355914427466,-32.0,0.08921446739538297,53.10897168012639,75.15151515151517,29.50846138461538,29.296176408720154,-24.848484848484826
2015-12-08,29.379999,29.65,29.215,29.557501,26.874651,137238000,2555037352.3612466,1405552800,11.940975746410732,-32.0,0.09633557086115374,52.96331119717269,70.35094736842093,29.49624988461538,29.315533785851994,-29.64905263157907
2015-12-09,29.41,29.422501,28.77,28.905001,26.28137,185445600,2446328313.517781,1220107200,12.206526342047999,-32.0,0.04876565966355173,45.88775484985053,24.561473684210437,29.442788384615383,29.285123949862957,-75.43852631578956
2015-12-10,29.01,29.235001,28.877501,29.0425,26.406393,116850800,2437339136.730089,1336958000,12.45310903799689,-32.0,0.0219086334014591,47.48001407274165,34.21052631578951,29.38124992307692,29.26715180542866,-65.78947368421049
2015-12-11,28.797501,28.8475,28.2125,28.295,25.72674,187544800,2298526450.1159177,1149413200,13.607031804457987,-28.000000000000004,-0.05901249695660837,40.502559343286286,4.707560627674925,29.29644223076923,29.195140560582093,-95.29243937232508
2015-12-14,28.045,28.17,27.4475,28.120001,25.567627,257274800,2520192993.437161,892138400,15.493478386338476,-100.0,-0.1356997700638516,39.05552858773559,26.713048659384206,29.215288423076927,29.115500593131568,-73.2869513406158
2015-12-15,27.985001,28.200001,27.5875,27.622499,25.115286,213292400,2331276131.4611006,678846000,17.178128726494087,-96.0,-0.23392272454885443,35.20481427107086,6.9513008937437855,29.11365380769231,29.004907882529228,-93.04869910625621
2015-12-16,27.7675,27.997499,27.200001,27.834999,25.308495,224954000,2464555857.6698174,903800000,19.113628266589632,-68.0,-0.29126067778299003,38.01598529965395,22.96557792606795,29.02490376923077,28.918247965304843,-77.03442207393205
2015-12-17,28.004999,28.0625,27.245001,27.245001,24.772051,179091200,2285464657.6698174,724708800,20.754490824330695,-68.0,-0.37992973313414424,33.65067964580358,1.627487026215856,28.950000000000003,28.794303745652634,-98.37251297378414
2015-12-18,27.227501,27.379999,26.452499,26.5075,24.101484,385813200,1945409111.1753705,338895600,22.965454142912872,-76.0,-0.5039020957809548,29.145459018772215,1.565864322885623,28.85307692307692,28.624910875604293,-98.43413567711437
2015-12-21,26.82,26.842501,26.3925,26.8325,24.39699,190362400,2127310132.812212,529258000,25.06459396017966,-80.0,-0.5693630397830844,33.37840458111438,12.31630510846749,28.772403846153846,28.492139699633604,-87.6836948915325
2015-12-22,26.85,26.93,26.612499,26.807501,24.374262,131157600,2157260650.992626,398100400,26.79006589956785,-80.0,-0.6161558587046088,33.2140353224048,11.616543037088872,28.723269307692306,28.367351647808892,-88.38345696291113
2015-12-23,26.817499,27.2125,26.799999,27.1525,24.687944,130629600,2249889004.9350414,528730000,27.681213426495137,-80.0,-0.6182738922333861,37.76857657366723,21.273617914625646,28.669711615384617,28.277362636860087,-78.72638208537435
2015-12-24,27.25,27.25,26.987499,27.0075,24.556103,54281600,2203879268.902036,474448400,28.414733817155906,-80.0,-0.6244544154569702,36.637681609856344,17.21483554933525,28.615288500000002,28.18329873783341,-82.78516445066475
2015-12-28,26.897499,26.922501,26.545,26.705,24.281059,106816800,2187608920.434613,367631600,29.57089794064455,-80.0,-0.6463114702280777,34.32834829576565,9.593246354566384,28.514615423076922,28.073795127623526,-90.40675364543361
2015-12-29,26.74,27.3575,26.715,27.184999,24.717489,123724800,2244897450.4741464,491356400,29.591926209851636,-80.0,-0.6177800519407342,40.71406897367921,26.155073876213322,28.418076923076924,28.00795837742919,-73.84492612378668
2015-12-30,27.145,27.174999,26.795,26.83,24.394718,100855200,2162620888.8389826,390501200,29.611452459829646,-40.0,-0.6167051566792452,37.78754468600854,15.39137541200512,28.302884576923073,27.920702201323323,-84.60862458799487
2015-12-31,26.752501,26.7575,26.205,26.315001,23.926464,163649200,2064135763.5872178,226852000,30.321683033773827,-68.0,-0.649917564589142,33.9725044053537,4.162762535477782,28.182788461538458,27.80176137159567,-95.83723746452222
2016-01-04,25.6525,26.342501,25.5,26.3375,23.946922,270597600,2331520884.082505,497449600,31.632894126138044,-72.0,-0.6667374219021482,34.28465113207956,31.018507030182526,28.052692346153847,27.693297566292287,-68.98149296981748
2016-01-05,26.4375,26.4625,25.602501,25.6775,23.346828,223164000,2147280363.84469,274285600,32.56451640409945,-72.0,-0.7249667981798353,29.82965265622383,6.574071639232668,27.905384653846152,27.543979228048414,-93.42592836076734
2016-01-06,25.139999,25.592501,24.967501,25.174999,22.889936,273829600,2055271865.735251,456000,33.95526911267965,-80.0,-0.8024119243440637,26.957514355028948,6.704299419805983,27.74086542307692,27.36849921115594,-93.29570058019402
2016-01-07,24.67,25.032499,24.1075,24.112499,21.923876,324377600,1734400353.033506,-323921600,35.80338606624658,-84.0,-0.9387018445656814,22.10996811743233,0.12639696586594132,27.53076919230769,27.127314010329574,-99.87360303413406
2016-01-08,24.637501,24.7775,24.190001,24.24,22.039804,283192000,1499410364.6386316,-40729600,37.519494665987295,-84.0,-1.0246132197300142,23.87892148210267,4.048893521434131,27.334807692307695,26.913438898453308,-95.95110647856586
2016-01-11,24.7425,24.764999,24.334999,24.6325,22.396679,198957600,1575755485.3716555,158228000,39.11302408003225,-84.0,-1.0489356564572851,29.20888239619208,16.15384615384611,27.16413461538461,26.74448046153084,-83.84615384615388
2016-01-12,25.137501,25.172501,24.709999,24.99,22.721725,196616800,1617204253.1607661,354844800,39.59119813690434,-84.0,-1.027519495415035,33.75845512687364,27.153846153846054,27.017596192307693,26.61451894586189,-72.84615384615395
2016-01-13,25.08,25.297501,24.325001,24.3475,22.137545,249758400,1379002283.4776812,105086400,40.352415514223516,-84.0,-1.0502843892376035,30.02388590494425,7.384615384615336,26.809519269230766,26.446591616538786,-92.61538461538467
2016-01-14,24.49,25.120001,23.934999,24.879999,22.62171,252680400,1529330448.8640697,357766800,41.350873912477745,-100.0,-1.013672526685621,36.312335981316885,27.61138711135512,26.62913461538462,26.330547719017392,-72.38861288864489
2016-01-15,24.049999,24.4275,23.84,24.282499,22.078442,319335600,1691035474.1045833,38431200,42.346753928182935,-100.0,-1.0211000129860857,32.75536711757758,12.579928926794635,26.426249923076924,26.178840406497585,-87.42007107320536
2016-01-19,24.602501,24.6625,23.875,24.165001,21.971613,212350800,1635083262.9320116,-173919600,42.68190624054936,-96.0,-1.0246558610792036,32.08968246674553,9.239545131485434,26.243942230769235,26.029667117127396,-90.76045486851456
2016-01-20,23.775,24.547501,23.355,24.1975,22.001165,289337600,1754578742.3172705,115418000,43.41840756160286,-100.0,-1.0131722792595141,32.49830747395828,22.05497959554443,26.05759607692308,25.893951034377217,-77.94502040445556
2016-01-21,24.264999,24.469999,23.735001,24.075001,21.889782,208646000,1738966301.5922613,-93228000,44.10230164543826,-92.0,-1.002401048155665,31.723458717894815,21.160940484937544,25.89528842307692,25.759213994793722,-78.83905951506246
2016-01-22,24.657499,25.365,24.592501,25.355,23.053595,263202000,1995354001.5090263,169974000,42.73444198368145,-92.0,-0.8804304933232423,46.16681285157257,64.36041834271927,25.78894223076923,25.729272217401597,-35.639581657280736
2016-01-25,25.379999,25.3825,24.8025,24.860001,22.603529,207178000,1829255112.4676483,-37204000,41.4299735355525,-84.0,-0.8143232210947247,42.42883258706114,48.43124698310542,25.682692307692307,25.664881756853333,-51.568753016894576
2016-01-26,24.9825,25.219999,24.5175,24.997499,22.728542,300308000,1939332151.284786,263104000,40.55946373629256,-84.0,-0.742281236059906,43.79026287256362,73.40774372838278,25.573557692307695,25.61544599708642,-26.592256271617213
2016-01-27,24.01,24.157499,23.334999,23.355,21.235134,533478800,1431798906.248434,-270374800,40.8636501122862,-100.0,-0.8084046012199728,33.57589697473193,0.9768493397561514,25.423942269230768,25.448005552857797,-99.02315066024386
2016-01-28,23.4475,23.629999,23.0975,23.522499,21.387432,222715200,1564591368.365357,-47659600,41.32524283139245,-80.0,-0.8376363249069811,35.23497266580465,18.599518599562348,25.30913453846154,25.305375437831295,-81.40048140043764
2016-01-29,23.6975,24.334999,23.5875,24.334999,22.126175,257666000,1822257368.365357,210006400,40.41893410033257,-80.0,-0.7861781446058416,42.710036131953146,54.157505470459505,25.21307680769231,25.233495701695645,-45.842494529540495
2016-02-01,24.1175,24.1775,23.85,24.1075,21.919331,163774000,1916021108.8233747,46232400,39.57736170720553,-80.0,-0.755050679759016,41.273596269813304,44.20131291028453,25.109230615384618,25.150088612681156,-55.79868708971547
2016-02-02,23.855,24.01,23.57,23.620001,21.476086,149428800,1800554078.9542825,-103196400,39.07730454986031,-80.0,-0.7609473078162381,38.300932576667535,22.866564551422243,24.97336526923077,25.03674878951959,-77.13343544857776
2016-02-03,23.75,24.209999,23.52,24.0875,21.901144,183857200,1919129088.2763243,80660800,38.22720814928126,-80.0,-0.7196020413902282,42.572479423685984,43.32603938730846,24.861057576923073,24.966434064369988,-56.67396061269154
2016-02-04,23.965,24.3325,23.797501,24.15,22.077118,185886800,1978195684.874074,266547600,37.200130465409266,-80.0,-0.6740226783340688,43.13924467158142,46.06126914660825,24.762788346153847,24.905957467009248,-53.93873085339175
2016-02-05,24.129999,24.23,23.422501,23.504999,21.487484,185672400,1830461664.1295285,80875200,36.67838185065199,-76.0,-0.6820842522549206,38.875208039880896,17.833654266958483,24.62124988461538,24.802182765749304,-82.16634573304151
2016-02-08,23.282499,23.924999,23.26,23.752501,21.713741,216085600,1934443835.9174552,296960800,36.3728460921986,-72.0,-0.6608835109991205,41.273942872243765,28.665251641137793,24.50288453846154,24.724428560878984,-71.3347483588622
2016-02-09,23.5725,23.985001,23.4825,23.747499,21.709171,177324800,1944147100.2405114,119636000,35.95662935097647,-64.0,-0.6371408275537007,41.238720412059365,28.44634573304162,24.404134461538458,24.65206340822128,-71.55365426695839
2016-02-10,23.98,24.0875,23.525,23.567499,21.544617,169374400,1800366451.798202,-49738400,35.335832571398036,-64.0,-0.625637120266795,39.91854413909789,20.568884026258264,24.29759596153846,24.571725303908593,-79.43111597374173
2016-02-11,23.4475,23.68,23.147499,23.424999,21.414349,200298800,1808829389.334845,-250037200,35.230237822508634,-60.0,-0.6208619978025034,38.857986972900946,14.332560175054683,24.21096130769231,24.486782614730178,-85.66743982494532
2016-02-12,23.547501,23.625,23.252501,23.497499,21.480623,161405600,1859741401.939444,-88631600,35.13218555568277,-12.000000000000007,-0.6042619788028176,39.73525148888233,18.845662589240366,24.146442076923076,24.41350234697239,-81.15433741075962
2016-02-16,23.754999,24.2125,23.6525,24.16,22.08626,196231600,2019179576.939445,107600000,33.69696397749287,-12.0,-0.5315210068936302,47.191612868852026,85.85865523931739,24.14826903846154,24.394724395344806,-14.141344760682612
2016-02-17,24.1675,24.5525,24.0375,24.530001,22.424509,179452800,2182952732.09595,287052800,31.702290255957728,-12.0,-0.43895724819676474,50.84920433603338,98.45367697594504,24.159422923076924,24.404744884578527,-1.5463230240549726
2016-02-18,24.709999,24.7225,24.022499,24.065001,21.999414,156084000,2045822654.0703468,130968800,29.535989442064768,-12.0,-0.3985274401214731,46.49110707357571,58.254058251391506,24.13759603846154,24.379578670906042,-41.745941748608494
2016-02-19,24.0,24.190001,23.950001,24.01,21.949141,141496800,1975073074.9303489,-10528000,27.65641501317543,-11.999999999999996,-0.3666975854742063,45.98903122146511,54.761933484486775,24.09990373076923,24.352202473061148,-45.238066515513225
2016-02-22,24.077499,24.225,23.98,24.219999,22.141111,137123200,2106598290.2511652,126595200,25.83996989628656,-12.0,-0.3208287183235079,48.285411678222,68.09519486019383,24.094999846153847,24.342409623204766,-31.904805139806175
2016-02-23,24.1,24.125,23.637501,23.672501,21.640608,127770400,1997174446.8594866,-1175200,24.79776298577937,-12.0,-0.32491045809634045,43.13606222324916,33.333439153372,24.048557615384617,24.292786762226633,-66.666560846628
2016-02-24,23.495001,24.094999,23.33,24.025,21.962852,145022800,2115657471.0501056,143847600,24.349303298771947,-12.000000000000004,-0.29628614073207515,47.051246462222764,55.7143138321816,24.038653807692306,24.2729507057654,-44.2856861678184
2016-02-25,24.012501,24.190001,23.8125,24.190001,22.113686,110330800,2225988271.0501056,254178400,23.708265747173694,-12.0,-0.25732072808791173,48.82734316842984,66.19056114884998,24.039615346153845,24.26680628311611,-33.80943885115002
2016-02-26,24.299999,24.504999,24.145,24.227501,22.14797,115964400,2163175012.938833,370142800,22.399833136129896,-12.0,-0.22086838794689712,49.244046748340985,68.57151201808762,24.04076923076923,24.263894780663065,-31.428487981912383
2016-02-29,24.215,24.557501,24.1625,24.172501,22.097691,140865200,2029442923.3117177,229277600,21.06971393197575,-12.0,-0.19417930791679083,48.618717319166564,65.07945074320591,24.044519230769232,24.25712487098432,-34.9205492567941
2016-03-01,24.4125,25.192499,24.355,25.1325,22.975292,201628400,2202181730.9143534,430906000,20.526361403473565,-12.0,-0.09447507361495511,58.51991157119717,97.06606356968209,24.035961538461542,24.321967473133633,-2.9339364303179067
2016-03-02,25.127501,25.2225,24.91,25.1875,23.02557,132678400,2305140169.3143535,563584400,20.073630820372784,92.0,-0.010895117126448639,59.007289509912965,98.31325382493792,24.048557653846157,24.386080993642253,-1.686746175062091
2016-03-03,25.145,25.4275,25.112499,25.375,23.196978,147822800,2403688859.073435,711407200,20.009341136938676,96.0,0.0696691806024532,60.70246538990127,97.58620578676135,24.063076923076924,24.459334253372457,-2.4137942132386474
2016-03-04,25.592501,25.9375,25.342501,25.752501,23.542068,184220400,2473352462.239826,895627600,20.72724173293167,100.0,0.16210944599572485,63.93604118372876,92.9051198465963,24.1552885,24.555124382752275,-7.094880153403686
2016-03-07,25.5975,25.7075,25.24,25.467501,23.281532,143315600,2469521107.4402537,752312000,21.130710666166827,60.0,0.20995171152041436,59.926903124248504,81.97511025886861,24.230096269230767,24.622707835881737,-18.024889741131393
2016-03-08,25.195,25.440001,25.1,25.2575,23.08956,126247600,2460237851.6627707,626064400,21.14429565998801,60.0,0.22829013936431153,57.08637606779049,73.92138063279006,24.265577076923076,24.669729477668277,-26.078619367209942
2016-03-09,25.327499,25.395,25.067499,25.280001,23.110132,108806800,2492631613.5761685,734871200,21.071110013410607,60.0,0.24185120802418325,57.31981245580093,74.7843144774688,24.31067326923077,24.714934775618776,-25.215685522531196
2016-03-10,25.352501,25.559999,25.0375,25.2925,23.121555,134054400,2489424820.94001,868925600,21.296151674553766,60.0,0.25071690901953403,57.4582477632023,75.26366251198469,24.375000153846152,24.7577173848322,-24.73633748801531
2016-03-11,25.559999,25.57,25.375,25.565001,23.370667,109632800,2593436550.507188,978558400,21.52320174224793,60.0,0.27654376981054085,60.46874780297999,85.71432406519651,24.431827115384618,24.817516171140927,-14.28567593480349
2016-03-14,25.477501,25.727501,25.445,25.629999,23.430082,100304400,2624503109.8708725,1078862800,22.023303076032654,60.0,0.29881201949226366,61.17450743512251,88.20705656759354,24.48875015384616,24.877700084389748,-11.792943432406453
2016-03-15,25.99,26.295,25.9625,26.145,23.900879,160270800,2640168676.788165,1239133600,23.36699308828897,88.0,0.35393608953358324,66.30720878952299,93.95770392749236,24.590288653846155,24.97157415221273,-6.042296072507635
2016-03-16,26.1525,26.577499,26.147499,26.4925,24.218554,153214000,2732810412.667235,1392347600,24.971922799662227,92.0,0.42081180150859865,69.26019581059737,96.50569229422088,24.69567323076923,25.0842353261229,-3.494307705779111
2016-03-17,26.379999,26.6175,26.24,26.450001,24.179707,137682800,2748311854.6953154,1254664800,26.511447514059004,96.0,0.4650214926399201,68.469822376548,93.17723014256622,24.799615615384617,25.1854031538175,-6.822769857433789
2016-03-18,26.584999,26.625,26.297501,26.48,24.20713,176820800,2768558033.0934176,1431485600,27.950795518297593,100.0,0.4967524074278238,68.74098922867782,93.61233480176213,24.91163488461539,25.281299216497686,-6.387665198237868
2016-03-21,26.4825,26.9125,26.285,26.477501,24.204842,142010800,2713677817.9883976,1289474800,29.651854190150534,100.0,0.5157524642282851,68.68799419430344,78.27720349563042,25.029038807692306,25.369906756016377,-21.722796504369587
2016-03-22,26.3125,26.8225,26.3025,26.68,24.389959,129777600,2772327310.296089,1419252400,31.23140867115683,72.0,0.540914794038013,70.6617563670375,87.59999999999991,25.15144269230769,25.466950700015165,-12.400000000000091
2016-03-23,26.620001,26.7675,26.475,26.532499,24.255123,102814000,2709935205.5849786,1316438400,32.698137832091255,72.0,0.5426981374041766,67.33236706233376,79.73328,25.242692653846152,25.545880203717743,-20.266720000000003
2016-03-24,26.3675,26.5625,26.2225,26.4175,24.14999,104532000,2725307558.5261555,1211906400,33.03043566650057,72.0,0.5287370401850211,64.77001992932661,73.59999999999994,25.31528876923077,25.610444633071985,-26.400000000000052
2016-03-28,26.5,26.547501,26.264999,26.297501,24.040297,77645600,2665528290.7376094,1134260800,33.33899794130922,72.0,0.5022007954670507,62.11376247393963,67.20005333333329,25.401154153846157,25.661337697288875,-32.79994666666672
2016-03-29,26.2225,26.9475,26.219999,26.92,24.60936,124760400,2780856645.9706607,1259021200,34.2904135418648,92.0,0.5253452442439475,69.17584819847255,98.56020942408378,25.51307723076923,25.754571941934145,-1.4397905759162228
2016-03-30,27.1625,27.605,27.15,27.389999,25.039022,182404400,2790878063.973298,1441425600,35.96730040627698,96.0,0.5749843167130955,73.23278022519915,91.62605647517036,25.635000307692305,25.87571468697606,-8.373943524829638
2016-03-31,27.43,27.475,27.219999,27.247499,24.908751,103553600,2709659466.581131,1337872000,37.52440963751686,96.0,0.5959552787135642,70.21532309403734,83.96856502242157,25.772500230769232,25.977328339792646,-16.031434977578435
2016-04-01,27.195,27.5,27.049999,27.497499,25.137297,103496000,2812005053.5998273,1441368000,38.307962000673704,92.0,0.6255370263924078,72.36652381765282,95.02310185185188,25.906057884615386,26.089933573882078,-4.97689814814811
2016-04-04,27.605,28.047501,27.567499,27.780001,25.395548,149424800,2794884155.873566,1590792800,39.658515871404504,100.0,0.6641207543300496,74.5990861116032,87.1702699423165,26.04413480769231,26.21512375359452,-12.829730057683502
2016-04-05,27.377501,27.682501,27.355,27.452499,25.096155,106314800,2751870455.3218117,1484478000,40.17032873586116,96.0,0.6606563274512176,67.76399683766266,68.68413822722287,26.168173192307695,26.306781179254184,-31.31586177277712
2016-04-06,27.557501,27.745001,27.299999,27.74,25.358988,105616400,2855112989.063233,1590094400,40.723475607157624,92.0,0.6733477385581033,70.33370651216534,83.17369830511801,26.305384692307694,26.412945536346466,-16.826301694881984
2016-04-07,27.487499,27.605,27.030001,27.135,24.805904,127207600,2774363455.2247405,1462886800,40.31692152038658,88.0,0.627355565054291,59.57190334697325,50.06839937794873,26.38240392307692,26.466431052172652,-49.93160062205127
2016-04-08,27.227501,27.442499,27.0425,27.165001,24.833334,94326800,2737812436.298193,1557213600,39.93940701124204,64.0,0.5865657018811667,59.899572517410455,51.71003916821975,26.45846165384615,26.51817697423394,-48.28996083178025
2016-04-11,27.2425,27.6525,27.2075,27.254999,24.915604,117630000,2645293930.095947,1674843600,39.92688593470706,64.0,0.5551026500859138,60.92276633846243,56.63468494152131,26.530769307692307,26.572756383549944,-43.36531505847869
2016-04-12,27.334999,27.625,27.165001,27.610001,25.240139,108929200,2747119509.9976425,1783772800,39.75925054703847,64.0,0.5524454026670007,64.74416650115866,76.06021771795596,26.602211615384615,26.6495893181018,-23.939782282044025
2016-04-13,27.700001,28.084999,27.700001,28.01,25.605803,133029200,2828319573.374596,1916802000,40.290602027351426,92.0,0.5759765916958663,68.48392548261364,95.97860589812342,26.70000003846154,26.750360479723888,-4.021394101876586
2016-04-14,27.905001,28.0975,27.8325,28.025,25.619513,101895600,2874460977.14818,2018697600,40.800931838928825,96.0,0.5890454538501508,68.61835830716957,96.1384840807008,26.806442346153844,26.844778221966564,-3.8615159192991966
2016-04-15,28.0275,28.075001,27.432501,27.4625,25.105299,187756000,2704238026.9349504,1830941600,39.86392669486488,96.0,0.5477000272889825,58.53500834085823,66.17844677579389,26.89038461538462,26.89053539070978,-33.82155322420611
2016-04-18,27.2225,27.237499,26.735001,26.870001,24.563654,243286000,2591673383.0398483,1587655600,37.160559737776836,92.0,0.46180041357536794,50.171782469847365,9.908264152854281,26.95105773076923,26.889014324731278,-90.09173584714571
2016-04-19,26.969999,27.0,26.557501,26.727501,24.43339,129539600,2561667259.951661,1458116000,34.74264737913389,88.0,0.37786994227752047,48.38138933783181,11.038968207122311,26.99576926923077,26.87705037475118,-88.96103179287769
2016-04-20,26.66,27.022499,26.514999,26.782499,24.483665,122444000,2568302156.503386,1580560000,32.58919564036327,84.0,0.3121935451948481,49.13581709815211,16.903622809717135,27.040096192307693,26.870046569214058,-83.09637719028285
2016-04-21,26.7325,26.7325,26.379999,26.4925,24.218554,126210000,2522652218.517393,1454350000,30.88578470738297,80.0,0.23404609397400122,45.370358735948905,6.550272750932796,27.053461576923077,26.842080156679685,-93.44972724906721
2016-04-22,26.252501,26.620001,26.155001,26.42,24.152279,134732400,2541485200.313524,1319617600,29.77580580161573,-24.0,0.16436879066452548,44.453190938910225,13.64216918515803,27.050673115384615,26.810814959888596,-86.35783081484196
2016-04-25,26.25,26.4125,26.127501,26.27,24.015156,112126400,2541484806.886178,1207491200,28.80216897910991,-28.0,0.09593935028627598,42.53724234765595,7.2334554484545786,27.043750000000003,26.770754592489443,-92.76654455154542
2016-04-26,25.977501,26.325001,25.977501,26.0875,23.84832,224064800,2459272691.4053125,983426400,28.212643902595534,-32.0,0.026674810385522107,40.26346294204406,5.188634522940737,27.028653846153848,26.72014314119393,-94.81136547705927
2016-04-27,24.0,24.6775,23.92,24.455,22.35594,458408400,2648385067.642935,525018000,30.1445037050485,-36.0,-0.15812418595136535,26.57765042111751,12.80670257330932,26.950865346153844,26.55235476036475,-87.19329742669068
2016-04-28,24.4025,24.469999,23.5625,23.7075,21.6726,328970800,2424540038.580423,196047200,32.1798796498558,-40.0,-0.36073736899649234,22.762421411600045,3.1973539140021954,26.83653842307692,26.34162477811551,-96.80264608599781
2016-04-29,23.497499,23.68,23.127501,23.434999,21.423498,274126000,2455548334.743857,-78078800,34.33606159133408,-43.99999999999999,-0.5371068956672147,21.54804456420179,6.1870837398559315,26.71740380769231,26.126319164921767,-93.81291626014406
2016-05-02,23.4925,23.52,23.1,23.41,21.400637,192640400,2547281858.553381,-270719200,36.354620314437355,-48.0,-0.6711614946751325,21.435065220370873,6.203101550775363,26.60173073076923,25.925110337890523,-93.79689844922464
2016-05-03,23.549999,23.934999,23.42,23.795,21.752588,227325200,2651013417.8868947,-43394000,37.18196650799991,-48.0,-0.7378292119072611,27.720417110933624,13.906953476738378,26.505480692307692,25.76732438693567,-86.09304652326162
2016-05-04,23.799999,23.975,23.455,23.547501,21.526335,164102000,2545294491.3561263,-207496000,37.85224704661564,-48.0,-0.8013969537625485,26.265672458920946,8.994993166835528,26.375769192307697,25.602893024940435,-91.00500683316447
2016-05-05,23.5,23.5175,23.17,23.309999,21.438963,143562000,2517407521.21512,-351058000,38.728130969714975,-48.0,-0.8610140397886319,24.914479619398975,5.075505758430393,26.21884611538462,25.433049023092998,-94.9244942415696
2016-05-06,23.342501,23.362499,22.9625,23.18,21.319401,174799600,2532702961.452721,-525857600,39.71781637389233,-64.0,-0.9082807477601946,24.181209063412567,5.357144176636523,26.062403846153845,25.26615650286389,-94.64285582336348
2016-05-09,23.25,23.442499,23.147499,23.1975,21.335491,131745600,2445617780.06696,-394112000,40.417343343829955,-64.0,-0.9335662796722701,24.503332946462052,5.788178765561344,25.897019269230775,25.112922687836935,-94.21182123443864
2016-05-10,23.3325,23.3925,23.0275,23.355,21.48035,134747200,2552677199.2450438,-259364800,41.1805165033033,-64.0,-0.9301738470715044,27.489236277551626,10.411140583554417,25.72682692307692,24.982706192441608,-89.58885941644557
2016-05-11,23.370001,23.3925,23.115,23.127501,21.271109,114876400,2448150852.408287,-374241200,41.889177294242835,-64.0,-0.9350637548963014,25.896055014056742,4.511304303129382,25.560480846153844,24.845283585594082,-95.48869569687062
2016-05-12,23.18,23.195,22.3675,22.584999,20.772156,305258800,2303359686.828106,-679500000,43.194767255597796,-80.0,-0.9715153948741744,22.541117109270147,5.3769839307787395,25.362211576923077,24.677855097772298,-94.62301606922125
2016-05-13,22.5,22.9175,22.5,22.629999,20.813541,177571200,2236370898.463077,-501928800,44.407100791141694,-80.0,-0.9854132279636865,23.42729461577457,6.632948418711752,25.188942307692308,24.526162053492868,-93.36705158128825
2016-05-16,23.0975,23.5975,22.9125,23.469999,21.586117,245039200,2390190410.7573843,-256889600,43.6611519006825,-80.0,-0.9180635162479049,37.74504729256128,47.72722943722954,25.046826846153845,24.447927753234136,-52.27277056277046
2016-05-17,23.637501,23.674999,23.252501,23.372499,21.496441,187667600,2309125619.124763,-444557200,42.78012698280804,-80.0,-0.8626121635788735,36.882988315360556,47.800212984643544,24.897499923076925,24.368266364105683,-52.199787015356456
2016-05-18,23.540001,23.8025,23.4725,23.639999,21.742472,168249600,2311673835.793854,-276307600,41.645903668269305,-80.0,-0.7879980022161988,40.87293575858296,79.16012441679618,24.74480753846154,24.31432063343119,-20.839875583203828
2016-05-19,23.66,23.66,23.3925,23.549999,21.659697,121768400,2333295351.544135,-398076000,40.708949348643486,-80.0,-0.7277390666503827,39.95771719263437,73.56136858475887,24.57326903846154,24.25770421613999,-26.438631415241137
2016-05-20,23.66,23.8575,23.629999,23.805,21.894222,128104000,2402274688.3558393,-269972000,39.32584813243961,-76.0,-0.6518923670857042,43.79768224933856,89.42457231726273,24.410961346153847,24.22417057049999,-10.575427682737264
2016-05-23,23.967501,24.297501,23.9175,24.1075,22.172447,152074400,2402274288.1611037,-117897600,37.01676474087434,-72.0,-0.5609082877448834,48.042748067189684,90.15539370186862,24.281922884615383,24.21552830601851,-9.844606298131383
2016-05-24,24.305,24.522499,24.209999,24.475,22.510447,140560800,2500105504.5502253,22663200,34.4054202844215,-64.0,-0.4539161083440142,52.7154307259843,97.79586904680706,24.189807461538464,24.23474843149862,-2.2041309531929434
2016-05-25,24.6675,24.934999,24.5275,24.905001,22.905935,152675200,2630302363.991842,175338400,32.68794664919471,-64.0,-0.3306154195445359,57.52842441807169,98.83162564036041,24.119711307692306,24.284396769906127,-1.16837435963958
2016-05-26,24.92,25.182501,24.66,25.102501,23.087578,225324800,2786628314.228876,400663200,31.509716994688148,-60.0,-0.21448963294045242,59.56426387269991,97.15808271471312,24.055095999999995,24.344997083246415,-2.8419172852868733
2016-05-27,24.860001,25.1175,24.8125,25.0875,23.073788,145364800,2903396760.130514,255298400,30.41564660121777,-56.00000000000001,-0.12226022596642494,59.33163198594174,96.6251876997557,24.00105753846154,24.39999729930224,-3.374812300244296
2016-05-31,24.9,25.1,24.705,24.965,22.961121,169228800,2956950177.8520327,86069600,29.13635766800127,-52.0,-0.058379519921626155,57.36145963868523,92.27350185666013,23.945096,24.44184935120578,-7.726498143339867
2016-06-01,24.754999,24.885,24.5825,24.615,22.639212,116693200,2865331549.752858,-30623600,27.647231605906292,-48.0,-0.035585467950099314,52.043988558470566,79.84011373352975,23.88144215384615,24.454675325190536,-20.159886266470252
2016-06-02,24.4,24.459999,24.157499,24.43,22.469065,160766400,2994211462.257982,-191390000,26.030557243093163,40.0,-0.03207918258266318,49.435367036715704,71.94778305767643,23.817692153846153,24.45284752332457,-28.052216942323568
2016-06-03,24.4475,24.567499,24.362499,24.48,22.515051,114019600,3010898369.766274,-77370400,24.286489664601408,40.0,-0.02497791418842965,50.1624436890791,69.05283301637316,23.818653692307695,24.454858817893122,-30.947166983626833
2016-06-06,24.497499,25.4725,24.387501,24.657499,22.678297,93170000,2964098391.6003957,15799600,24.08358903680284,64.0,-0.0049701293873809504,52.75936990780958,63.28822670640851,23.855192115384618,24.46986920175289,-36.71177329359149
2016-06-07,24.8125,24.967501,24.74,24.7575,22.770279,89638000,2888250792.521712,105437600,23.89518131098989,64.0,0.01873941288566172,54.207121111759655,65.62500000000004,23.90605753846154,24.49117518680823,-34.374999999999964
2016-06-08,24.754999,24.889999,24.67,24.735001,22.749582,83392400,2854136701.8994813,22045200,23.547162490790647,64.0,0.035306918508293705,53.807576533796,64.54331730769235,23.957019115384618,24.50923635815577,-35.456682692307645
2016-06-09,24.625,24.997499,24.615,24.9125,22.912836,106405600,2913251356.854397,128450800,23.408756488482982,64.0,0.062044264298009466,56.52976544386582,69.60652938587283,23.999999884615384,24.539107739033124,-30.393470614127164
2016-06-10,24.6325,24.8375,24.620001,24.7075,22.724291,126851600,2888463565.4089203,1599200,23.280236629197294,64.0,0.06593199374239589,52.66923355015502,50.80385852090028,24.04461523076923,24.551581239845486,-49.19614147909972
2016-06-13,24.672501,24.780001,24.275,24.334999,22.381683,152082000,2772519188.5740237,-150482800,22.237912768330883,64.0,0.03851139437555062,46.46038544834819,13.498088594609328,24.084038307692307,24.535538110968044,-86.50191140539067
2016-06-14,24.33,24.620001,24.1875,24.365,22.409279,127727600,2749631341.5456924,-22755200,21.05108560577063,64.0,0.01898238467929403,47.00226691980969,15.779531726591634,24.129615230769232,24.522905658303745,-84.22046827340837
2016-06-15,24.455,24.602501,24.2575,24.285,22.335703,117780800,2650627136.396142,-140536000,19.949031811964684,64.0,-0.0029162113468785833,45.674737778389655,9.695886162824126,24.171442153846154,24.505283016947914,-90.30411383717588
2016-06-16,24.112499,24.4375,24.0175,24.387501,22.429974,125307200,2746099885.478047,-15228800,18.743645117400792,64.0,-0.01186327989904612,47.712465807354235,25.429621993127256,24.211153730769233,24.49655842309992,-74.57037800687274
2016-06-17,24.155001,24.1625,23.825001,23.8325,21.919523,244032800,2512911573.7117887,-259261600,18.08402196719894,64.0,-0.06301148141542612,39.14955266832344,0.45517478311059717,24.238269076923075,24.447368910277703,-99.54482521688941
2016-06-20,24.0,24.1425,23.7575,23.775,21.86664,137647600,2387777391.8936057,-396909200,17.629609218549223,60.0,-0.10695367369845243,38.381015457094406,1.0204081632652067,24.284038346153846,24.397563805812688,-98.9795918367348
2016-06-21,23.735001,24.0875,23.67,23.977501,22.052887,142185600,2455039524.519235,-254723600,17.415846245953578,56.00000000000001,-0.12400854601480304,42.650832120154654,17.059694868238488,24.335865346153845,24.366448042419158,-82.94030513176152
2016-06-22,24.0625,24.2225,23.8375,23.887501,21.970106,116876400,2368521238.1628723,-371600000,16.791506075125714,52.0,-0.14313690984083394,41.281678867715826,12.066629680998547,24.35192311538462,24.330970483721444,-87.93337031900144
2016-06-23,23.985001,24.0725,23.8125,24.025,22.096571,128960800,2450361745.8551774,-242639200,16.278723424512055,44.0,-0.14552374862372375,44.227371188092356,19.6948682385574,24.377019307692308,24.30830600344578,-80.30513176144261
2016-06-24,23.227501,23.665001,23.1625,23.35,21.47575,301245600,2373925847.726418,-543884800,17.24396034719248,-56.0,-0.19958154255763105,34.95633017947334,10.217989219612654,24.3658655,24.23732037356091,-89.78201078038734
2016-06-27,23.25,23.262501,22.875,23.01,21.163046,181958400,2318751037.9623156,-725843200,18.62228786065005,-60.0,-0.26678258860205517,31.38729305304821,6.360427024936242,24.34509630769231,24.146407753297137,-93.63957297506376
2016-06-28,23.225,23.415001,23.035,23.397499,21.51944,161779600,2465628221.6044636,-564063600,19.394522274882394,-60.0,-0.2854811222425333,39.02797628651644,24.617161185941644,24.32942319230769,24.09093303083068,-75.38283881405836
2016-06-29,23.4925,23.637501,23.407499,23.6,21.705685,146124000,2564102234.8739147,-417939600,19.41264658237669,-60.0,-0.28072369848800705,42.623817924332094,36.94267515923577,24.30990396153846,24.054567621139515,-63.05732484076423
2016-06-30,23.610001,23.942499,23.575001,23.9,21.981602,143345600,2674293669.9293413,-274594000,18.57143634981612,-60.0,-0.24986561778587912,47.558132795335574,53.80574603372908,24.287788576923074,24.043118167721772,-46.19425396627092
2016-07-01,23.872499,24.1175,23.8325,23.9725,22.048285,104106000,2672467248.87671,-170488000,17.341209874709744,-60.0,-0.21705811161998767,48.706185033137785,62.89394676564662,24.251923153846157,24.037887192334974,-37.10605323435338
2016-07-05,23.8475,23.85,23.615,23.747499,21.841341,110820800,2686613641.891179,-281308800,16.709837245882998,-60.0,-0.20682942602995524,45.385471018179395,50.50642517717797,24.199807692307694,24.016376955865717,-49.49357482282203
2016-07-06,23.65,23.915001,23.592501,23.8825,21.965506,123796400,2785458061.7584662,-157512400,15.94681100925574,-60.0,-0.1856891575360038,47.689934575203665,64.48000000000002,24.15346153846154,24.00646014432011,-35.51999999999998
2016-07-07,23.924999,24.125,23.905001,23.985001,22.059776,100558400,2758033376.002623,-56954000,14.93397508185644,-60.0,-0.1588334354107026,49.434517463299976,82.37484230055661,24.115769269230775,24.004870578074176,-17.62515769944339
2016-07-08,24.122499,24.2225,24.012501,24.17,22.229931,115648400,2815857300.64798,58694400,14.242254560876292,-60.0,-0.12122480485200882,52.51280260497344,96.10389610389622,24.098653884615388,24.01710238710572,-3.8961038961037797
2016-07-11,24.1875,24.4125,24.182501,24.245001,22.298914,95179600,2772405969.031755,153874000,14.068633400110198,-60.0,-0.08439488854702404,53.7422819890012,89.1057560975608,24.09153853846154,24.033983765838627,-10.894243902439205
2016-07-12,24.2925,24.424999,24.280001,24.355,22.400084,96670000,2775739463.28685,250544000,13.938167577675026,-60.0,-0.04580292690013721,55.55959238869331,95.48393257027914,24.086730846153845,24.057762746146878,-4.516067429720875
2016-07-13,24.352501,24.4175,24.209999,24.217501,22.273617,103568800,2679659524.907757,146975200,13.587691541021517,-48.00000000000001,-0.02601367003262922,52.768860532450155,86.61302362130549,24.069807846153846,24.069595209395256,-13.38697637869451
2016-07-14,24.3475,24.747499,24.33,24.6975,22.715092,155676000,2798048516.6801925,302651200,14.086185545220303,-48.0,0.028077704094709333,60.27110222976168,97.32982500925237,24.067500153846154,24.116106675365977,-2.6701749907476398
2016-07-15,24.73,24.825001,24.625,24.695,22.712793,120548000,2761883694.7643023,182103200,14.72538443713817,-48.0,0.06993758178313669,60.21745227440535,93.33328547011001,24.065961653846156,24.158987662375907,-6.666714529889985
2016-07-18,24.674999,25.032499,24.65,24.9575,22.954226,145975600,2850614575.042681,328078800,15.770981159569862,56.0,0.12287694371244129,63.85556121327675,96.24535481619756,24.067692423076924,24.218136724422134,-3.7546451838024333
2016-07-19,24.889999,25.0,24.834999,24.967501,22.963417,95119600,2908264197.5225434,423198400,16.741892401827865,56.0,0.16375114529565948,63.99067413976476,96.0001230769229,24.07769246153846,24.27364518927975,-3.999876923077094
2016-07-20,25.0,25.115,24.934999,24.99,22.98411,105104000,2867391230.7279124,528302400,17.89673845204133,64.0,0.1957037745099086,64.31386524352598,91.88311161241012,24.10288480769231,24.32670850859236,-8.116888387589873
2016-07-21,24.9575,25.25,24.782499,24.8575,22.862242,130808000,2778554181.840317,397494400,18.334018298593808,68.0,0.20793784270329851,60.85014075597973,76.31974438596959,24.121827115384615,24.366026396844777,-23.680255614030415
2016-07-22,24.815001,24.825001,24.577499,24.665001,22.685202,113254800,2745379716.622258,284239600,17.957929927677192,68.0,0.19979723125705462,56.121209169531916,64.7059213912045,24.136442538461537,24.388172663745163,-35.2940786087955
2016-07-25,24.5625,24.709999,24.23,24.334999,22.381683,161531600,2654517665.802152,122708000,16.862779352970954,68.0,0.16481742193299453,49.07955293343483,44.79628645326486,24.13442323076923,24.384233873838113,-55.20371354673514
2016-07-26,24.205,24.4925,24.105,24.1675,22.227627,224959200,2502125949.67312,-102251200,16.200763834447923,68.0,0.12217158360863678,45.929486452856004,19.516668785627466,24.147307846153847,24.368179512813068,-80.48333121437254
2016-07-27,26.067499,26.0875,25.6875,25.737499,23.67161,369379200,2225089702.7771196,267128000,17.66881510276359,84.0,0.21260941872649042,67.18772584837943,83.1324737987826,24.222788576923076,24.469610585938028,-16.86752620121741
2016-07-28,25.7075,26.112499,25.705,26.084999,23.991215,159479200,2363044049.955395,426607200,19.063218053505345,88.0,0.3087631708133962,69.99923347973214,98.63013630392842,24.30384619230769,24.589268986979658,-1.369863696071573
2016-07-29,26.047501,26.137501,25.92,26.0525,23.961325,110934800,2387270568.753927,315672400,20.391159410676057,92.0,0.37798612563005207,69.40031973667458,95.81791103669805,24.38711538461538,24.69765646942561,-4.182088963301956
2016-08-01,26.102501,26.5375,26.102501,26.512501,24.384407,152671600,2522394370.5824366,468344000,22.12700440031034,96.0,0.4646083366615663,72.93069996049078,98.97229188078104,24.4827885,24.832089397616304,-1.0277081192189554
2016-08-02,26.512501,26.5175,26.0,26.120001,24.023409,135266400,2449860736.8293924,333077600,23.426591246436157,96.0,0.4958695181060655,65.94002267664983,82.83662898252815,24.589327,24.92749025705213,-17.16337101747185
2016-08-03,26.202499,26.459999,26.192499,26.4475,24.324623,120810400,2559381348.495936,453888000,24.633350460695844,92.0,0.5408362384046796,68.64102943081654,96.30010277492292,24.721538538461537,25.040083571344567,-3.699897225077074
2016-08-04,26.395,26.5,26.32,26.467501,24.47489,109634800,2629427022.2159343,563522800,25.811418841056756,88.0,0.5714987202522579,68.80373794921888,97.12234326824243,24.83961553846154,25.14581819568941,-2.8776567317575656
2016-08-05,26.567499,26.9125,26.545,26.870001,24.847084,162213600,2754122713.174299,725736400,27.453269995842994,100.0,0.621117488420559,71.95707674915576,98.48623330365083,24.96538480769231,25.27353544045316,-1.5137666963491696
2016-08-08,26.879999,27.092501,26.790001,27.092501,25.052835,112148800,2866271513.174299,837885200,29.18886562204714,92.0,0.6706636174593115,73.54878170479034,100.0,25.08817330769231,25.40827363004922,-0.0
2016-08-09,27.057501,27.235001,27.002501,27.202499,25.154558,105260800,2942102751.698169,943146000,30.962068485849787,96.0,0.7106136887294561,74.32466232786824,98.96159777584732,25.212404038461536,25.541179213008533,-1.0384022241526734
2016-08-10,27.1775,27.225,26.940001,27.0,24.9673,96034000,2886503588.0730343,847112000,32.37027397455443,96.0,0.7176616740410502,70.23999691923069,92.49198322939831,25.33750023076923,25.649240012044938,-7.508016770601685
2016-08-11,27.129999,27.2325,26.9625,26.9825,24.95112,109938000,2792852699.184148,737174000,33.6877298266201,92.0,0.7136091078431122,69.88256590401969,91.93287797671634,25.456730999999998,25.748000011152723,-8.067122023283659
2016-08-12,26.945,27.110001,26.945,27.045,25.008917,74641600,2808685217.5228257,811815600,34.83603042483587,88.0,0.7072874778265721,70.46070785916285,93.92968245058073,25.574423269230767,25.84407408440067,-6.070317549419274
2016-08-15,27.035,27.385,27.02,27.370001,25.309441,103472800,2903653970.7984405,915288400,36.280755765962944,56.0,0.7202003833369588,73.32793752340687,99.11640648011765,25.69750023076923,25.9571057077784,-0.8835935198823611
2016-08-16,27.407499,27.557501,27.3025,27.344999,25.286322,135177600,2813534333.8840785,780110800,37.83576605655448,60.0,0.720115458784278,72.74297480010313,88.52891307481092,25.816730923076925,26.059912618313334,-11.471086925189086
2016-08-17,27.275,27.342501,27.084999,27.305,25.24934,101424000,2885416804.69984,678686800,38.344629039092396,60.0,0.7086516750602776,71.75673963014889,84.58010101978569,25.93019246153846,26.152141313253086,-15.419898980214318
2016-08-18,27.307501,27.4,27.254999,27.27,25.216972,87938800,2815673326.646583,590748000,38.90771598398153,60.0,0.6888022527687063,70.85154422148807,81.54087862543913,26.047596269230766,26.234945660419523,-18.459121374560862
2016-08-19,27.192499,27.422501,27.09,27.34,25.281702,101472400,2866790542.9184136,692220400,38.73639199830399,60.0,0.6709851583491719,71.6225673837965,86.0352577622744,26.149230884615385,26.316801537425484,-13.964742237725615
2016-08-22,27.215,27.275,26.9625,27.127501,25.085201,103280800,2872574928.7155337,588939600,38.066277540163576,60.0,0.6324278546489772,65.92190699225333,68.49821465463049,26.242788615384615,26.37685334946804,-31.501785345369505
2016-08-23,27.147499,27.33,27.1325,27.2125,25.163799,85030800,2856429840.107938,673970400,37.56396604192224,60.0,0.6017925328935654,67.05157681906081,72.12115384149182,26.329519384615384,26.438753101359293,-27.878846158508185
2016-08-24,27.1425,27.1875,26.92,27.0075,24.974234,94700400,2823682972.8182178,579270000,36.25520723577447,60.0,0.5545791892630447,61.73612326591795,45.678967230649654,26.407980884615384,26.480882501258606,-54.321032769350346
2016-08-25,26.8475,26.969999,26.67,26.8925,24.867893,100344800,2872183455.635825,478925200,34.1681741072175,60.0,0.5020948979369848,58.91460438636518,25.070394286879385,26.48115396153846,26.511372686350562,-74.92960571312062
2016-08-26,26.852501,26.987499,26.577499,26.735001,24.722248,111065200,2846449919.6865573,367860000,31.930621474555412,60.0,0.4426888246993421,55.19410734257637,16.07159985387796,26.55336553846154,26.52793774662089,-83.92840014612204
2016-08-29,26.655001,26.860001,26.5725,26.705,24.694508,99881200,2838632809.8984156,267978800,29.83617913552978,60.0,0.3887074758698539,54.48823951469969,13.451762993133727,26.631827038461537,26.541053469093416,-86.54823700686627
2016-08-30,26.450001,26.625,26.375,26.5,24.504946,99455600,2838632809.8984156,168523200,28.165627589839403,60.0,0.32563140512458943,49.80144974677417,10.57081558493398,26.71509630769231,26.538012471382793,-89.42918441506602
2016-08-31,26.415001,26.6425,26.41,26.525,24.528063,118649600,2837357007.747877,287172800,26.550894354669644,56.00000000000001,0.2744962339694723,50.362182858933835,12.684978701920656,26.805769384615385,26.537048584613697,-87.31502129807934
2016-09-01,26.535,26.700001,26.405001,26.682501,24.673702,106806000,2931491109.442791,393978800,24.83505294286983,52.0,0.2438690858112551,53.85905312784995,26.004290905462142,26.842115615384614,26.547822837605274,-73.99570909453786
2016-09-02,26.924999,27.0,26.705,26.932501,24.904886,107210000,2989639632.9004173,501188800,23.89762781023825,48.0,0.237037341974343,58.818267027212684,47.1459220753301,26.874711846153847,26.57631751630118,-52.8540779246699
2016-09-06,26.975,27.075001,26.877501,26.924999,24.897942,107521600,2933835105.880671,393667200,23.25448056818505,40.0,0.22838510572634263,58.614677958514086,52.50582099682954,26.9082695,26.602145774352945,-47.49417900317046
2016-09-07,26.9575,27.190001,26.7675,27.09,25.050522,169457200,3023075267.543721,563124400,22.998777896334918,40.0,0.2321660818200577,61.750571972610125,68.25769140077189,26.930481,26.638283124400875,-31.74230859922811
2016-09-08,26.8125,26.817499,26.309999,26.379999,24.393974,212008000,2869552233.0609627,351116400,21.608949695086665,36.0,0.1758443613029428,45.70279540620971,6.292123519777972,26.940480923076922,26.619150967037847,-93.70787648022203
2016-09-09,26.16,26.43,25.782499,25.782499,23.841459,186228000,2683324233.0609627,164888400,21.65585837901374,-68.0,0.08204991518493898,36.99057913503521,0.0,26.914903961538464,26.557176747257266,-100.0
2016-09-12,25.6625,26.43,25.6325,26.360001,24.375475,181171200,2832691538.8194585,346059600,22.01096434054377,-72.0,0.0536977318710079,47.422936912847405,42.85720176730492,26.910769346153845,26.54257113634932,-57.14279823269508
2016-09-13,26.877501,27.1975,26.809999,26.987499,24.955742,248704800,2811831838.5740376,594764400,20.672862432941344,-72.0,0.08092936338435663,55.95603816956234,86.58140575079861,26.9152885,26.575528755879,-13.418594249201387
2016-09-14,27.182501,28.2575,27.15,27.942499,25.838842,443554800,3003070240.2809463,1038319200,21.22626188991303,8.0,0.17752475145453772,65.21021897329135,87.99996190476196,26.94798073076923,26.67678581099907,-12.000038095238049
2016-09-15,28.465,28.932501,28.372499,28.8925,26.717319,359934400,3311584338.444881,1398253600,22.513683274432417,12.0,0.3269653802678718,71.60227443772217,98.787848852167,27.012980769230772,26.840912787962104,-1.2121511478329914
2016-09-16,28.780001,29.032499,28.51,28.73,26.567051,319547600,3261129969.2453213,1078706000,23.811418280929672,16.0,0.42735942984791464,69.25818628489361,91.10296797146114,27.07951923076923,26.980845174038986,-8.897032028538858
2016-09-19,28.797501,29.045,28.3125,28.395,26.257277,188092000,3115406815.661703,890614000,24.536759229887203,20.0,0.4744218968425642,64.56547739570976,80.9523809523809,27.133846153846154,27.08559738336943,-19.0476190476191
2016-09-20,28.262501,28.530001,28.127501,28.3925,26.254965,138057200,3159138534.632138,752556800,24.77066085585343,20.0,0.5056882525011339,64.53033783537404,80.87912087912078,27.185673076923077,27.182404984601323,-19.120879120879213
2016-09-21,28.4625,28.497499,28.110001,28.387501,26.25034,144012800,3221390293.416957,608544000,24.94532610508899,20.0,0.5240230752820523,64.45479748125031,80.73263003663,27.224807692307692,27.271671356112336,-19.267369963369998
2016-09-22,28.5875,28.735001,28.5,28.655001,26.497704,124296000,3261059589.700801,732840000,25.43892139487696,20.0,0.553755223326565,66.701109951307,88.5714578754578,27.275192384615384,27.374140218622532,-11.42854212454221
2016-09-23,28.605,28.6975,27.887501,28.1775,26.056149,209924800,3201450980.4002943,522915200,24.480637068808367,20.0,0.5326477926112787,59.4756788334131,74.5787545787545,27.30875007692308,27.43364835057642,-25.421245421245505
2016-09-26,27.91,28.3475,27.887501,28.219999,26.095448,119477600,3254695769.1220098,642392800,23.590801623173245,20.0,0.5134308050980358,59.892116076569366,75.82414652014653,27.345288500000002,27.491896546830016,-24.17585347985348
2016-09-27,28.25,28.295,28.084999,28.272499,26.144001,98429600,3332032474.9967422,740822400,22.76452585222635,19.999999999999993,0.49671173163212856,60.43303457425058,77.36260805860802,27.381153846153843,27.549718950768533,-22.637391941391986
2016-09-28,28.422501,28.66,28.3575,28.487499,26.342813,118564400,3315373882.8354187,859386800,22.629945359419757,20.0,0.49510320704622046,62.65432930825871,83.6629743589743,27.43346146153846,27.619184139600492,-16.337025641025694
2016-09-29,28.290001,28.450001,27.950001,28.045,25.93362,143548000,3226373548.6434193,715838800,21.572664996564953,20.0,0.4529016996692725,55.720871729460235,70.69597069597071,27.46548069230769,27.65072605518564,-29.304029304029292
2016-09-30,28.115,28.342501,27.950001,28.262501,26.134748,145516400,3312571161.3822737,861355200,20.590904659628354,20.0,0.43202707480505964,58.17111237873734,64.98887472533563,27.513749961538466,27.69604271776448,-35.01112527466436
2016-10-03,28.1775,28.262501,28.07,28.129999,26.012226,86807200,3279876357.60671,774548000,19.679270061044367,20.0,0.40017896615298554,56.13324604682592,51.71498680738793,27.56134607692308,27.728187627559702,-48.28501319261207
2016-10-04,28.264999,28.577499,28.157499,28.25,26.123188,118947200,3213323133.545757,893495200,19.45429812638912,20.000000000000007,0.3802390295605882,57.582551678920765,31.317435263442928,27.61961526923077,27.76684039588861,-68.68256473655707
2016-10-05,28.35,28.415001,28.172501,28.262501,26.134748,85812400,3191206535.6076126,979307600,19.24539561563782,20.0,0.36128059457155004,57.739193180864696,32.39743619648912,27.67951915384615,27.803555996193158,-67.60256380351089
2016-10-06,28.424999,28.584999,28.282499,28.4725,26.328941,115117200,3220700133.0767035,1094424800,19.384058431734605,19.999999999999996,0.3590620190721978,60.385690991645525,50.53991407335982,27.755384538461538,27.853107403882554,-49.46008592664018
2016-10-07,28.577499,28.639999,28.377501,28.514999,26.368238,97433600,3225339121.3082333,1191858400,19.620163544169365,20.0,0.35662217765165494,60.9190807753436,74.04106194690254,27.83192296153846,27.902136411002367,-25.958938053097448
2016-10-10,28.754999,29.1875,28.68,29.012501,26.828287,144944000,3270322313.2057705,1336802400,20.776656251375304,80.0,0.390333319813319,66.59018336189915,86.53852810656011,27.921538346153845,27.984385639817006,-13.461471893439898
2016-10-11,29.424999,29.672501,29.049999,29.075001,26.886082,256164000,3034735314.8154044,1592966400,22.489461919803933,84.0,0.41728269535521534,67.23346785586142,66.5266106442577,28.00394219230769,28.065171962793524,-33.4733893557423
2016-10-12,29.3375,29.495001,29.1875,29.334999,27.126505,150347200,3028622193.0967765,1743313600,24.079924326201944,84.0,0.4543821013170408,69.83542905826387,81.09232492997195,28.0966345,28.15923322480882,-18.907675070028045
2016-10-13,29.1975,29.360001,28.93,29.245001,27.043282,140769600,3094096600.760013,1602544000,24.73968438800574,84.0,0.47109111622938116,67.82761083956854,76.05042016806712,28.179519153846154,28.239660467415575,-23.949579831932883
2016-10-14,29.469999,29.5425,29.282499,29.407499,27.193554,142608800,3088611119.51648,1745152800,25.623268152207118,84.0,0.4917764684686361,69.53097307576327,84.61526850507988,28.29596146153846,28.32616702538479,-15.38473149492012
2016-10-17,29.3325,29.459999,29.195,29.387501,27.175058,94499600,3131404622.506303,1650653200,26.164295231793755,84.0,0.500783368730513,69.04647900621632,83.4542815674891,28.434615384615384,28.40478435683777,-16.545718432510892
2016-10-18,29.545,29.5525,29.362499,29.3675,27.156559,98214000,3038360787.0212264,1552439200,26.81680545039374,80.0,0.5005376026253714,68.53213433495193,82.29312046444117,28.550288423076925,28.476096626701636,-17.706879535558823
2016-10-19,29.3125,29.440001,28.450001,29.280001,27.075649,80138400,3092595865.809105,1472300800,25.001681168252222,76.0,0.48766094140196614,66.20852721591518,77.2133526850507,28.638461576923078,28.53564509879781,-22.786647314949306
2016-10-20,29.215,29.344999,29.0825,29.264999,27.061775,96503200,3130277843.6330194,1375797600,23.316208620549386,48.0,0.4708182587750578,65.79661681423494,74.57087390273074,28.689326961538463,28.589671313701675,-25.42912609726926
2016-10-21,29.202499,29.227501,29.07,29.15,26.955435,92770800,3131749797.647278,1283026800,21.722413502048944,48.0,0.44308326516394914,62.58243193580738,65.51153067784715,28.69923080769231,28.631177142316364,-34.48846932215285
2016-10-24,29.275,29.434999,29.25,29.4125,27.198175,94154800,3203002972.8255224,1377181600,20.710412374136336,48.0,0.43724435831576614,66.59397962297322,82.66660000000006,28.72548080769231,28.68905290955219,-17.333399999999937
2016-10-25,29.487499,29.59,29.327499,29.5625,27.336878,192516000,3355182440.774216,1569697600,20.104464971352066,48.0,0.43965268647384903,68.66155110681404,92.08627037946704,28.770384653846158,28.753752694029806,-7.913729620532958
2016-10-26,28.577499,28.924999,28.327499,28.897499,26.721943,264536800,3595368572.9917893,1305160800,19.87855431676125,48.00000000000001,0.38348075341851384,53.000205645969,42.37911913885629,28.78980769230769,28.76440056854612,-57.62088086114371
2016-10-27,28.8475,28.965,28.525,28.620001,26.46534,138248000,3516819201.391789,1166912800,19.576292635089708,48.0,0.3129646605299392,48.072606493934614,21.747328256760863,28.79875,28.753704304209368,-78.25267174323913
2016-10-28,28.467501,28.8025,28.362499,28.43,26.289646,151446800,3411839615.9972105,1015466000,19.574002743563096,48.0,0.23899368563968437,44.98842904029412,7.620880861143709,28.790096115384618,28.729726207601267,-92.3791191388563
2016-10-31,28.4125,28.557501,28.299999,28.385,26.24803,105677600,3375930030.828942,909788400,19.679789166434464,44.0,0.17472589977820263,44.264102069226986,6.589219698279448,28.798076884615384,28.70419093296414,-93.41078030172055
2016-11-01,28.365,28.442499,27.6325,27.872499,25.774109,175303200,3304509904.0100203,734485200,20.779567029909906,-60.0,0.0814991968978056,36.96469136842153,12.260485312899158,28.784711499999997,28.642584123114943,-87.73951468710084
2016-11-02,27.85,28.0875,27.807501,27.897499,25.79723,113326800,3264034688.0971074,847812000,21.80078933170853,-60.0,0.0095238690354158,37.506073513272334,13.537624521072777,28.770288423076924,28.587392632513836,-86.46237547892723
2016-11-03,27.745001,27.865,27.387501,27.4575,25.520716,107730400,3187889779.4577174,740081600,23.281159205681313,-68.0,-0.08207522680019963,32.255360216786556,3.1781626234563225,28.730673076923075,28.503696881957257,-96.82183737654368
2016-11-04,27.1325,27.5625,27.0275,27.209999,25.290672,123348000,3148694626.754914,616733600,25.04895392294797,-72.0,-0.17264923947140431,29.73375863444474,7.12191219512195,28.698557653846155,28.407867409219683,-92.87808780487805
2016-11-07,27.52,27.627501,27.365,27.602501,25.655487,130240000,3254127102.2121515,746973600,26.49717298129259,-72.0,-0.21033357145628884,38.01021284445463,22.43906341463416,28.673173038461535,28.34821063816637,-77.56093658536584
2016-11-08,27.577499,27.93,27.424999,27.764999,25.806524,97016800,3287746526.6948752,843990400,26.97069412810516,-72.0,-0.2244985657868277,41.10321357116246,28.78044878048779,28.659134576923073,28.305009776079974,-71.21955121951221
2016-11-09,27.469999,27.83,27.012501,27.719999,25.7647,236705600,3460750880.074147,607284800,27.93455278590263,-84.0,-0.23662785119352492,40.500556789947275,27.449011619403198,28.638749923076922,28.261675644518494,-72.5509883805968
2016-11-10,27.772499,27.772499,26.4575,26.9475,25.04669,228538000,3402530302.368766,378746800,29.41295299381843,-88.0,-0.30505809074357515,31.863624091855257,15.642458100558722,28.58817296153846,28.164329300480087,-84.35754189944127
2016-11-11,26.780001,27.217501,26.637501,27.1075,25.1954,136575600,3487300893.4873877,515322400,30.785753186883102,-88.0,-0.34243154804639175,34.957497393581676,20.75019952114931,28.53567296153846,28.086045648592673,-79.2498004788507
2016-11-14,26.9275,26.952499,26.02,26.4275,24.563366,204702000,3461507535.748666,310620400,32.61232442917472,-96.0,-0.42205540720904366,28.942526300067982,13.837011884550044,28.455384538461537,27.963190415363588,-86.16298811544995
2016-11-15,26.6425,26.92,26.540001,26.7775,24.888685,129058000,3493771781.028258,439678400,34.308426297016936,-96.0,-0.45170879649933227,35.1295780483717,25.721561969439737,28.36942296153846,27.875361495707025,-74.27843803056027
2016-11-16,26.674999,27.557501,26.65,27.497499,25.557892,235362000,3698010529.9817038,675040400,34.17912148771653,-56.0,-0.4123580126498503,45.61936752123427,53.09969451931724,28.30874980769231,27.84737168121021,-46.90030548068276
2016-11-17,27.452499,27.5875,27.2075,27.487499,25.548595,110528000,3750365316.676441,564512400,33.98642701415378,-56.0,-0.37762611062932194,45.50929650869056,57.83245011529063,28.237692115384615,27.82071444556501,-42.16754988470937
2016-11-18,27.43,27.635,27.415001,27.514999,25.57416,113715600,3740025937.1938057,678228000,33.68619372753399,-56.0,-0.34391734282828423,45.895904847516036,61.71309049043978,28.171153576923075,27.798068857004637,-38.28690950956022
2016-11-21,27.530001,27.997499,27.502501,27.932501,25.96221,117058400,3826342548.8100133,795286400,32.517780188927716,-56.0,-0.2802830507582037,51.51964381395876,92.50307134220071,28.114422884615387,27.80802679352281,-7.496928657799283
2016-11-22,27.987499,28.105,27.85,27.950001,25.978476,103862000,3803941755.570797,899148400,31.18361107369621,-56.0,-0.2258370036861166,51.74605195555729,92.56599520383693,28.059134423076923,27.81854340141001,-7.434004796163071
2016-11-23,27.84,27.877501,27.5825,27.807501,25.846027,109705600,3861583857.4809594,789442800,30.398968987519844,-56.0,-0.19197372459901985,49.71025829884986,85.73146282973612,27.999134461538464,27.817725445750007,-14.268537170263876
2016-11-25,27.782499,27.967501,27.737499,27.9475,25.976152,45903600,3899503892.958913,835346400,29.44675417976227,-56.0,-0.15208691933592178,51.71990362568606,92.44604316546769,27.94788442307692,27.82733837569445,-7.5539568345323165
2016-11-28,27.8575,28.1175,27.8475,27.8925,25.92503,108776000,3826986559.625578,726570400,28.18910280539169,-56.0,-0.12349085345359612,50.860021363967164,89.27294398092961,27.895096,27.83216516268004,-10.727056019070389
2016-11-29,27.695,28.0075,27.5175,27.865,25.899471,114115200,3874728633.094965,612455200,27.62384182784114,-56.0,-0.10187295735259028,50.40874575335744,87.96185935637658,27.845672923076922,27.834597372851892,-12.038140643623422
2016-11-30,27.9,28.049999,27.567499,27.629999,25.681049,144649200,3767553319.1053276,467806000,26.98643748887201,-56.00000000000001,-0.10252143240334277,46.60331491345394,76.75799761620986,27.77711519230769,27.81944193782583,-23.242002383790137
2016-12-01,27.592501,27.735001,27.2575,27.372499,25.441713,148347600,3690660336.5926213,319458400,26.936283226306966,-48.0,-0.12240247203109789,42.79137223082774,64.48147794994048,27.692884384615386,27.786335053542434,-35.51852205005952
2016-12-02,27.2925,27.522499,27.2125,27.475,25.536976,106112000,3764254722.742255,425570400,26.965393939955295,-48.0,-0.12840716721488477,44.72939693244964,69.36829558998815,27.63817288461539,27.763273197724477,-30.631704410011835
2016-12-05,27.5,27.5075,27.0625,27.2775,25.353409,137298000,3759626700.2703447,288272400,27.247062580467777,-44.0,-0.14740335669260674,41.79167151967504,46.751154834329526,27.586538230769232,27.72728999789303,-53.248845165670474
2016-12-06,27.375,27.59,27.297501,27.487499,25.548595,104782000,3790970775.4774394,393054400,27.24453902094528,-40.0,-0.14385454381398688,45.86309599445028,57.06977853492337,27.550288192307693,27.70952770175281,-42.93022146507663
2016-12-07,27.315001,27.797501,27.290001,27.7575,25.799557,119994800,3892049666.138326,513049200,26.596509793484937,-36.0,-0.11789622553228796,50.643237459461524,65.87677725118488,27.526153576923075,27.713081205326674,-34.123222748815124
2016-12-08,27.715,28.1075,27.65,28.030001,26.052835,108273200,3963640615.9665217,621322400,25.12876111386359,36.0,-0.07447699353913251,54.96521802306398,91.7062559241705,27.532211346153847,27.736556745672843,-8.29374407582949
2016-12-09,28.077499,28.674999,28.077499,28.487499,26.47806,137610400,4014884656.133886,758932800,24.176224232830016,72.0,-0.0031147691166992786,61.12067919996854,88.37208581214624,27.554903653846154,27.792182097845224,-11.627914187853762
2016-12-12,28.3225,28.75,28.122499,28.325001,26.327028,105497600,3977477704.5797048,653435200,23.439061123923445,76.0,0.039868498098790894,58.083909379245554,74.8148740740741,27.588269076923076,27.8316501646715,-25.185125925925906
2016-12-13,28.459999,28.98,28.4375,28.797501,26.766197,174935200,4034715212.1749125,828370400,23.195684158628957,80.0,0.11078281289042735,63.72732194051941,90.48245110821382,27.649326846153844,27.90319467099213,-9.517548891786175
2016-12-14,28.76,29.049999,28.745001,28.797501,26.766197,136127200,3945451781.773403,964497600,23.100827350832496,84.0,0.16507997903327265,63.72732194051941,87.29569172110278,27.695288384615385,27.96943958425197,-12.70430827889721
2016-12-15,28.844999,29.182501,28.807501,28.955,26.91259,186098000,3905749882.5840697,1150595600,23.262255452517902,88.0,0.2183032632872539,65.52185033711014,89.26882581659159,27.741057653846156,28.042444059492563,-10.73117418340842
2016-12-16,29.1175,29.125,28.9125,28.9925,26.947441,177404400,3861920560.231127,1328000000,23.412152975511496,88.0,0.2605060841325475,65.95374536766278,91.03769290674867,27.79,28.112818573604223,-8.962307093251319
2016-12-19,28.950001,29.344999,28.9375,29.16,27.103125,111117600,3872146404.0187187,1439117600,23.973939181044994,96.0,0.30396406531751907,67.88865623328154,91.89489239644787,27.875096153846155,28.190387568152058,-8.10510760355212
2016-12-20,29.184999,29.375,29.17,29.237499,27.175158,85700000,3842882153.28701,1524817600,24.552082731267586,100.0,0.340730619632609,68.77293413187635,94.0540108108108,27.95701919230769,28.26795137791857,-5.945989189189203
2016-12-21,29.200001,29.35,29.195,29.264999,27.200716,95132800,3833674525.767009,1619950400,25.088930313617137,96.0,0.3678470867497623,69.09812356187626,95.24319999999999,28.06615376923077,28.34180675733201,-4.75680000000002
2016-12-22,29.0875,29.127501,28.91,29.0725,27.021797,104343600,3885245933.054334,1515606800,24.526054496441756,92.0,0.36954414689283155,64.06855601924835,86.91891891891899,28.154423,28.395932182714823,-13.081081081081013
2016-12-23,28.897499,29.129999,28.897499,29.129999,27.075237,56998000,3942243933.054334,1572604800,23.959123775261133,44.0,0.37124923792351794,64.89061709391265,88.24934688218083,28.217211461538458,28.450307502513727,-11.75065311781917
2016-12-27,29.129999,29.450001,29.122499,29.315001,27.24719,73187600,3955094032.825327,1645792400,24.190541110284297,60.0,0.3831123692105436,67.46944137230938,93.74999999999993,28.2875,28.514358872697894,-6.250000000000072
2016-12-28,29.379999,29.504999,29.049999,29.190001,27.131008,83623600,3922931844.900931,1562168800,24.13193847593013,64.0,0.37806938239313226,64.04640447350758,83.01896658704386,28.35192315384615,28.564406437683235,-16.98103341295614
2016-12-29,29.112499,29.2775,29.1,29.182501,27.124041,60158000,3918696043.86431,1502010800,24.07752174402983,64.0,0.3692115507567806,63.83713120276914,77.40819614711015,28.400000076923074,28.61019122007707,-22.59180385288985
2016-12-30,29.1625,29.299999,28.8575,28.955,26.91259,122345200,3850265799.604321,1379665600,23.105593149096627,64.0,0.3399158872154011,57.6803512157459,60.21707052441207,28.438653884615384,28.635732611182473,-39.78292947558793
2017-01-03,28.950001,29.0825,28.690001,29.0375,26.989265,115127600,3938994646.996035,1494793200,21.633657990458033,64.0,0.31967095552667857,59.21645502826178,56.20614164509761,28.485961538461538,28.66549315850229,-43.79385835490239
2017-01-04,28.9625,29.127501,28.9375,29.004999,26.959059,84472400,3914540905.0830994,1410320800,20.409298929468935,64.0,0.29757389559361513,58.31838244068671,38.65015619670253,28.526634576923076,28.69064173935397,-61.34984380329747
2017-01-05,28.98,29.215,28.952499,29.1525,27.096155,88774400,3961041942.3149576,1499095200,19.55255323612365,64.0,0.2886366902831661,61.19473805935601,56.74848281836269,28.575096115384614,28.72485346236479,-43.25151718163731
2017-01-06,29.195,29.540001,29.1175,29.477501,27.398235,127007600,4050473418.234778,1626102800,19.680010602488455,88.0,0.30427130503671407,66.65488845422081,92.64705882352942,28.637115384615388,28.78060513181925,-7.352941176470576
2017-01-09,29.487499,29.8575,29.485001,29.747499,27.649179,134247600,4105432911.4339542,1760350400,20.524611640439385,92.0,0.33459146981471477,70.38320347585228,90.57806473495907,28.71855769230769,28.85222689983264,-9.421935265040927
2017-01-10,29.692499,29.844999,29.575001,29.7775,27.677069,97848400,4154357473.8381195,1858198800,21.30888403282239,92.0,0.3569268186315,70.77423003373679,93.14774573682705,28.811057730769228,28.920765647993186,-6.8522542631729575
2017-01-11,29.684999,29.9825,29.65,29.9375,27.825775,110354400,4234841509.9283442,1968553200,22.335395362349633,100.0,0.3831220142158003,72.83419435163438,96.51837254806374,28.905769269230767,28.996079303697393,-3.481627451936257
2017-01-12,29.725,29.825001,29.5525,29.8125,27.709599,108344800,4333245661.308339,1860208400,22.857493792564686,92.0,0.3893077427879348,68.7567876906237,86.8471851815745,29.00326926923077,29.05655491083092,-13.152814818425494
2017-01-13,29.7775,29.905001,29.702499,29.76,27.660801,104447600,4288114428.0365715,1755760800,23.532353006223182,92.0,0.3855295216659549,67.05878504767851,82.78528648764915,29.09067315384615,29.108661954473074,-17.21471351235085
2017-01-17,29.584999,30.059999,29.555,30.0,27.883873,137759200,4393139249.391068,1893520000,24.51265390735554,100.0,0.3973211772351668,70.62961408911893,95.62050455548103,29.176923153846154,29.174686994882475,-4.37949544451898
2017-01-18,30.0,30.125,29.9275,29.997499,27.88155,94852000,4365523149.623982,1798668000,25.56623422879229,100.0,0.4018322671855685,70.54379667809815,91.11490670028351,29.25259615384616,29.23563603229859,-8.885093299716491
2017-01-19,29.85,30.022499,29.842501,29.945,27.832754,102389200,4379744029.855987,1696278800,26.115945094675897,96.0,0.3965993574067035,68.65797092523923,87.45643725187269,29.308653884615385,29.288181511387585,-12.54356274812732
2017-01-20,30.112499,30.112499,29.932501,30.0,27.883873,130391600,4347145767.653075,1826670400,26.84963801380493,92.0,0.39236731290865734,69.57558755202476,91.2891925360227,29.373076923076926,29.340908806840357,-8.71080746397732
2017-01-23,30.0,30.202499,29.942499,30.02,27.902458,88200800,4311526892.274612,1914871200,27.749082277994916,52.0,0.3861756277559607,69.92045909337402,87.93393445809517,29.420096115384617,29.391211858185514,-12.066065541904841
2017-01-24,29.887501,30.025,29.875,29.9925,27.876905,92844000,4364138492.274613,1822027200,28.212455057909782,52.0,0.37472999833141074,68.76621500108318,83.39927541444698,29.466057615384617,29.435751720542143,-16.600724585553024
2017-01-25,30.105,30.525,30.07,30.469999,28.320721,129510400,4462338116.404725,1951537600,29.720634201007254,60.0,0.3995832858383146,76.1334884550783,96.50232336895192,29.524326807692304,29.512362630131616,-3.497676631048071
2017-01-26,30.4175,30.610001,30.4,30.485001,28.334661,105350400,4442271970.769229,2056888000,31.267013867547377,64.0,0.4156983198014075,76.3224529711251,91.62479623129232,29.581730692307694,29.584409916788534,-8.375203768707689
2017-01-27,30.535,30.5875,30.4,30.487499,28.336985,82251600,4436787653.41883,2139139600,32.70293784362035,64.0,0.4237860265268907,76.3560220802664,89.11093333333326,29.632788346153845,29.651305404433828,-10.889066666666736
2017-01-30,30.2325,30.407499,30.165001,30.407499,28.26263,121510000,4558297653.41883,2017629600,32.798601220848234,64.0,0.41891131212062405,72.79646755214596,80.85089281239463,29.677788346153843,29.70731974484614,-19.14910718760537
2017-01-31,30.2875,30.3475,30.155001,30.3375,28.197573,196804000,4734654378.368048,1820825600,32.8374669687545,64.0,0.4047342075331457,69.73324356705989,74.23160829162323,29.719038384615388,29.75399976374642,-25.768391708376765
2017-02-01,31.7575,32.622501,31.752501,32.1875,29.917076,447940000,4734653348.620922,2268765600,35.54519256045058,80.0,0.5365927813459948,86.2277257565775,85.83059093466095,29.83884607692308,29.934259040505946,-14.169409065339053
2017-02-02,31.995001,32.3475,31.945,32.1325,29.865953,134841600,4725440568.496699,2133924000,38.05950918131123,80.0,0.6293982989333138,84.74901541448075,84.02605247724452,29.954326884615384,30.097091704172172,-15.973947522755477
2017-02-03,32.077499,32.297501,32.040001,32.27,29.993748,98029200,4802530731.376704,2231953200,40.39423175782469,80.0,0.705905205317304,85.42207954550183,88.50852860357676,30.06798069230769,30.25804787423349,-11.491471396423233
2017-02-06,32.282501,32.625,32.224998,32.572498,30.274912,107383600,4881725203.486345,2339336800,42.75368446080535,92.0,0.7819329045604029,86.80204927501337,98.11313499124358,30.19807673076923,30.42948862429027,-1.886865008756406
2017-02-07,32.634998,33.022499,32.612499,32.8825,30.563044,152735200,4930154182.682442,2492072000,45.147649734023794,96.0,0.8573173537729701,88.05044529943379,95.59751295441056,30.340384384615387,30.611193170639137,-4.402487045589427
2017-02-08,32.837502,33.055,32.805,33.009998,30.681559,92016400,4989043206.420044,2584088400,47.38643472600287,100.0,0.9167800264748571,88.53094919276168,98.5848427672957,30.496345846153847,30.788882417258463,-1.4151572327042974
2017-02-09,32.912498,33.112499,32.779999,33.105,30.903257,113399600,5097327717.094328,2697488000,49.49463933992585,100.0,0.9604984620507011,88.8894537336099,99.7683705848248,30.652788153846153,30.960446682646726,-0.23162941517519572
2017-02-10,33.115002,33.235001,33.012501,33.029999,30.833244,80262000,5029689757.328033,2617226000,51.515835247939826,100.0,0.9778219604414566,86.58830127579198,93.89875181584766,30.807595846153845,31.113746854302523,-6.101248184152342
2017-02-13,33.27,33.455002,33.1875,33.322498,31.106291,92141600,5030548820.626254,2709367600,53.50268352334386,100.0,1.0035844852724836,87.90351508146384,96.08555622714559,30.967980384615387,31.277358050280114,-3.9144437728544115
2017-02-14,33.3675,33.772499,33.3125,33.755001,31.510033,132904800,5153342432.600191,2842272400,55.4912653100633,100.0,1.0468336031854193,89.53733540846109,99.51629551695665,31.132499615384614,31.460887157666775,-0.48370448304334435
2017-02-15,33.880001,34.067501,33.654999,33.877499,31.624386,142492400,5164568361.238599,2984764800,57.45604694589982,92.0,1.07856043228319,89.95131496765552,95.14371884984027,31.291345769230773,31.63989544228405,-4.856281150159737
2017-02-16,33.9175,33.974998,33.709999,33.837502,31.58704,90338400,5161161738.454361,2894426400,59.28048703631946,92.0,1.0879357037155373,88.71699845798587,94.12143130990417,31.447499692307694,31.802681113225972,-5.878568690095829
2017-02-17,33.775002,33.9575,33.775002,33.93,31.673393,88792800,5223194771.224032,2983219200,60.974609977423405,92.0,1.0902616320033829,89.0898528285964,96.48559744408946,31.601057384615384,31.960260290024046,-3.51440255591055
2017-02-21,34.057499,34.1875,33.994999,34.174999,31.902098,98028800,5308491605.89606,3081248000,62.64430387877706,96.0,1.099203386280145,90.02966485934554,99.48661169881383,31.76884580769231,32.124315009281524,-0.5133883011861734
2017-02-22,34.107498,34.279999,34.0275,34.2775,31.997774,83347600,5390189412.016485,3164595600,64.2319545490052,100.0,1.1018592178499205,90.4021697094124,99.89297639956192,31.94259580769231,32.28381019377919,-0.1070236004380794
2017-02-23,34.345001,34.369999,34.075001,34.1325,31.862417,83152800,5339451766.337531,3081442800,65.74263273761456,96.0,1.0798162457994565,85.5337896773517,89.80690112180356,32.10153811538461,32.42075017942518,-10.193098878196434
2017-02-24,33.977501,34.165001,33.82,34.165001,31.892771,87106400,5426558166.337531,3168549200,65.9103096884155,96.0,1.0528331851240296,85.71942673027121,90.44298813846692,32.26182665384615,32.5499539439122,-9.557011861533084
2017-02-27,34.285,34.360001,34.07,34.232498,31.955769,81029600,5436336170.040967,3249578800,66.22860067156863,84.0,1.0250788876133754,86.11784496826711,92.17633001422473,32.426730423076926,32.67458683695574,-7.823669985775266
2017-02-28,34.27,34.360001,34.174999,34.247501,31.969778,93931600,5416027869.93178,3343510400,66.52415658449654,84.0,0.9928490774541672,86.20994038860401,92.29572327044025,32.590095846153844,32.79109899718124,-7.704276729559745
2017-03-01,34.4725,35.037498,34.400002,34.947498,32.623219,145658400,5520558934.230851,3489168800,67.27117794828432,100.0,1.0121234988114338,89.65748596366026,96.01328727055932,32.779615,32.95083225664929,-3.986712729440686
2017-03-02,35.0,35.07,34.689999,34.740002,32.42952,104844000,5443307043.367404,3384324800,67.98358856697541,100.0,0.9991379827943447,83.03101282653824,83.96120727154651,32.96221123076923,33.083363348749344,-16.038792728453494
2017-03-03,34.695,34.9575,34.647499,34.945,32.620895,84432400,5520930400.815927,3468757200,68.44502836270954,84.0,0.99393107443003,84.26810352907508,93.35989375830013,33.13432665384616,33.221262359953094,-6.640106241699867
2017-03-06,34.842499,34.942501,34.650002,34.834999,32.518192,87000000,5543980274.49071,3381757200,68.87350817303408,84.0,0.9697497294217428,80.86151870040098,86.62867709815096,33.30163426923077,33.34079840736398,-13.37132290184904
2017-03-07,34.764999,34.994999,34.697498,34.880001,32.560204,69785200,5559815010.9319315,3451542400,69.31179672731554,84.0,0.9433428553620118,81.19641966855164,86.57251832330863,33.47057665384615,33.4548134142259,-13.427481676691377
2017-03-08,34.737499,34.950001,34.705002,34.75,32.438862,74828800,5512473232.041405,3376713600,69.71877895629117,84.0,0.9015329129464149,77.00439339436426,76.47060553631938,33.63759592307693,33.55075316132028,-23.529394463680617
2017-03-09,34.685001,34.697498,34.262501,34.669998,32.364178,88623600,5589891472.004437,3288090000,67.87257967146999,80.0,0.8521200302795364,74.4567988426513,69.11176696797982,33.80423046153846,33.63366018640767,-30.888233032020185
2017-03-10,34.8125,34.84,34.66,34.785,32.471519,78451200,5620400272.004434,3366541200,66.39125519634067,76.0,0.8128694124604223,75.70127757668803,77.1999999999997,33.9041343076923,33.71894461704414,-22.800000000000296
2017-03-13,34.712502,34.857498,34.705002,34.799999,32.485531,69686800,5637535905.899093,3436228000,65.04453918276222,72.0,0.7740505362493124,75.86642636333382,78.39991999999995,34.006730423076924,33.799022719485315,-21.600080000000048
2017-03-14,34.825001,34.912498,34.709999,34.747501,32.43652,61236400,5598980975.662398,3374991600,63.88832556760102,68.0,0.7306279234201085,73.97137589273777,74.20007999999996,34.102018923076926,33.86928036989381,-25.799920000000043
2017-03-15,34.852501,35.1875,34.7575,35.115002,32.779575,102767200,5667095075.822397,3477758800,63.2506579390048,100.0,0.717597432759959,78.09608518737315,94.69850091407656,34.19980753846154,33.96155604619797,-5.301499085923442
2017-03-16,35.18,35.255001,35.064999,35.172501,32.833263,76928000,5677217884.298095,3554686800,62.7569217925246,96.0,0.7037974251742654,78.66573284101266,93.03798055866594,34.287884500000004,34.051255672405524,-6.96201944133407
2017-03-17,35.25,35.25,34.9725,34.997501,32.669888,175540000,5533307978.280081,3379146800,61.81623722946001,96.0,0.6710048559812023,72.48689879046455,76.15745156027486,34.36432692307692,34.121347918894,-23.84254843972513
2017-03-20,35.099998,35.375,35.057499,35.365002,33.012951,86168000,5614049175.441663,3465314800,61.15565800259083,100.0,0.666982212243262,76.63696769697941,99.10130256296831,34.451250076923074,34.21347044342037,-0.8986974370316794
2017-03-21,35.5275,35.700001,34.932499,34.959999,32.634892,158119600,5467260592.168656,3307195200,61.02350037112796,100.0,0.6239216997734403,65.00059796013724,48.52160000000021,34.52548084615385,34.26876885501886,-51.47839999999979
2017-03-22,34.962502,35.400002,34.939999,35.355,33.00362,103440800,5550462207.286817,3410636000,60.900782570483855,96.0,0.6145846635104917,69.81454744987957,75.99993043478237,34.603654,34.34923042131376,-24.000069565217633
2017-03-23,35.314999,35.395,35.1525,35.23,32.886932,81385200,5521096413.47238,3329250800,60.78683032702862,92.0,0.590293997908347,66.68854957933162,67.30427826086932,34.66038473076923,34.41447261232756,-32.695721739130676
2017-03-24,35.375,35.435001,35.087502,35.16,32.821583,89582400,5468892796.347724,3239668400,60.29112290652914,88.0,0.5589518069333508,64.93509334623404,62.434713043478,34.70971169230769,34.46969686326626,-37.565286956522
2017-03-27,34.8475,35.305,34.654999,35.220001,32.877609,94300400,5538530342.907192,3333968800,57.66450462251142,84.0,0.5328125427001424,65.76598916578077,66.60869565217413,34.76288473076923,34.52527494746876,-33.39130434782587
2017-03-28,35.227501,36.009998,35.154999,35.950001,33.559048,133499200,5653293728.005888,3467468000,56.629966394651795,88.0,0.5644947426006155,73.87658687018069,96.56668938487432,34.840577076923076,34.630810210619224,-3.433310615125671
2017-03-29,35.919998,36.122501,35.797501,36.029999,33.633724,116760000,5703588906.344348,3584228000,55.84104846200321,92.0,0.5892655973078149,74.58712888516442,93.6966355071405,34.911923230769226,34.73445382464743,-6.303364492859498
2017-03-30,36.047501,36.125,35.875,35.982498,33.58939,84829200,5691711461.0771475,3499398800,55.11241191528783,96.0,0.5981684310834581,73.31203135566005,90.30599298912041,34.97750007692308,34.82690154134021,-9.694007010879586
2017-03-31,35.93,36.067501,35.752499,35.915001,33.526371,78646800,5694208668.376147,3420752000,53.90866281346108,96.0,0.5929424754252466,71.443046085469,85.7143634596165,35.04605780769231,34.90750150124094,-14.285636540383502
2017-04-03,35.927502,36.029999,35.762501,35.924999,33.535706,79942800,5711392165.502855,3500694800,52.79089579033623,92.0,0.5828884477679566,71.55870877320658,86.3944990513612,35.11375003846154,34.9828716863342,-13.6055009486388
2017-04-04,35.8125,36.2225,35.7925,36.192501,33.785427,79565600,5779855958.831228,3580260400,52.12581283934747,100.0,0.5897079480618928,74.53100317226807,98.08618941869915,35.18913476923076,35.07247385771685,-1.9138105813008448
2017-04-05,36.055,36.365002,35.952499,36.005001,33.61039,110871600,5697207090.5117235,3469388800,51.763158878439995,76.0,0.5733732779439009,69.08142690091331,78.94734687599981,35.25673092307692,35.14154994233042,-21.05265312400018
2017-04-06,36.072498,36.130001,35.862499,35.915001,33.526371,84596000,5645818013.764632,3384792800,50.99388524757917,76.0,0.5468618038862871,66.56548398466822,73.68419821485692,35.29394257692308,35.19884261326891,-26.31580178514308
2017-04-07,35.932499,36.044998,35.817501,35.834999,33.451687,66688800,5589387991.879511,3318104000,50.0611064985525,76.0,0.5134767367028417,64.32290298412785,69.005726890538,35.33605784615384,35.24596530858232,-30.994273109461997
2017-04-10,35.900002,35.970001,35.724998,35.7925,33.412022,75733600,5555385876.53235,3242370400,48.743502926855186,76.0,0.478078524673613,63.10661482416565,66.52040961331647,35.368654,35.286449359798446,-33.479590386683526
2017-04-11,35.735001,35.837502,35.014999,35.407501,33.052631,121517600,5549845728.371918,3120852800,45.58614809902317,76.0,0.4141845235148338,53.278152584204186,44.005887708969325,35.39067330769231,35.295416147961525,-55.994112291030675
2017-04-12,35.400002,35.537498,35.252499,35.450001,33.092297,81400000,5581264810.544136,3202252800,42.65431861603629,76.0,0.3627953827378434,54.12748414116316,46.49126346561986,35.412596384615384,35.30686687774215,-53.50873653438014
2017-04-13,35.477501,35.595001,35.262501,35.262501,32.917267,71291600,5509973210.544136,3130961200,39.744077103081146,76.0,0.30344155013207796,49.824249340048766,35.52637042157257,35.432307961538456,35.30358051642792,-64.47362957842743
2017-04-17,35.369999,35.470001,35.217499,35.4575,33.099304,66328400,5569733968.8747635,3197289600,37.18715956396313,28.0,0.2690367120491288,53.926690899173806,32.77777901234309,35.462596500000004,35.31498195965548,-67.22222098765691
2017-04-18,35.352501,35.509998,35.2775,35.299999,32.952271,58790000,5522322270.709616,3138499600,34.668221730732945,28.0,0.22645122680409457,50.34613640850223,21.11106419763496,35.482404153846154,35.31387211079211,-78.88893580236504
2017-04-19,35.470001,35.5,35.112499,35.169998,32.830925,69313600,5473578747.619869,3069186000,32.887280174614524,28.0,0.18013543948329414,47.54033569801775,11.481381893225219,35.49663488461538,35.30321476925196,-88.51861810677478
2017-04-20,35.305,35.73,35.290001,35.610001,33.241665,93278400,5515978328.70619,3162464400,30.680036964819436,28.0,0.1768952706196103,56.39751678818866,44.07412427972356,35.52980796153846,35.32593967523329,-55.92587572027644
2017-04-21,35.610001,35.669998,35.462502,35.567501,33.201984,69283600,5516813754.773198,3093180800,28.63045398429543,28.000000000000004,0.16895046287034177,55.42412684962341,40.92598312744486,35.54721176923077,35.343833106697495,-59.07401687255514
2017-04-24,35.875,35.987499,35.794998,35.91,33.521702,68537200,5530166156.119682,3161718000,27.749633862671402,28.0,0.18812239454405244,61.23128133189228,66.2962230454301,35.57557711538461,35.38577139509027,-33.70377695456991
2017-04-25,35.977501,36.224998,35.967499,36.1325,33.729412,75486000,5551420457.9150305,3237204000,27.561015441373115,28.0,0.21874858153007892,64.46959606827926,82.7776679014789,35.61923092307693,35.44108462508358,-17.222332098521093
2017-04-26,36.1175,36.150002,35.845001,35.919998,33.531048,80164800,5510679263.120257,3157039200,26.89226304986914,28.0,0.22329886955011347,59.3690638042398,74.79336759782441,35.64057692307692,35.47655968989221,-25.206632402175593
2017-04-27,35.98,36.040001,35.827499,35.947498,33.556721,56985200,5518052676.354959,3214024400,26.200129094405103,28.0,0.2265129257532834,59.812171654149935,77.06609674884052,35.67855765384615,35.511444009159455,-22.933903251159478
2017-04-28,36.022499,36.075001,35.817501,35.912498,33.52404,83441600,5496177691.307968,3130582800,25.662855465464784,28.0,0.2236576942799431,58.93128793911625,74.17353237482007,35.69999988461538,35.54115171218468,-25.826467625179934
2017-05-01,36.275002,36.799999,36.240002,36.645,34.207825,134411600,5556182951.315434,3264994400,26.81659445681504,96.0,0.27730509190875097,69.1661539895033,91.3165826330534,35.75442296153846,35.62291825202285,-8.683417366946601
2017-05-02,36.884998,37.022499,36.709999,36.877499,34.424858,181408800,5569244384.915431,3446403200,28.245137172999115,100.0,0.33472328558477926,71.58657865122524,92.40837696335063,35.82048061538462,35.71585015928042,-7.591623036649364
2017-05-03,36.397499,36.872501,36.067501,36.764999,34.319836,182788000,5703212321.372576,3263615200,27.35984567817515,56.0,0.3669201805094815,68.77338027822199,86.51832460732986,35.87990361538461,35.79356488822261,-13.481675392670146
2017-05-04,36.630001,36.785,36.452499,36.6325,34.196156,93487600,5710944636.4260645,3170127600,26.537789290124326,56.0,0.37739452062986345,65.50818557656939,79.58120418848155,35.90615357692308,35.855708229835756,-20.418795811518446
2017-05-05,36.689999,37.244999,36.689999,37.240002,34.763248,109310800,5818287054.200478,3279438400,26.670206297252985,68.0,0.429761818209883,72.05845206531885,99.76567409144182,35.95269215384615,35.95824850910718,-0.2343259085581724
2017-05-08,37.2575,38.424999,37.2575,38.252499,35.708408,195009600,5955670641.672844,3474448000,28.28483409942329,72.0,0.5466617485849952,79.16144332314393,94.7924528301887,36.03999988461538,36.128192989914055,-5.207547169811304
2017-05-09,38.467499,38.720001,38.362499,38.497501,35.937115,156521600,5917362249.11336,3630969600,30.047904983201224,76.0,0.6515645686955835,80.45612237397799,93.51311953352761,36.139326807692306,36.30369728695746,-6.486880466472398
2017-05-10,38.407501,38.485001,38.0275,38.314999,35.766754,103222800,5943872288.067593,3527746800,30.791793435754027,76.0,0.7117695865178888,76.63656366168235,87.56708751100145,36.23124988461539,36.45268259903469,-12.432912488998548
2017-05-11,38.112499,38.517502,38.077499,38.487499,36.076073,109020400,6038024884.615343,3636767200,31.51856405137608,76.0,0.7645881094667786,77.7135285878955,92.05122182780654,36.319519038461536,36.60340973984694,-7.948778172193446
2017-05-12,38.674999,39.105,38.6675,39.025002,36.579903,130108000,6120551719.888488,3766875200,32.79022637853227,88.0,0.8401346205012032,80.69904887873244,97.56660002025868,36.43567292307693,36.782786944302714,-2.433399979741327
2017-05-15,39.002499,39.162498,38.762501,38.924999,36.486164,104038800,6101044038.483877,3662836400,34.02426098593961,92.0,0.8817718514198916,78.58963969869936,92.89987405070916,36.551442076923074,36.94146931879881,-7.100125949290828
2017-05-16,38.985001,39.014999,38.68,38.8675,36.432266,80194000,6110619709.438118,3582642400,34.932106792515405,92.0,0.8997581166533877,77.3378923101226,91.18091884686295,36.66807673076923,37.08413825814705,-8.819081153137049
2017-05-17,38.400002,38.642502,37.427502,37.5625,35.209038,203070800,5952675085.3367195,3379571600,32.98330776193014,92.0,0.7994937020454103,55.66673699122427,52.167430942389494,36.73615365384615,37.119572461247266,-47.832569057610506
2017-05-18,37.817501,38.334999,37.782501,38.134998,35.745663,134272800,5989735970.459924,3513844400,31.17370866210097,72.0,0.7574972780414839,60.84964586430375,66.8012602273929,36.84105738461538,37.19478916782155,-33.1987397726071
2017-05-19,38.345001,38.494999,38.157501,38.264999,35.867512,107843200,5950592012.017504,3621687600,29.743803453530692,72.0,0.7263320993712767,61.93781156642394,71.00161971077851,36.94932653846154,37.274063970205134,-28.99838028922149
2017-05-22,38.5,38.645,38.227501,38.497501,36.085453,91865600,5977546873.862921,3713553200,28.650301971857335,72.0,0.7121848158049175,63.87186963466424,78.51380792937765,37.073749615384614,37.36468893537512,-21.486192070622355
2017-05-23,38.724998,38.724998,38.327499,38.450001,36.04092,79675600,5946980430.621553,3633877600,27.761799883844112,72.0,0.6891955216625618,63.16570059729297,73.70858808434984,37.18884580769231,37.445082421643626,-26.291411915650155
2017-05-24,38.459999,38.5425,38.1675,38.334999,35.933136,76712000,5938797408.157557,3557165600,26.58145076018885,72.0,0.6541559376859283,61.395858241548225,66.5318772626401,37.30557657692307,37.51100216818854,-33.468122737359906
2017-05-25,38.432499,38.587502,38.2575,38.467499,36.057335,76942400,5959780639.260397,3634108000,25.566564051685088,68.0,0.6298183042263261,62.69285950175586,63.51707455860829,37.43240353846154,37.58185378535976,-36.48292544139171
2017-05-26,38.5,38.560001,38.327499,38.4025,35.996403,87710400,5928657861.821924,3546397600,24.624169250931594,64.0,0.5983878357981354,61.599509449052405,56.195979702547156,37.53980734615384,37.64264239385163,-43.804020297452844
2017-05-30,38.355,38.607498,38.3325,38.4175,36.010464,80507600,5897918958.321532,3626905200,23.845639088026967,60.0,0.5681401715219394,61.765227162667586,57.060535009878905,37.649422692307695,37.700039253566324,-42.939464990121095
2017-05-31,38.4925,38.5425,38.095001,38.189999,35.797218,97804800,5841639437.217797,3529100400,22.49970408350551,44.00000000000001,0.5198190992654048,57.69825173109131,43.9480552116548,37.73711496153847,37.73633256811697,-56.0519447883452
2017-06-01,38.2925,38.3325,38.055,38.294998,35.895645,65616400,5889520729.233652,3594716800,21.147002266748423,44.0,0.4844128335457256,59.03881272449999,49.999884725959106,37.82028796153846,37.7777151927009,-50.000115274040894
2017-06-02,38.395,38.862499,38.2225,38.862499,36.427582,111082800,6000603529.233652,3705799600,21.01870486557313,44.0,0.4964232426423223,65.4177416655852,82.70895149037811,37.93346107692308,37.85806954879713,-17.29104850962188
2017-06-05,38.584999,38.612499,38.365002,38.482498,36.071392,101326800,5995483905.020026,3604472800,20.899571564481786,44.0,0.4698623923032841,58.8130612921365,66.45656653209414,38.03096107692308,37.90432350814549,-33.54343346790586
2017-06-06,38.474998,38.952499,38.445,38.612499,36.193241,106499600,5959284252.410661,3710972400,21.41445318644919,32.0,0.4540685022393305,60.2901321720852,77.70487417352282,38.13480726923077,37.95678095198656,-22.295125826477168
2017-06-07,38.755001,38.994999,38.619999,38.842499,36.408829,84278400,5975016220.410659,3795250800,21.966535946608097,32.0,0.45486738036882457,62.82994029498272,87.42265966624242,38.219326461538465,38.02238969628385,-12.577340333757569
2017-06-08,38.8125,38.884998,38.599998,38.747501,36.31979,85003200,5978000578.372764,3710247600,22.41232138135165,32.0,0.44273142015268263,61.091909467383054,73.67039752169947,38.291249615384615,38.07610164470727,-26.329602478300526
2017-06-09,38.797501,38.797501,36.505001,37.244999,34.91143,259530800,5886018108.090015,3450716800,22.916042255053306,28.000000000000004,0.3083201075029649,41.52611734208547,29.71881905126028,38.30971115384615,38.01453848584007,-70.28118094873972
2017-06-12,36.435001,36.522499,35.627499,36.355,34.07719,289229200,6066988980.11057,3161487600,24.23364440167771,-76.0,0.128501408332923,34.481478161561185,21.603593170007326,38.299038076923075,37.89160970911118,-78.39640682999267
2017-06-13,36.790001,36.862499,36.287498,36.647499,34.35136,136661600,6101451648.282627,3298149200,24.793160999530738,-76.0,0.009486662164576387,38.19253744213936,30.28953229398673,38.2762495,37.799453360288126,-69.71046770601326
2017-06-14,36.875,36.875,35.959999,36.290001,34.016258,126124800,6066302565.794628,3172024400,25.622564658265496,-76.0,-0.11238497841934247,35.54270625259464,19.673407572382967,38.200768807692306,37.68764207434086,-80.32659242761703
2017-06-15,35.830002,36.119999,35.552502,36.072498,33.812393,128661600,6173425533.302828,3043362800,26.75077270851633,-88.0,-0.22393838368116548,33.997239496367754,15.105198348756895,38.10749946153847,37.56800177253783,-84.8948016512431
2017-06-16,35.945,36.125,35.549999,35.567501,33.339024,201444400,5984244346.371327,2841918400,27.787882491952505,-92.0,-0.3490704318642841,30.66344828367211,0.5080406386066865,38.001826461538464,37.41981653012762,-99.49195936139331
2017-06-19,35.915001,36.685001,35.915001,36.584999,34.292774,130165600,6080600023.433147,2972084000,27.625776171596584,-92.0,-0.3619624191090196,42.828264870813584,30.043541364296185,37.92865338461539,37.35797819456261,-69.95645863570381
2017-06-20,36.717499,36.717499,36.235001,36.252499,33.981117,99600400,5988223727.156688,2872483600,27.4132050613072,-92.0,-0.3944622675872722,40.337703411498815,20.391872278664746,37.82201865384615,37.27609084681723,-79.60812772133526
2017-06-21,36.380001,36.517502,36.1525,36.467499,34.18264,85063200,6049980670.261655,2957546800,27.315753857602125,-88.0,-0.3982788181888992,42.659682839821336,26.632801161102954,37.72749942307692,37.2161951544604,-73.36719883889704
2017-06-22,36.442501,36.674999,36.279999,36.407501,34.126392,76425200,6022894031.529505,2881121600,26.89420452709181,-27.999999999999993,-0.4015163684529739,42.16649888271948,24.891204644412298,37.63288407692308,37.15629188375963,-75.1087953555877
2017-06-23,36.282501,36.790001,36.2775,36.57,34.278713,141757600,6042947229.947459,3022879200,26.259055564905996,-28.0,-0.3865143423811972,44.053040584448986,29.60815674891148,37.594711000000004,37.112862855332985,-70.39184325108852
2017-06-26,36.7925,37.07,36.345001,36.455002,34.170929,102769600,5971363214.395437,2920109600,25.090839747426845,-28.0,-0.37952952603002643,42.98442302810329,26.270043541364313,37.53009576923077,37.06413242160462,-73.72995645863568
2017-06-27,36.252499,36.540001,35.904999,35.932499,33.681156,99047600,5880894513.359536,2821062000,24.675697578825805,-28.0,-0.4114131197602475,38.423746142882216,11.46926880637745,37.440384230769226,36.98030772370798,-88.53073119362254
2017-06-28,36.122501,36.5275,35.790001,36.4575,34.173264,88329600,5952456437.742349,2909391600,24.454267563486262,-28.0,-0.3898242530843774,44.765176129715066,27.944586331278757,37.36192265384615,36.94158122565553,-72.05541366872124
2017-06-29,36.177502,36.282501,35.57,35.919998,33.669437,125997600,5950245072.441808,2783394000,24.5588541448527,-28.0,-0.4113451096422125,40.20049942589562,24.34202345919508,37.26461484615384,36.8659083941255,-75.65797654080492
2017-06-30,36.112499,36.240002,35.945,36.005001,33.749123,92096400,5895611985.208501,2875490400,24.65597025612153,-28.0,-0.4167376199408892,41.221271466278125,29.934322411630003,37.174999538461535,36.802137476042134,-70.06567758837
2017-07-03,36.220001,36.325001,35.775002,35.875,33.627262,57111200,5859268116.704013,2818379200,24.996330978254715,-28.000000000000004,-0.4265838246485032,40.094052502144734,21.381630669979835,37.07528803846154,36.73346062596494,-78.61836933002016
2017-07-05,35.922501,36.197498,35.68,36.022499,33.765522,86278400,5887194083.567654,2904657600,25.451859368932475,-28.0,-0.4176704314747113,42.03096516786353,31.085505864799003,36.98374953846154,36.68079680181938,-68.914494135201
2017-07-06,35.755001,35.875,35.602501,35.682499,33.446831,96515200,5847347150.017074,2808142400,25.99116689019004,-28.0,-0.4330497339000914,38.9080906025703,8.71709952822401,36.878557192307696,36.60684881649943,-91.28290047177599
2017-07-07,35.724998,36.1875,35.724998,36.044998,33.786613,76806800,5876823894.73688,2884949200,25.604475371648697,-28.0,-0.4112467060692637,43.71015326547007,31.66653333333329,36.79605715384615,36.56523023749947,-68.33346666666671
2017-07-10,36.0275,36.487499,35.842499,36.264999,33.992821,84362400,5902982778.457811,2969311600,24.486863157704903,-28.0,-0.37192805228648496,46.46070186496424,46.33326666666685,36.71798026923077,36.542990886573584,-53.66673333333315
2017-07-11,36.182499,36.462502,36.095001,36.3825,34.102966,79127200,5947659273.537825,3048438800,23.449080387614234,-28.0,-0.32751104374116125,47.92431349515935,54.166666666666664,36.62259569230769,36.53110267275332,-45.833333333333336
2017-07-12,36.467499,36.544998,36.205002,36.435001,34.152168,99538000,5982791331.197327,3147976800,22.270843757183474,-28.0,-0.2847909596245515,48.60043280056314,57.6667333333333,36.54384580769231,36.52398403032715,-42.3332666666667
2017-07-13,36.375,37.122501,36.360001,36.942501,34.627888,100797600,6035999244.63995,3248774400,21.48813453229041,-28.000000000000004,-0.207590996745445,54.72033761092074,88.40580456953008,36.47961511538462,36.55498528733995,-11.594195430469918
2017-07-14,36.9925,37.3325,36.8325,37.259998,34.925484,80528400,6093173764.41275,3329302800,21.158457977352818,-24.0,-0.119413589968417,58.082859471419845,95.88641134751774,36.41874969230769,36.607208451240695,-4.1135886524822665
2017-07-17,37.205002,37.724998,37.142502,37.389999,35.04734,95174000,6078876815.853448,3424476800,21.517613080423672,-20.0,-0.03859743833435658,59.41194202978652,84.45478835711234,36.36653807692308,36.66519293633397,-15.545211642887669
2017-07-18,37.299999,37.532501,37.1675,37.52,35.169197,71475200,6145456075.978214,3495952000,21.851114247560893,80.0,0.03553036637420348,60.75211618585061,90.48732295807253,36.37711503846154,36.72851197808701,-9.512677041927478
2017-07-19,37.619999,37.855,37.487499,37.755001,35.389473,83692000,6183601988.713147,3579644000,22.669422230398506,88.0,0.1119493203039923,63.12256906040242,95.62367614879663,36.430961230769235,36.80454820193242,-4.376323851203369
2017-07-20,37.875,37.935001,37.547501,37.584999,35.230129,68974800,6127976438.005536,3510669200,23.548965806106985,92.0,0.15698453127116352,60.28595513655902,84.99455519828528,36.46701892307693,36.862359372159645,-15.005444801714722
2017-07-21,37.497501,37.610001,37.220001,37.567501,35.213718,105010400,6210099955.954255,3405658800,23.404239107761093,92.0,0.1890836791084496,59.98714671437219,84.24437299035372,36.516153538461545,36.914592085333005,-15.755627009646268
2017-07-24,37.645,38.110001,37.474998,38.022499,35.640213,85972800,6272379034.993568,3491631600,24.05943234215428,100.0,0.24837392109939316,64.86395143628548,96.51038883349976,36.591153576923084,36.99665926419723,-3.4896111665002403
2017-07-25,37.950001,38.459999,37.950001,38.185001,35.79253,75415600,6266464358.526601,3567047200,25.130116457834596,68.0,0.304959040367514,66.43730585972344,90.3762662301075,36.69182665384615,37.084684577960395,-9.623733769892507
2017-07-26,38.337502,38.482498,38.264999,38.365002,35.961239,63124000,6261387424.232647,3630171200,26.153063553218576,72.0,0.36017584845087924,68.13919505591939,95.7390389845874,36.760288307692306,37.17952290551889,-4.260961015412609
2017-07-27,38.4375,38.497501,36.825001,37.639999,35.281681,129905200,6258086084.54906,3500266000,24.581986024894775,76.0,0.3414973152005274,55.85408672789553,67.70239721100039,36.81365369230769,37.21363224585082,-32.29760278899962
2017-07-28,37.4725,37.557499,37.297501,37.375,35.033287,68854800,6230279124.4955225,3431411200,23.123128320022676,76.0,0.3018319080647629,52.15283178021656,53.27779396462012,36.84855757692308,37.225585412824834,-46.72220603537988
2017-07-31,37.474998,37.5825,37.032501,37.182499,34.852833,79383600,6194195171.341425,3352027600,22.19680430048371,76.0,0.2519591371399983,49.582462195658344,42.638928086773426,36.87836519230769,37.22239382668966,-57.361071913226574
2017-08-01,37.275002,37.555,37.102501,37.512501,35.16217,141474400,6309094836.256486,3493502000,21.336646282340382,76.0,0.23633864553637807,53.78728259978043,53.91812865497085,36.914615230769236,37.24388324693487,-46.08187134502915
2017-08-02,39.82,39.9375,39.040001,39.285,36.823616,279747200,6182078244.876216,3773249200,22.193754104265746,92.0,0.3628029823650394,68.82603880715129,79.03613784293574,37.02346130769231,37.39507708049525,-20.96386215706426
2017-08-03,39.262501,39.302502,38.755001,38.892502,36.455704,108389200,6128131405.307339,3664860000,22.528677825663976,92.0,0.42643983905569627,63.869483578342994,66.42575628136748,37.13730757692308,37.50599744490301,-33.57424371863251
2017-08-04,39.017502,39.349998,38.922501,39.0975,36.647865,82239600,6113222559.723861,3747099600,22.884654152272777,92.0,0.4877911787528717,65.27602793354853,73.0120395219403,37.23884603846154,37.62388652305834,-26.987960478059705
2017-08-07,39.264999,39.73,39.1675,39.702499,37.214943,87481200,6192149731.346263,3834580800,23.57284739859691,76.0,0.5785616223474861,69.09931639789696,92.44976464249476,37.38432684615385,37.77785781764661,-7.550235357505237
2017-08-08,39.650002,40.4575,39.567501,40.02,37.512558,144823600,6194590418.556474,3979404400,24.812746218458212,92.0,0.6684124870173704,70.90954454395316,87.95594988463864,37.538749884615385,37.94394242374687,-12.044050115361344
2017-08-09,39.814999,40.317501,39.7775,40.264999,37.74221,104526000,6278791181.929135,4083930400,25.964080836900855,92.0,0.7507353070633798,72.25998611254434,94.7005904199836,37.707596,38.11587254050636,-5.299409580016399
2017-08-10,39.974998,40.0,38.657501,38.830002,36.540051,163217200,6157518341.242922,3920713200,25.20051761942089,92.0,0.6922051597254963,55.89342709891881,55.19618862937054,37.81557688461539,38.168771018987364,-44.80381137062946
2017-08-11,39.150002,39.642502,39.017502,39.369999,37.048195,105028400,6170960968.170281,4025741600,24.491494631760922,88.0,0.6815365125550557,59.601511890951976,70.06190504113002,37.95740380769231,38.25775086943275,-29.93809495886998
2017-08-14,39.830002,40.052502,39.6875,39.962502,37.605762,88490800,6215812708.65828,4114232400,24.26731791593114,84.0,0.7126762845718915,63.25209941317757,86.37307264227734,38.10807703846154,38.38402873095625,-13.626927357722662
2017-08-15,40.165001,40.549999,40.035,40.400002,38.017464,117862000,6265018472.7665615,4232094400,24.54069021426313,100.0,0.7638521596896837,65.71567262683737,95.97323273730619,38.26711561538461,38.53336008421875,-4.026767262693808
2017-08-16,40.485001,40.627499,40.037498,40.237499,37.864548,110686400,6229373947.903723,4121408000,24.86734810510236,100.0,0.7822791483467597,63.99943626890186,89.15159340839685,38.41538480769231,38.65959259649884,-10.848406591603137
2017-08-17,40.130001,40.177502,39.459999,39.465,37.137604,111762400,6119169517.033887,4009645600,24.228661740811365,96.0,0.7261775337806782,56.45185827552454,67.66343124530256,38.53192323076923,38.719252404165594,-32.33656875469744
2017-08-18,39.465,39.875,39.18,39.375,37.052906,109712400,6071022348.688563,3899933200,23.216332314222836,56.0,0.6667682627242897,55.62874428304889,64.46809331523028,38.625480884615385,38.767826300153324,-35.53190668476972
2017-08-21,39.375,39.4725,38.7775,39.302502,36.98468,105474000,6124898164.366261,3794459200,21.704910292425716,56.0,0.6068407225778358,54.9338954406687,32.7412007524878,38.70403873076923,38.80743190754938,-67.2587992475122
2017-08-22,39.557499,40.0,39.505001,39.945,37.589291,86418400,6192112436.681154,3880877600,20.952373002360332,56.0,0.6042267840291586,59.734091949557005,65.35534553842182,38.802308,38.891696210693866,-34.644654461578185
2017-08-23,39.767502,40.1175,39.720001,39.994999,37.636333,77596400,6221881613.989273,3958474000,20.392114531567334,56.0,0.5992815753767289,60.09034711408623,67.8933684196633,38.89750026923077,38.973422343235065,-32.106631580336696
2017-08-24,40.107498,40.185001,39.637501,39.817501,37.469307,79275600,6194732435.907082,3879198400,19.740668051292847,56.0,0.5744183198755195,58.1242811049933,58.88330851097303,38.976827192307695,39.035946688180616,-41.11669148902697
2017-08-25,39.912498,40.139999,39.817501,39.965,37.608116,101920400,6186041495.18807,3981118800,19.135753462466543,56.0,0.5601587855668768,59.315529545559706,66.37057499550771,39.068365692307694,39.10476545201909,-33.62942500449228
2017-08-28,40.035,40.5,39.982498,40.3675,37.986866,103864000,6236719304.603299,4084982800,19.055370458256096,56.0,0.5747114719567818,62.45431474857682,86.80206781935814,39.17605796153846,39.198301344462116,-13.197932180641857
2017-08-29,40.025002,40.779999,40.0,40.727501,38.325649,118067600,6338893774.317747,4203050400,19.330987477238562,92.0,0.6082817593339698,65.05139450000749,97.52659366463477,39.2800965,39.311575393020476,-2.4734063353652207
2017-08-30,40.950001,40.9725,40.6525,40.837502,38.429161,109078400,6355938637.797748,4312128800,19.82039716317033,96.0,0.6364262892239836,65.82917723131877,93.84974943052408,39.38211576923077,39.42460699353747,-6.150250569475917
2017-08-31,40.91,41.130001,40.869999,41.0,38.582081,107140400,6355938637.797748,4419269200,20.464753812113123,100.0,0.6641869290041953,66.99762605630653,94.4739237092779,39.483461846153844,39.54130277179396,-5.526076290722096
2017-09-01,41.200001,41.235001,40.907501,41.012501,38.593838,66364400,6332128509.5534725,4485633600,21.19120257177787,96.0,0.6793648669630059,67.09085532415526,90.94608710230445,39.613173461538466,39.65028041832774,-9.053912897695552
2017-09-05,40.9375,41.0625,40.139999,40.52,38.130379,117874000,6311364947.100966,4367759600,20.320838504786604,96.0,0.6442265349710397,59.91033544569927,70.90536280554939,39.734135,39.714704091044204,-29.09463719445061
2017-09-06,40.677502,40.747501,40.130001,40.477501,38.090385,86606800,6322234626.453193,4281152800,19.494600293382433,92.0,0.6059646562312295,59.32033487434772,69.17600440447421,39.86086584615384,39.77120756578167,-30.82399559552579
2017-09-07,40.522499,40.560001,40.09,40.314999,37.937477,87714000,6318501563.880985,4193438800,18.65058479401491,64.0,0.5561186981731865,57.00850937846771,62.563514724917745,39.968654230769225,39.81148841276081,-37.436485275082255
2017-09-08,40.215,40.287498,39.6325,39.657501,37.318745,114446000,6212792275.889267,4078992800,17.60481204911524,64.0,0.45827807920266395,48.73299550137534,35.80877484892183,39.98298119230769,39.80008193774149,-64.19122515107817
2017-09-11,40.125,40.512501,39.9725,40.375,37.993938,126323200,6274783867.898911,4205316000,16.46480868350179,64.0,0.4336361688502208,56.20432746107711,50.288959537572346,40.040000346153846,39.84266846087175,-49.711040462427654
2017-09-12,40.6525,40.990002,39.692501,40.215,37.843372,286856000,6218959633.028959,3918460000,16.182660109747367,64.0,0.3966245733450293,54.303801994462994,36.349431295206955,40.08298111538462,39.87024857488125,-63.650568704793045
2017-09-13,39.967499,39.990002,39.477501,39.912498,37.558708,179629600,6344259534.088276,3738830400,15.511885239044583,64.0,0.3389757327259204,50.805874371640265,24.750896159317364,40.091058000000004,39.873378161927086,-75.24910384068264
2017-09-14,39.747501,39.849998,39.522499,39.57,37.236404,95042800,6276787065.862112,3643787600,14.889022859106282,64.0,0.26262451306449464,47.10612397421118,5.263100995732782,40.07375030769231,39.850905705488046,-94.73689900426722
2017-09-15,39.6175,40.2425,39.5,39.970001,37.612812,196458400,6329044206.490801,3840246000,14.957924549189999,64.0,0.23172122115808946,51.544174224691346,28.022759601707353,40.06240423076924,39.859727579155596,-71.97724039829265
2017-09-18,40.0275,40.125,39.5,39.6675,37.328156,113077600,6276576200.090799,3727168400,15.021904689982023,36.0,0.18073740873958855,48.24724401587443,10.810753911806556,40.09461569230769,39.84548849921814,-89.18924608819344
2017-09-19,39.877499,39.942501,39.610001,39.682499,37.342274,83242400,6229633995.670951,3810410800,15.081314820717472,36.00000000000001,0.13992964221524318,48.42340228386616,11.664182076813844,40.106634923076925,39.83341520297976,-88.33581792318616
2017-09-20,39.474998,39.564999,38.4575,39.017502,36.716496,211805600,6232025536.456089,3598605200,15.046691965056723,-48.0,0.053314911836167767,41.653758612209046,20.16208094974578,40.07028876923077,39.77297718794422,-79.83791905025423
2017-09-21,38.950001,38.950001,38.1875,38.3475,36.086002,150046800,6144949114.199855,3448558400,15.393901936712508,-52.0,-0.06860066224243866,36.16756778200958,5.250203363345795,39.99134638461539,39.66738628513354,-94.74979663665421
2017-09-22,37.884998,38.067501,37.639999,37.9725,35.73312,186581600,6248605073.704134,3261976800,16.400333042450786,-56.0,-0.1932513181474178,33.50746658188616,9.715146905727531,39.90423103846154,39.541839152901424,-90.28485309427246
2017-09-25,37.497501,37.9575,37.290001,37.637501,35.417881,177549200,6255920111.702992,3084427600,17.717947020405795,-60.0,-0.31543336117101006,31.293219753563164,9.391889353543517,39.83394261538461,39.40077706750132,-90.60811064645648
2017-09-26,37.945,38.48,37.922501,38.285,36.02718,146640000,6299977685.546174,3231067600,17.892049169498012,-60.0,-0.3559130089966587,39.60115909888796,26.89185759679524,39.79201953846154,39.31812691435308,-73.10814240320477
2017-09-27,38.450001,38.68,38.384998,38.557499,36.28363,102016800,6317268551.370811,3333084400,17.68483064512201,-60.0,-0.3618340321193543,42.73922072767189,34.25669344413699,39.76336557692308,39.261784105882484,-65.743306555863
2017-09-28,38.4725,38.57,38.174999,38.32,36.060127,88022000,6293870580.282131,3245062400,17.77384581897264,-60.0,-0.3812953347696819,40.75192478384467,27.837803287080288,39.70086557692308,39.19202232026156,-72.16219671291971
2017-09-29,38.302502,38.532501,38.0,38.529999,36.257744,105199200,6398081205.994381,3350261600,18.087745373526957,-60.0,-0.37544549115076364,43.26401188988907,33.51345040177016,39.64451942307692,39.142983555797734,-66.48654959822984
2017-10-02,38.564999,38.612499,38.18,38.452499,36.184803,74795200,6417536476.88472,3275466400,18.210977266447653,-60.0,-0.37276603542481723,42.54704514593188,39.373357958800504,39.59201934615385,39.091836551664564,-60.626642041199496
2017-10-03,38.502499,38.772499,38.477501,38.619999,36.34243,64921200,6415335303.173712,3340387600,17.984178657119422,-60.0,-0.35305687740108027,44.680806544655375,45.0465182206667,39.54028853846153,39.05688562191163,-54.9534817793333
2017-10-04,38.407501,38.465,38.115002,38.369999,36.107174,80655200,6452205540.658497,3259732400,18.31163853109186,-60.0,-0.3535348091214985,42.16380675468717,36.57911484474685,39.46346157692308,39.00600513139966,-63.42088515525315
2017-10-05,38.544998,38.860001,38.512501,38.8475,36.556511,85135200,6531215416.13936,3344867600,17.790688620587943,-60.0,-0.31178912247371926,48.16954198596904,54.93825571014304,39.39115384615384,38.99426401055524,-45.06174428985696
2017-10-06,38.7425,38.872501,38.639999,38.825001,36.535347,69630400,6572394929.695373,3275237200,17.281564030017535,-60.0,-0.27732402755054864,47.9170600800989,57.86993402450525,39.313749961538456,38.981726009773375,-42.13006597549475
2017-10-09,38.952499,39.182499,38.872501,38.959999,36.66238,65051600,6544065404.655858,3340288800,16.186223928824216,-60.0,-0.23639200129962745,49.623285413061076,73.40657002775406,39.23528838461538,38.98011660164202,-26.59342997224595
2017-10-10,39.014999,39.5,38.775002,38.974998,36.676491,62468000,6516061913.876573,3402756800,15.473056114597386,-56.00000000000001,-0.20043232259818922,49.81997953571126,76.24424264445369,39.15692288461538,38.97973744596483,-23.755757355546308
2017-10-11,38.9925,39.244999,38.9375,39.137501,36.829414,67622400,6536404337.322503,3470379200,14.810828858529614,-36.0,-0.15701145384237947,52.00637567250003,83.59732289471629,39.103749846153846,38.991423635152614,-16.40267710528372
2017-10-12,39.087502,39.342499,38.932499,39.0,36.700024,64500400,6493142188.543966,3405878800,14.381349831031859,-36.0,-0.13217169109817206,50.02039819504014,77.3755553735545,39.046922884615384,38.992058921437604,-22.6244446264455
2017-10-13,39.182499,39.32,39.102501,39.247501,36.932922,65576800,6515001523.88252,3471455600,13.982547876926802,-36.0,-0.0914604389071556,53.465104927328255,83.99371410061117,39.00586526923077,39.01098055688667,-16.00628589938883
2017-10-16,39.474998,40.0,39.412498,39.970001,37.612812,96486000,6601633996.52772,3567941600,14.803914596669534,-36.0,-0.0008865468611176652,61.75234393568849,98.50005000000017,39.0178845,39.0820191082284,-1.4999499999998278
2017-10-17,39.945,40.217499,39.807499,40.1175,37.751617,75989200,6640555664.767721,3643930800,15.882123715371138,-36.0,0.08185230926454068,63.19343786235549,95.49046019862931,39.007980653846154,39.15872139650778,-4.509539801370688
2017-10-18,40.105,40.177502,39.900002,39.939999,37.584591,65496800,6593939408.981054,3578434000,16.883317897022632,-24.0,0.13158378561068673,60.251382178981636,87.48590191021522,38.99740369230769,39.216593811581276,-12.514098089784786
2017-10-19,39.1875,39.27,38.755001,38.994999,36.69532,170336800,6582362106.86901,3408097200,16.00736320797846,-24.000000000000004,0.09366304729942954,47.55705825851387,41.8548516359359,38.96211526923077,39.200179381093776,-58.1451483640641
2017-10-20,39.1525,39.4375,38.990002,39.0625,36.758831,95896400,6517537565.099439,3503993600,14.893701633084435,-24.0,0.06827037714332107,48.39345139124134,45.06536751300968,38.94259603846154,39.18998090842016,-54.93463248699032
2017-10-23,39.2225,39.422501,38.875,39.0425,36.740013,87937200,6483406590.110899,3416056400,14.064823565432187,64.0,0.046002383406843705,48.14842662388549,44.1141176420228,38.90692292307693,39.17905639668533,-55.8858823579772
2017-10-24,39.072498,39.355,39.049999,39.275002,36.958809,71028800,6517175433.963871,3487085200,13.295151074040815,64.0,0.04657887397334548,51.23925641334026,44.72151873491946,38.89182684615385,39.18616347841234,-55.27848126508054
2017-10-25,39.227501,39.387501,38.817501,39.102501,36.796482,84828400,6517175433.96387,3402256800,13.018171517451458,64.0,0.03273896346021843,48.90977923467684,29.31866877971445,38.86951923076923,39.179966257789204,-70.68133122028556
2017-10-26,39.307499,39.4575,39.195,39.352501,37.031746,68002000,6530776352.074344,3470258800,12.603639373087372,64.0,0.04146565507004851,52.29474978468137,40.8547567244535,38.882403807692306,39.19274660906407,-59.1452432755465
2017-10-27,39.822498,40.900002,39.674999,40.762501,38.358578,177816800,6668674902.377322,3648075600,13.552921332127578,96.0,0.16030889601712062,65.98365126506822,93.58969995818182,38.97528846153846,39.30902471209637,-6.410300041818175
2017-10-30,40.9725,42.017502,40.93,41.68,39.221977,178803200,6736496352.263023,3826878800,15.51875580342524,100.0,0.32478361874184003,71.67858350280271,89.6551142819573,39.11788461538462,39.48465251120034,-10.34488571804271
2017-10-31,41.974998,42.412498,41.735001,42.259998,39.767761,144187200,6815772422.029238,3971066000,17.648639874779686,100.0,0.49621198989378,74.57623595632529,95.83048188419576,39.295672961538465,39.690233658518835,-4.169518115804233
2017-11-01,42.467499,42.485001,41.4025,41.7225,39.261967,134551200,6760771049.696833,3836514800,18.987517760301518,92.0,0.5819897964670275,67.66680855918361,79.55761394101874,39.4278845,39.840771906035954,-20.44238605898126
2017-11-02,41.650002,42.125,41.32,42.0275,39.548988,165573600,6886236759.013604,4002088400,20.073148876860234,92.0,0.6668927526544195,69.39933598668155,87.73455764075084,39.56134607692308,40.00275176484811,-12.265442359249166
2017-11-03,43.5,43.564999,42.779999,43.125,40.581757,237594400,6857483901.929274,4239682800,22.17745129666139,100.0,0.8133621029134375,74.66087236015846,90.85240783883901,39.74615376923077,40.234029411896394,-9.147592161160986
2017-11-06,43.092499,43.747501,42.93,43.5625,40.993465,140105200,6934177308.903455,4379788000,24.24263689886092,92.0,0.9537484929692113,76.40268907331324,96.29442163244869,39.9397115,40.48058278879296,-3.7055783675513223
2017-11-07,43.477501,43.8125,43.400002,43.702499,41.125195,97446000,6979651384.452913,4477234000,26.20115778236116,96.0,1.0640369126086924,76.94874475890845,97.82499215521354,40.141634576923074,40.71924324888237,-2.175007844786463
2017-11-08,43.665001,44.060001,43.5825,44.060001,41.461617,97638000,7077289384.452913,4574872000,28.177757810852192,100.0,1.1668381198748534,78.3279014502322,100.0,40.350865423076925,40.9667067860022,-0.0
2017-11-09,43.7775,44.025002,43.285,43.970001,41.376923,117930400,7177689318.507147,4456941600,29.398611575183278,96.0,1.2269035885890887,77.0776532678761,98.28326180257518,40.56625011538461,41.18917302407611,-1.7167381974248224
2017-11-10,43.7775,43.845001,43.567501,43.6675,41.239979,100582000,7149598125.12336,4356359600,30.532261499205,92.0,1.2358504875693086,72.86764028578959,92.51309489747253,40.751634730769226,41.37275280007047,-7.4869051025274755
2017-11-13,43.375,43.625,43.349998,43.4925,41.074707,67928400,7152068724.816453,4288431200,31.11525174985901,56.0,1.2148162860572995,70.4696202889582,89.17499284692417,40.93115392307693,41.52977111117636,-10.825007153075823
2017-11-14,43.259998,43.369999,42.794998,42.834999,40.45377,99130000,7066731045.629809,4189301200,30.56066093784049,56.0,1.1320422160857007,62.18880060576767,74.82010795064592,41.08019238461538,41.62645465849663,-25.17989204935408
2017-11-15,42.4925,42.580002,42.095001,42.27,39.920174,116632400,7034265702.471342,4072668800,28.894717371245267,56.0,1.0092188254687997,56.08938762352634,59.17901519771264,41.206923230769235,41.674124683793174,-40.820984802287356
2017-11-16,42.794998,42.967499,42.575001,42.775002,40.397095,94550000,7036073363.147321,4167218800,27.826488771205096,56.0,0.9417736638690144,59.8772696163898,58.945731966219846,41.34682711538461,41.755671151660344,-41.054268033780154
2017-11-17,42.759998,42.8475,42.41,42.537498,40.172817,87598000,6999531682.251322,4079620800,26.573568682758893,56.0,0.8592533616028675,57.37070089439469,44.434217359774664,41.482884730769236,41.81358425153736,-55.565782640225336
2017-11-20,42.572498,42.639999,42.389999,42.494999,40.132668,65049600,6989123746.25132,4014571200,25.37730238924653,56.0,0.7814184084131242,56.9115971156534,42.8831595316936,41.607788500000005,41.86405941809014,-57.1168404683064
2017-11-21,42.695,43.424999,42.695,43.285,40.87875,100525200,7051091557.885582,4115096400,25.231405439916706,56.0,0.7745515771856759,62.86113166643696,71.71530229368517,41.73528846153847,41.96931427600939,-28.284697706314827
2017-11-22,43.34,43.75,43.262501,43.740002,41.30846,102355600,7149248785.01179,4217452000,25.43879830474836,56.0,0.7966412384498085,65.79090814061247,83.71506361323138,41.87461546153846,42.100476329638326,-16.28493638676862
2017-11-24,43.775002,43.875,43.662498,43.7425,41.310818,56106800,7135387763.532463,4273558800,25.761136477394214,56.00000000000001,0.8050686911387999,65.80685623015194,83.84218829516536,42.020865500000006,42.22210771262808,-16.15781170483464
2017-11-27,43.762501,43.77,43.334999,43.522499,41.103043,82867200,7123957640.688607,4190691600,25.442483605702353,40.0,0.7849468869362894,63.02032040361994,72.64620865139962,42.195000115384616,42.31843299317415,-27.353791348600375
2017-11-28,43.575001,43.717499,42.965,43.267502,40.862225,105715200,7103236731.525937,4084976400,24.4973685091936,40.0,0.7398950359293508,59.85658245569364,59.66926208651395,42.35673096153847,42.38873440108718,-40.33073791348605
2017-11-29,43.157501,43.23,41.790001,42.369999,40.014618,166665600,7070829161.800681,3918310800,23.510321448316216,40.0,0.6245704684916689,50.28758946689582,25.950681901260996,42.48471169230769,42.38734659359924,-74.04931809873901
2017-11-30,42.607498,43.035,42.110001,42.962502,40.574173,166108800,7210899975.203075,4084419600,22.593777748930076,40.0,0.5743640470690821,55.36108494978703,56.23508692330318,42.62653861538461,42.42995069777707,-43.76491307669682
2017-12-01,42.487499,42.9175,42.125,42.762501,40.385292,159037200,7307727441.543014,3925382400,21.742701456642948,36.0,0.5125285767571555,53.380685051130754,46.64270822192251,42.76730784615384,42.454584053497285,-53.35729177807749
2017-12-04,43.119999,43.154999,42.407501,42.450001,40.090157,130169600,7192359775.46123,3795212800,20.56523954530588,32.0,0.4333124267776327,50.349937410969375,31.65469144109914,42.886442461538465,42.45424456805304,-68.34530855890087
2017-12-05,42.264999,42.880001,42.099998,42.41,40.052387,109400800,7169918812.286472,3685812000,19.90446612955213,28.000000000000004,0.3631194952919543,49.95893064108163,29.73617733149987,42.9498078076923,42.4509671926417,-70.26382266850013
2017-12-06,41.875,42.549999,41.615002,42.252499,39.90366,114240000,7211460397.211344,3571572000,19.91131745173041,16.0,0.2914227370590936,48.36626346560014,28.20785682111234,42.971827000000005,42.43626584503861,-71.79214317888766
2017-12-07,42.2575,42.610001,42.227501,42.330002,39.976841,102693200,7163805919.79017,3674265200,19.807271069732774,16.0,0.23811158189592163,49.22407060877153,31.637196139111737,42.97451946153846,42.428394449109824,-68.36280386088826
2017-12-08,42.622501,42.75,42.205002,42.342499,39.988644,93420800,7117523200.067894,3767686000,19.445390631334185,16.0,0.194626972216561,49.370131800721225,32.19016123023112,42.99836557692308,42.42203182324984,-67.80983876976889
2017-12-11,42.299999,43.2225,42.197498,43.1675,40.76778,141095200,7243476505.710614,3908781200,18.270974509132717,-76.0,0.22415190796958484,57.96635033729284,68.69466256164819,43.04221173076923,42.47725168819429,-31.30533743835181
2017-12-12,43.037498,43.0975,42.865002,42.924999,40.538757,77636800,7205908653.311026,3831144400,17.18044525280278,-76.0,0.22538473332627973,55.00980528716829,57.9645203225844,43.034519384615386,42.51041815573546,-42.0354796774156
2017-12-13,43.125,43.384998,43.0,43.067501,40.67334,95273600,7144043347.762425,3926418000,16.23407670598224,-76.0,0.23514981606071927,56.416571860510956,64.26992413267628,43.015480961538465,42.55168355160691,-35.73007586732373
2017-12-14,43.099998,43.282501,42.912498,43.055,40.661541,81906000,7125227478.447852,3844512000,15.195021467265649,-76.0,0.23912352115395663,56.25040733253809,66.8213149153734,42.99057715384616,42.588966251487875,-33.17868508462659
2017-12-15,43.407501,43.5425,43.115002,43.4925,41.074707,160677200,7248319192.667804,4005189200,14.683999662591074,-72.0,0.2744120533933483,60.621670010940804,89.29848651389291,42.968750192307695,42.655894677303586,-10.701513486107086
2017-12-18,43.720001,44.299999,43.715,44.105,41.653168,117684400,7287547594.228147,4122873600,15.31681530672463,32.0,0.347792959810036,65.77707446525798,92.7374592969749,42.97394246153847,42.763235812318136,-7.262540703025091
2017-12-19,43.7575,43.8475,43.522499,43.634998,41.209293,109745600,7253778808.17272,4013128000,15.515249807704018,32.0,0.3638286333865324,59.355457444002944,75.23270975721776,42.97269238461539,42.82781078918346,-24.76729024278224
2017-12-20,43.717499,43.855,43.3125,43.587502,41.164433,93902400,7255077690.402398,3919225600,15.283989408813298,32.0,0.3684571453523162,58.73146021743194,73.46376923326177,42.97634630769231,42.88408421220691,-26.536230766738225
2017-12-21,43.5425,44.005001,43.525002,43.752499,41.320255,83799600,7250712245.895222,4003025200,15.298008424296262,31.999999999999993,0.38104668440981726,60.29313742244501,79.60891576415173,43.01163476923077,42.94841123352491,-20.391084235848265
2017-12-22,43.669998,43.855,43.625,43.752499,41.320255,65397600,7257820112.003049,4068422800,15.311026081530443,32.0,0.3865678710285465,60.293137422445014,79.60891576415173,43.06865396153846,43.00797329030084,-20.391084235848265
2017-12-26,42.700001,42.8675,42.419998,42.642502,40.271957,132742000,7257080319.671395,3935680800,15.205233657546444,32.0,0.2979414859460263,46.54948475788609,38.26819918234554,43.063557807692305,42.98090134287115,-61.73180081765446
2017-12-27,42.525002,42.695,42.427502,42.650002,40.279049,85992800,7314142032.228499,4021673600,15.106997835275587,32.0,0.2257078054859818,46.637994397685105,21.52217763511163,43.06788488461538,42.956390280436246,-78.47782236488837
2017-12-28,42.75,42.962502,42.619999,42.77,40.392387,65920800,7305961958.124624,4087594400,14.517058348308458,32.0,0.17611478739920017,48.118296422295785,27.2295708777309,43.07846184615384,42.94258359299653,-72.77042912226909
2017-12-29,42.630001,42.647499,42.305,42.307499,39.955593,103999600,7203479997.594521,3983594800,14.44946426207766,32.0,0.0983581859078626,43.14984774153791,5.231911899209422,43.040865653846154,42.8955402898116,-94.76808810079058
2018-01-02,42.540001,43.075001,42.314999,43.064999,40.670975,102223600,7303012971.919325,4085818400,13.612657232580476,32.0,0.09674423105387575,51.9084360016252,38.09520706526673,43.014904,42.90809278686259,-61.90479293473327
2018-01-03,43.1325,43.637501,42.990002,43.057499,40.663887,118071600,7209557560.624482,3967746800,13.31901807987669,31.999999999999996,0.09377894755228056,51.82330438328365,37.71926702720153,42.98855780769231,42.91915991376165,-62.28073297279847
2018-01-04,43.134998,43.3675,43.02,43.2575,40.852779,89738400,7242483160.624482,4057485200,13.046353152366033,32.00000000000001,0.10634150950912158,53.99029952977516,47.744384834278144,42.97836553846154,42.9442221423719,-52.255615165721856
2018-01-05,43.360001,43.842499,43.262501,43.75,41.317898,94640000,7306936486.325606,4152125200,13.468403351754931,32.0,0.15425985281423493,58.89360622835651,72.43111400055841,42.99692315384615,43.003909391085095,-27.568885999441587
2018-01-08,43.587502,43.9025,43.482498,43.587502,41.164433,82271200,7265802257.505744,4069854000,13.941415478030978,32.0,0.1770819639186456,56.744824135903265,64.28584675982299,43.04375019230769,43.047138473226944,-35.71415324017701
2018-01-09,43.637501,43.764999,43.352501,43.5825,41.159714,86336000,7275744026.920384,3983518000,14.109098516481684,32.0,0.1925454872748773,56.676274386327734,75.14701461940335,43.06759626923077,43.08679488261754,-24.85298538059665
2018-01-10,43.290001,43.575001,43.25,43.572498,41.150261,95839600,7370107406.731525,3887678400,14.04737040608238,32.0,0.20166865244258503,56.5292191643704,74.55866202431663,43.09875,43.122772891312536,-25.44133797568336
2018-01-11,43.647499,43.872501,43.622501,43.82,41.384003,74670800,7413415873.365126,3962349200,14.458726642808942,32.0,0.22626196244642927,59.34058176434212,89.11759463670906,43.15144226923076,43.174419343807905,-10.882405363290946
2018-01-12,44.044998,44.34,43.912498,44.272499,41.811352,101672400,7482980874.230619,4064021600,15.490664185638837,100.0,0.2790485276922112,63.93310884136975,96.68299754299754,43.22307684615385,43.25575857759991,-3.3170024570024528
2018-01-16,44.474998,44.8475,44.035,44.047501,41.598854,118263600,7368356445.34102,3945758000,17.043630707905617,92.0,0.2992769246489715,60.28675990554742,68.53494591937067,43.292115384615386,43.314406164444364,-31.46505408062933
2018-01-17,44.037498,44.8125,43.767502,44.775002,42.285927,137547200,7496032344.332597,4083305200,17.874637607196682,92.0,0.36974908836553055,66.8668867811282,97.14855457227154,43.386153846153846,43.4225984485596,-2.851445427728458
2018-01-18,44.842499,45.025002,44.5625,44.814999,42.3237,124773600,7507496897.795284,4208078800,18.904214122407307,100.0,0.42393930109656,67.18877119522136,92.27930714756826,43.481249999999996,43.52573923014778,-7.720692852431737
2018-01-19,44.6525,44.895,44.352501,44.615002,42.134808,129700400,7503313723.45063,4078378400,19.377143962960165,48.0,0.4456106267280404,63.84859193961553,84.92648167170452,43.53692315384615,43.60642536124794,-15.073518328295478
2018-01-22,44.325001,44.445,44.150002,44.25,41.790104,108434400,7468393199.010464,3969944000,19.364256260858717,48.0,0.4283944331147751,58.16537713940074,71.40217187951451,43.58788473076923,43.65409755671106,-28.597828120485495
2018-01-23,44.325001,44.860001,44.205002,44.259998,41.799545,130756400,7359594325.58501,4100700400,19.930202546511104,48.0,0.4108215357469476,58.274934697368714,62.40766584766604,43.63375,43.69897907102876,-37.59233415233396
2018-01-24,44.3125,44.325001,43.299999,43.555,41.133736,204420400,7256885739.650543,3896280000,18.724772380962435,48.0,0.3361327126154947,48.60828056703587,26.683265153850083,43.652980769230766,43.68831395465626,-73.31673484614991
2018-01-25,43.627499,43.737499,42.6325,42.7775,40.39946,166116000,7134365833.402665,3730164000,18.136054646952015,48.0,0.21176246414935918,40.60803134579127,6.060600994273071,43.62548076923076,43.62084625431135,-93.93939900572693
2018-01-26,43.0,43.0,42.514999,42.877499,40.493908,156572000,7211844278.659479,3886736000,17.744743443483824,48.0,0.11988526704170965,41.9317984229565,14.442213814086976,43.578269192307694,43.565783494732734,-85.55778618591303
2018-01-29,42.540001,42.540001,41.767502,41.990002,39.655739,202561600,7125968799.93601,3684174400,18.27166572081984,-28.0,-0.024261987296661403,34.56783035343149,6.830391404451161,43.515000115384616,43.449058939567344,-93.16960859554884
2018-01-30,41.3825,41.842499,41.174999,41.7425,39.422009,184192800,7254973297.891967,3499981600,19.3417210776603,-32.0,-0.15666512972932622,32.83596284187918,14.740274228357741,43.4440385,43.32264716626606,-85.25972577164225
2018-01-31,41.717499,42.110001,41.625,41.857498,39.530609,129915600,7249614625.274797,3629897200,19.85803392665624,-32.0,-0.24944079824803111,34.478527411992474,17.72723293981848,43.37115384615385,43.214117598394495,-82.27276706018152
2018-02-01,41.7925,42.154999,41.689999,41.945,39.613235,188923200,7267898328.170283,3818820400,20.256075652251212,-32.0,-0.3123054411245363,35.76578207631995,20.000010389602306,43.30163465384615,43.12010888740231,-79.9999896103977
2018-02-02,41.5,41.700001,40.025002,40.125,37.894413,346375200,6962880558.532451,3472445200,22.031983557509168,-43.99999999999999,-0.5031845152742207,24.83619110544842,1.9999599999999873,43.20480765384615,42.898248969816954,-98.00004000000001
2018-02-05,39.775002,40.970001,39.0,39.122501,36.947647,290954000,6708111470.067013,3181491200,24.265001063207595,-48.0,-0.7269707811718504,21.024935331508402,2.0332109433324628,43.06913453846153,42.6185639350157,-97.96678905666754
2018-02-06,38.7075,40.93,38.5,40.7575,38.491749,272975200,6942330931.795408,3454466400,26.580641499521978,-52.0,-0.763590063215041,37.79171196843084,34.59769054476918,42.991730692307684,42.48070734723676,-65.40230945523082
2018-02-07,40.772499,40.849998,39.767502,39.884998,37.667755,206434400,6780710029.974433,3248032000,28.730879047528187,-52.0,-0.8531798019871601,33.68217122092149,21.65751368256454,42.89855757692307,42.288432580774774,-78.34248631743546
2018-02-08,40.072498,40.25,38.7575,38.787498,36.63126,217562000,6571893657.948972,3030470000,31.177144549525167,-52.0,-1.0011982035666094,29.357626027070467,4.520408094275449,42.73403830769231,42.029104093309975,-95.47959190572455
2018-02-09,39.267502,39.4725,37.560001,39.102501,37.079319,282690400,6745203435.726842,3313160400,33.86254717214196,-64.0,-1.0806289261309487,32.05411330595096,21.130136986301334,42.581922999999996,41.812318678990714,-78.86986301369866
2018-02-12,39.625,40.9725,39.377499,40.677502,38.572834,243278000,6898492121.05682,3556438400,34.25465383932419,-64.0,-1.00490500875393,43.63835428498661,46.08279379157424,42.482692307692304,41.728258184250656,-53.91720620842577
2018-02-13,40.487499,41.1875,40.412498,41.084999,38.959248,130196800,6994249520.392565,3686635200,34.35793534640404,-64.0,-0.9016183611365705,46.19435246582052,57.06190435027262,42.380192269230776,41.680609355787645,-42.938095649727394
2018-02-14,40.759998,41.884998,40.720001,41.842499,39.677559,162579600,7144967338.052523,3849214800,33.64091128442022,-64.0,-0.7499935704262555,50.672599138174455,78.72240417691248,42.31307676923076,41.69260118128486,-21.27759582308753
2018-02-15,42.447498,43.272499,42.25,43.247501,41.009861,204588800,7339552586.318192,4053803600,31.62264178561349,-64.0,-0.5105723518306959,57.70423014322671,99.56239809624435,42.30019219230769,41.807778945634126,-0.43760190375565317
2018-02-16,43.09,43.705002,42.942501,43.107498,40.877098,160704400,7248397587.267961,3893099200,29.38239218022427,-64.0,-0.32834146715519097,56.83481465853203,90.27658416979915,42.28230757692308,41.90405443114271,-9.723415830200851
2018-02-20,43.012501,43.564999,42.855,42.962502,40.739605,135722000,7153775325.27886,3757377200,27.37686955938339,-64.0,-0.1933928313877189,55.89552376326982,87.91700766200039,42.249326884615385,41.98245795476177,-12.082992337999613
2018-02-21,43.2075,43.529999,42.752499,42.767502,40.554695,149886400,7009673480.029214,3607490800,25.60664090638331,-64.0,-0.10101549189596426,54.58889198278153,84.74369654292978,42.191442384615385,42.04060936552016,-15.256303457070226
2018-02-22,42.950001,43.487499,42.927502,43.125,40.8937,123967600,6973146895.123224,3731458400,23.962857157168944,-64.0,0.0010294492089357732,56.59228784354657,90.5614010477785,42.155961576923076,42.12093459770385,-9.438598952221493
2018-02-23,43.4175,43.912498,43.384998,43.875,41.604893,135249600,7089167719.764741,3866708000,22.498872402664627,-64.0,0.1407965176049757,60.526704825308784,99.40971243276464,42.12134611538462,42.250865368244305,-0.5902875672353622
2018-02-26,44.087502,44.8475,44.052502,44.7425,42.427513,152648800,7201494093.796375,4019356800,21.98604362948123,-60.0,0.3178983915038103,64.53124236725168,98.55917647467264,42.11855769230769,42.435430896522504,-1.4408235253273711
2018-02-27,44.775002,45.119999,44.540001,44.5975,42.290009,155712400,7076655273.662513,3863644400,21.73428314524453,43.99999999999999,0.4414636956524305,63.3739503206488,93.08863573773428,42.11788453846154,42.59558416344676,-6.911364262265723
2018-02-28,44.814999,45.154999,44.512501,44.529999,42.226002,151128400,6933758633.89585,3712516000,21.53024541258406,48.0,0.5278584986674133,62.80924303679716,91.77089974217242,42.12865373076924,42.738874151339594,-8.22910025782759
2018-03-01,44.634998,44.945,43.165001,43.75,41.486351,195208000,6866861363.050193,3517308000,20.127576043156015,48.0,0.5273091107313732,56.53971631131421,81.50099578696404,42.10903842307693,42.81377236235148,-18.499004213035963
2018-03-02,43.200001,44.075001,43.112499,44.052502,41.773209,153816000,7013486300.207725,3671124000,18.876098614444995,48.0,0.5450006716278466,58.279055253919445,80.91740372133276,42.12817311538462,42.90553011328841,-19.08259627866725
2018-03-05,43.802502,44.435001,43.630001,44.205002,41.91782,113605600,7062174696.743377,3784729600,17.715394485192515,48.0,0.5648159894626659,59.166286479226336,79.9684385938981,42.18307703846154,43.00178729008186,-20.0315614061019
2018-03-06,44.477501,44.5625,44.032501,44.1675,41.882244,95154000,7015495108.378114,3689575600,16.77031313162984,48.0,0.5709125491399405,58.83493627668812,77.73394711790172,42.23269246153846,43.088136379705425,-22.266052882098283
2018-03-07,43.735001,43.962502,43.567501,43.7575,41.493462,126814000,7010678435.90893,3562761600,15.772454983706782,48.0,0.5364763773869186,55.19552679930538,51.893305298900344,42.30067315384615,43.137718870097615,-48.106694701099656
2018-03-08,43.869999,44.279999,43.767502,44.235001,41.946266,95096400,7089075624.763498,3657858000,14.803907595890749,48.0,0.5414740276956707,58.42135392591961,61.70663891779392,42.39653857692308,43.218999027868165,-38.29336108220608
2018-03-09,44.490002,45.0,44.3475,44.994999,42.66695,128740800,7215842991.075222,3786598800,14.647863908919433,48.0,0.5998455425792173,62.98882152610678,93.34027055150898,42.51721169230769,43.35055458135941,-6.659729448491023
2018-03-12,45.072498,45.5975,45.052502,45.43,43.079433,128828400,7265483001.39306,3915427200,15.045021107812376,80.0,0.6734432987691363,65.33600093028511,94.11248010106159,42.651250153846156,43.504587575332785,-5.887519898938422
2018-03-13,45.647499,45.875,44.810001,44.9925,42.66457,126774000,7182157170.313406,3788653200,15.651072942873864,84.0,0.6885305060544624,61.13660181075028,70.0593520334874,42.838461692307696,43.61480331049332,-29.940647966512593
2018-03-14,45.080002,45.130001,44.452499,44.610001,42.301853,117473600,7119302824.418041,3671179600,15.732046071325783,84.0,0.6619917253685514,57.647966846026826,54.20819757169308,43.04951938461538,43.688521657864186,-45.79180242830692
2018-03-15,44.625,45.060001,44.517502,44.662498,42.351639,90975200,7076958276.637492,3762154800,15.807235404888278,84.0,0.6378429630035996,58.00218417477854,56.10854077518884,43.19971161538462,43.76066805357795,-43.89145922481116
2018-03-16,44.662498,44.779999,44.404999,44.505001,42.202305,157618800,7003404517.9046955,3604536000,15.714065591059803,84.0,0.5990902635666302,56.476085517930635,50.40729397021033,43.37740403846154,43.81580382738699,-49.59270602978967
2018-03-19,44.330002,44.3675,43.415001,43.825001,41.55748,133787200,6984793820.97714,3470748800,14.833517662053742,84.0,0.5076562082975968,50.32005606830125,25.791918265368974,43.57115415384615,43.8164850994324,-74.20808173463102
2018-03-20,43.810001,44.200001,43.735001,43.810001,41.543251,78597600,6931550285.49327,3392151200,14.015866013690971,80.0,0.42903800307772144,50.19009264909004,25.24893203658569,43.75221184615385,43.81600479577074,-74.75106796341431
2018-03-21,43.759998,43.772499,42.814999,42.817501,40.6021,148219600,6784105297.376717,3243931600,14.251163209769711,76.0,0.283379432001432,42.388974398829305,0.08176467916186245,43.834519500000006,43.74204155163957,-99.91823532083815
2018-03-22,42.5,43.169998,42.150002,42.212502,40.028412,165963200,6638480804.587333,3077968400,15.065422778251099,72.0,0.11776804518095929,38.46428450747414,1.6778532498540941,43.877885,43.6287423255922,-98.3221467501459
2018-03-23,42.0975,42.48,41.235001,41.235001,39.101494,164115200,6474365604.587333,2913853200,16.512066547459025,-32.0,-0.09130383959497124,33.127408236087064,0.0,43.8545196923077,43.451428153326106,-100.0
2018-03-26,42.017502,43.275002,41.610001,43.192501,40.95771,150164800,6609649036.750557,3064018000,16.806946970406507,-32.0,-0.09791225257218628,48.52888311983039,42.18750909213562,43.85240430769231,43.43224836419084,-57.81249090786439
2018-03-27,43.419998,43.787498,41.73,42.084999,39.907505,163690400,6502444648.70255,2900327600,16.47730022353451,-32.0,-0.19032171285265775,42.55698438995611,18.318926361837704,43.81307742307692,43.33245211499152,-81.68107363816229
2018-03-28,41.8125,42.505001,41.297501,41.619999,39.466568,166674000,6424800928.871494,2733653600,16.546497406029566,-31.999999999999993,-0.297647395831909,40.3138292684836,8.29737247788206,43.761442692307696,43.20560373610326,-91.70262752211794
2018-03-29,41.952499,42.9375,41.724998,41.945,39.774746,153594000,6326944547.758721,2887247600,16.102892683457675,-32.0,-0.3524164705782624,42.59145030147854,15.301705883988399,43.729808,43.112225681577094,-84.69829411601161
2018-04-02,41.66,42.235001,41.1175,41.669998,39.513973,150347200,6325262140.551928,2736900400,16.228270101315797,-52.0,-0.4132480536920369,41.16018257424926,11.613200210194428,43.67384638461538,43.005394001460274,-88.38679978980558
2018-04-03,41.91,42.1875,41.220001,42.0975,39.919353,121112000,6423841652.146254,2858012400,16.34469198932691,-52.0,-0.4220960227561932,44.29409370053793,24.423669925565047,43.60548099999999,42.9381425939447,-75.57633007443495
2018-04-04,41.220001,43.002499,41.192501,42.9025,40.682713,138422000,6546968539.579279,2996434400,15.48082208973577,-52.0,-0.36000145694883656,49.72429514249522,45.27582871887677,43.534711769230775,42.93550240180065,-54.72417128112323
2018-04-05,43.145,43.557499,43.02,43.200001,40.964821,107732800,6511392196.550547,3104167200,14.652734930706242,-52.0,-0.2835170141430794,51.60196676488322,56.860111088085006,43.48096180769231,42.955094890556154,-43.139888911914994
2018-04-06,42.7425,43.119999,42.049999,42.095001,39.916988,140021200,6383149004.106436,2964146000,14.279048366909365,-52.0,-0.30851049041614687,44.89510980146246,30.076953846153963,43.38730803846154,42.89138423199644,-69.92304615384604
2018-04-09,42.470001,43.272499,42.462502,42.512501,40.312889,116070800,6281407698.979133,3080216800,13.766129720527248,-52.0,-0.2912716414515515,47.662949407153796,45.255492212330196,43.33971192307692,42.863318807404106,-54.744507787669804
2018-04-10,43.25,43.5,42.8825,43.3125,41.071499,113634400,6326033354.039862,3193851200,13.037544728464114,-52.0,-0.21062850176189585,52.578208163940545,82.20979940808947,43.311250307692305,42.89659148833714,-17.790200591910533
2018-04-11,43.057499,43.48,42.924999,43.110001,40.879471,89726400,6296125092.936188,3104124800,12.361001521548348,-52.0,-0.16119999628696036,51.26575851672411,74.62556151727445,43.26913488461538,42.91239960031216,-25.37443848272555
2018-04-12,43.352501,43.75,43.259998,43.535,41.282482,91557200,6307336506.592457,3195682000,11.544600808450912,-52.0,-0.08673386810816908,53.86846096933216,90.5431389836246,43.244807961538456,42.958518148437186,-9.456861016375399
2018-04-13,43.695,43.959999,43.462502,43.682499,41.422352,100497200,6295720576.262022,3296179200,11.034866698175573,-52.0,-0.015636737847202653,54.771259116636635,90.23746358398004,43.2419233076923,43.01214635966406,-9.762536416019955
2018-04-16,43.7575,44.047501,43.7075,43.955002,41.680752,86313600,6335070069.177632,3382492800,10.667406896713178,-52.0,0.06198246948371633,56.46631883339804,96.84303862012345,43.23115411538462,43.08198751820746,-3.1569613798765475
2018-04-17,44.122501,44.735001,44.102501,44.560001,42.254459,106421600,6382602246.252732,3488914400,11.105789312084793,-52.00000000000001,0.17035091432151717,60.04641212018102,95.16240631308747,43.21442342307692,43.191469998340246,-4.837593686912521
2018-04-18,44.452499,44.705002,44.220001,44.459999,42.159622,83018000,6381745536.493371,3405896400,11.512858697787006,-52.0,0.24533627806257385,59.18008236974994,92.39801177663824,43.177115692307694,43.2854351095743,-7.601988223361755
2018-04-19,43.439999,43.8475,43.165001,43.200001,40.964821,139235200,6256790890.750595,3266661200,10.917596168371867,-48.0,0.2007769786794995,49.49126865332911,57.56739251765244,43.10817342307692,43.279106657013244,-42.43260748234756
2018-04-20,42.650002,42.805,41.357498,41.43,39.286396,261964400,6021068862.683484,3004696800,12.02415646844741,-44.0,0.022381128978466336,39.66677325339726,6.7042766407903995,42.9858656923077,43.14213579353078,-93.2957233592096
2018-04-23,41.7075,41.73,41.022499,41.310001,39.172611,146062000,5993715153.198974,2858634800,13.291899030407844,-100.0,-0.1272153245363512,39.100079910916754,7.744157444224862,42.8569235,43.00642210512109,-92.25584255577513
2018-04-24,41.4175,41.5825,40.305,40.735001,38.627357,134768000,5949671810.37001,2723866800,14.947429065286768,-20.0,-0.28883972173985484,36.415464999893686,9.70656665765984,42.711923500000005,42.83816868992694,-90.29343334234017
2018-04-25,40.654999,41.355,40.602501,40.912498,38.79567,113528400,5929680978.964255,2837395200,16.484706954817195,-20.0,-0.39801759736378983,37.8343994799196,13.713270042151233,42.599904153846154,42.695526416599016,-86.28672995784876
2018-04-26,41.029999,41.432499,40.842499,41.055,38.930794,111852000,5898400714.055781,2949247200,17.797111862316118,-20.0,-0.4676523250194293,39.01112744196,16.93001875168878,42.49394257692308,42.57400594129539,-83.06998124831122
2018-04-27,41.0,41.0825,40.157501,40.580002,38.480377,142623200,5886066183.823423,2806624000,19.485783766506508,-32.0,-0.5547716549488371,36.52902594367186,9.229950846531896,42.40788492307692,42.42630194564388,-90.77004915346811
2018-04-30,40.532501,41.814999,40.459999,41.314999,39.177345,169709600,5930528846.55405,2976333600,20.001080717043074,-32.0,-0.5580731168029516,42.61345184044445,25.2866848716548,42.37336557692307,42.34398320892952,-74.7133151283452
2018-05-01,41.602501,42.299999,41.317501,42.275002,40.087673,214277600,6133903020.456084,3190611200,19.85363639885193,-32.0,-0.4777184887193897,49.43200020806559,46.2588967777171,42.41336561538461,42.33887348974956,-53.7411032222829
2018-05-02,43.807499,44.4375,43.450001,44.142502,41.85854,266157600,6241040794.238944,3456768800,19.236240844866465,-31.999999999999993,-0.26034413920982047,59.51051949808794,87.05627525942114,42.44990411538461,42.47247560161996,-12.943724740578862
2018-05-03,43.970001,44.375,43.610001,44.2225,41.934406,136272800,6322982537.597039,3593041600,18.662944973308534,-32.0,-0.08068810880534016,59.87940494662624,88.8039104314582,42.53211569230769,42.602107038537,-11.196089568541803
2018-05-04,44.5625,46.0625,44.5425,45.9575,43.579639,224805200,6516729124.439145,3817846800,19.30089448349649,20.0,0.19939212138398688,66.91880358951104,98.22184559218391,42.69894265384615,42.850654665312035,-1.7781544078161051
2018-05-07,46.294998,46.9175,46.1875,46.290001,43.894932,169805600,6394609123.906541,3987652400,20.366371775533334,24.0,0.44308022057636975,68.07486035607708,90.7174690410457,42.86605807692308,43.10542106047411,-9.282530958954297
2018-05-08,46.247501,46.555,45.9175,46.512501,44.105919,113611200,6493072520.333836,4101263600,21.066500498360877,24.0,0.6467038855210987,68.8591036331228,94.0088896462855,43.05230819230769,43.35779735229084,-5.991110353714504
2018-05-09,46.637501,46.849998,46.305,46.84,44.416473,92844800,6582510840.638865,4194108400,21.8876203991643,24.0,0.824993527451916,70.02624586974667,98.8535501262649,43.23471203846154,43.61573828915818,-1.1464498737350928
2018-05-10,46.935001,47.592499,46.912498,47.509998,45.051807,111957200,6667301666.0094185,4306065600,23.059650571029888,36.0,1.0087246426119378,72.31250062395347,98.8903695737377,43.41192349999999,43.90420197144276,-1.1096304262623014
2018-05-11,47.372501,47.514999,46.862499,47.147499,44.880466,104848800,6654044921.181833,4201216800,24.087429525895395,36.0,1.112260785342869,69.23548155154937,94.01479327902989,43.56375034615385,44.14444619578033,-5.9852067209701145
2018-05-14,47.252499,47.3825,46.965,47.037498,44.775757,83115200,6599795281.754766,4118101600,25.041795698270505,35.99999999999999,1.1719285007549374,68.28592138996245,92.53529052731423,43.75384638461538,44.35874632942623,-7.464709472685772
2018-05-15,46.695,46.767502,46.275002,46.610001,44.368805,94780800,6633954474.52309,4023320800,25.0510780813444,36.0,1.1712190754993728,64.57905788226705,86.7854974540679,43.911442538461536,44.52550593465392,-13.214502545932097
2018-05-16,46.517502,47.115002,46.5,47.044998,44.78289,76732400,6693218394.974731,4100053200,25.30665900036996,36.0,1.1920166474444542,66.56779904840201,92.63616479789238,44.05500015384616,44.71213497653141,-7.3638352021076185
2018-05-17,47.0,47.227501,46.59,46.747501,44.499699,69176000,6658223640.732777,4030877200,25.624804815779505,36.0,1.1709948517040587,63.92438188926488,88.15284963196638,44.194903999999994,44.862902830121676,-11.847150368033615
2018-05-18,46.797501,46.952499,46.532501,46.577499,44.337879,73190800,6600715961.2162075,3957686400,25.840045539954097,36.0,1.1276187000361801,62.39949131625683,83.82469603974384,44.311923192307695,44.989909953816365,-16.175303960256148
2018-05-21,47.0,47.317501,46.727501,46.907501,44.652004,73603200,6572023188.334853,4031289600,26.324526859203267,36.0,1.1071091259370007,64.18547921271013,83.46413202854912,44.435961730769236,45.13195373501515,-16.53586797145089
2018-05-22,47.095001,47.220001,46.695,46.790001,44.540157,60962800,6533123306.168532,3970326800,26.72395054503537,36.0,1.0690505237118515,63.03735532361187,79.84938096641856,44.545000153846146,45.25477205093996,-20.150619033581435
2018-05-23,46.587502,47.125,46.439999,47.09,44.825737,80233600,6605157864.123339,4050560400,26.68908222329901,36.0,1.0509811627239287,64.77008260806905,83.52461754905515,44.64230780769231,45.39071486198145,-16.475382450944842
2018-05-24,47.192501,47.209999,46.552502,47.037498,44.775757,92936000,6649328461.58614,3957624400,26.736911516771254,36.0,1.0206590689274293,64.20284868095831,66.86559215856265,44.74144238461538,45.51269879813097,-33.13440784143736
2018-05-25,47.057499,47.412498,46.912498,47.145,44.878082,69844000,6644439940.3381405,4027468400,26.976356100019267,36.00000000000001,0.9938466584723002,64.88104390288046,73.28362584097104,44.89317311538461,45.63360999826942,-26.716374159028963
2018-05-29,46.900002,47.1875,46.717499,46.974998,44.716259,90056400,6653061768.442336,3937412000,26.850079796244586,36.0,0.9479524832328394,62.853103648848126,53.13074716678678,45.10644226923077,45.73297207247169,-46.86925283321322
2018-05-30,46.93,47.0,46.695,46.875,44.621071,74762000,6666543440.573483,3862650000,26.691324211228004,36.0,0.893215582595289,61.632790956369824,45.540748859390284,45.32048069230769,45.81756673377008,-54.459251140609716
2018-05-31,46.805,47.057499,46.535,46.717499,44.471138,109931200,6633406010.777062,3752718800,26.238420414505317,36.0,0.8275872691887187,59.66779756914079,35.6853282709551,45.550576769230766,45.88422838312044,-64.3146717290449
2018-06-01,46.997501,47.564999,46.9375,47.560001,45.273132,93770000,6725682263.504158,3846488800,26.41479706231318,36.0,0.8339460177255802,65.92594009213143,99.61255723850516,45.80624996153846,46.00835968807448,-0.3874427614948332
2018-06-04,47.91,48.355,47.837502,47.9575,45.65152,105064800,6669342544.066403,3951553600,27.34029119340491,100.0,0.8611336068330857,68.41600334667235,80.88940470135094,46.071730730769225,46.15274045192081,-19.11059529864906
2018-06-05,48.267502,48.485001,48.09,48.327499,46.003719,86264000,6686813034.541113,4037817600,28.311510797674835,100.0,0.9021365258565339,70.57176112961159,92.2981982413712,46.369711384615385,46.31383367770445,-7.701801758628797
2018-06-06,48.407501,48.52,47.98,48.494999,46.16317,83734400,6762793939.228519,4121552000,28.981912911073852,100.0,0.9373423851956275,71.51948044033863,98.79802942402416,46.64586523076923,46.47540147935597,-1.2019705759758348
2018-06-07,48.535,48.549999,48.084999,48.365002,46.039425,85388800,6780240064.6754,4036163200,29.63427646754005,100.0,0.9438732278664759,69.6448836188132,91.2323696682463,46.880095999999995,46.61537188829257,-8.767630331753686
2018-06-08,47.7925,48.0,47.442501,47.924999,45.620579,106627200,6858177897.960123,3929536000,28.91837993670823,96.0,0.9031336404676722,63.571215825054296,70.37914691943128,47.02557665384616,46.7123813039746,-29.62085308056873
2018-06-11,47.837502,47.9925,47.552502,47.807499,45.508739,73234000,6869828148.788536,3856302000,28.2536188723644,92.0,0.8515498196797964,62.01585392093435,64.81042654028437,47.16346123076923,46.79350113330982,-35.18957345971564
2018-06-12,47.8475,48.1525,47.787498,48.07,45.758614,67644400,6906893741.001181,3923946400,27.850236961100098,84.0,0.8223711245362466,64.12745055809822,77.25123222748817,47.24471123076923,46.8880566049165,-22.748767772511826
2018-06-13,48.105,48.220001,47.610001,47.674999,45.382607,86553600,6838785422.616919,3837392800,27.102530535424624,84.0,0.7586285215088395,58.82784608519988,56.57566083159353,47.297980384615386,46.946348634181945,-43.42433916840647
2018-06-14,47.887501,47.892502,47.555,47.700001,45.406395,86440400,6826619808.783519,3923833200,26.29069005541848,64.0,0.7020368579231757,59.058480799539645,57.81645549203756,47.34365346153846,47.00217473535365,-42.18354450796244
2018-06-15,47.5075,47.540001,47.064999,47.209999,44.939949,246876800,6730467157.313424,3676956400,24.556747581236667,64.0,0.6106097612913999,52.8142365802996,33.49872630209771,47.357884192307694,47.017569125327455,-66.50127369790229
2018-06-18,46.970001,47.305,46.799999,47.185001,44.916157,73939600,6769267507.845007,3603016800,23.129379146165228,64.0,0.5300261868785725,52.50921872691324,32.2581301529183,47.345384307692306,47.02997148641431,-67.7418698470817
2018-06-19,46.285,46.5825,45.862499,46.422501,44.190334,134314000,6843886852.737581,3468702800,23.15002774036872,-32.0,0.4000245124881374,44.136096320299735,20.83728372093013,47.317499769230764,46.98497367260584,-79.16271627906987
2018-06-20,46.587502,46.799999,46.432499,46.625,44.383091,82514800,6847816577.9881935,3551217600,22.754695006579762,-32.0,0.30976643127069536,46.57268891103551,28.372130232558153,47.30163446153846,46.95830895611652,-71.62786976744185
2018-06-21,46.8125,47.087502,46.235001,46.365002,44.135586,102847600,6776336192.449174,3448370000,21.860555768265623,-32.0,0.21478072739639487,43.92368721138335,18.697786046511524,47.29221142307692,46.91436029270048,-81.30221395348848
2018-06-22,46.529999,46.537498,46.174999,46.23,44.007076,108801600,6700550941.744481,3339568400,21.119431101927923,-31.999999999999993,0.127144694704036,42.56972468674271,13.674455813953385,47.26086534615384,46.86366693768563,-86.32554418604661
2018-06-25,45.849998,46.23,45.182499,45.5425,43.352638,126652400,6660953333.391267,3212916000,21.686334704023476,-48.0,0.0021917380965845723,36.41382737933376,10.690452858203324,47.214519153846155,46.765802720079286,-89.30954714179667
2018-06-26,45.747501,46.6325,45.634998,46.107498,43.890472,98276800,6655780683.558384,3311192800,21.47730511811679,-48.0,-0.05065978902431567,43.62838775483565,27.468418708240527,47.1964421923077,46.71703940748082,-72.53158129175947
2018-06-27,46.307499,46.82,46.0075,46.040001,43.826218,101141200,6562731028.521337,3210051600,20.956757052945765,-48.0,-0.09687473717859518,43.00069814834404,28.230499930534883,47.163076807692306,46.666888414334096,-71.76950006946512
2018-06-28,46.025002,46.552502,45.950001,46.375,44.145103,69460800,6591264324.92682,3279512400,20.55031189717198,-48.0,-0.10525547733161744,47.070883104299696,39.25926633134723,47.14711523076923,46.64526705030935,-60.74073366865277
2018-06-29,46.572498,46.797501,45.727501,46.2775,44.052299,90950800,6593814177.355232,3188561600,19.724586306299052,-48.0,-0.11839986944772818,46.04042643513915,36.04939190163503,47.11586523076923,46.61802504658274,-63.95060809836497
2018-07-02,45.955002,46.825001,45.855,46.794998,44.544914,70925200,6660351817.392716,3259486800,18.90693516381494,-48.0,-0.08606700435979775,52.041534043865816,53.0863518772991,47.106538307692304,46.63113415424327,-46.9136481227009
2018-07-03,46.947498,46.987499,45.884998,45.98,43.769108,55819200,6614152446.560037,3203667600,17.83871946520393,-48.0,-0.12476825246060486,43.78303185587449,29.428048603636114,47.06173061538462,46.5829019946697,-70.57195139636389
2018-07-05,46.314999,46.602501,46.07,46.349998,44.121307,66416800,6617581792.074881,3270084400,16.84680488792228,-48.0,-0.12415237273946644,47.830603355127316,49.522715145098545,47.03769215384615,46.565649846916386,-50.477284854901455
2018-07-06,46.355,47.107498,46.299999,46.9925,44.732914,69940800,6667601695.285163,3340025200,16.29572316404713,-48.0,-0.07100128324011479,54.02135106470636,85.2768031675839,47.04221138461538,46.59726837677443,-14.7231968324161
2018-07-09,47.375,47.669998,47.325001,47.645,45.354046,79026400,6735175810.49892,3419051600,16.635397436488596,-48.0,0.023501721732195335,59.30311703743799,98.995054872384,47.077884499999996,46.674878126642994,-1.004945127615992
2018-07-10,47.677502,47.82,47.544998,47.587502,45.299313,63756400,6691127645.534303,3355295200,17.155530472774913,-48.0,0.09268797666227613,58.66360517639429,91.18491329481962,47.07894223076923,46.74247989503981,-8.815086705180383
2018-07-11,47.125,47.445,46.9025,46.970001,44.711494,75326000,6634546642.1278515,3279969200,16.368910167248178,-48.00000000000001,0.09657811967972663,52.158347333640954,67.77256198196714,47.040961499999995,46.75933331022204,-32.227438018032856
2018-07-12,47.3825,47.852501,47.327499,47.7575,45.461143,72164400,6680594226.708483,3352133600,16.23668592530744,-48.0,0.16134578022410295,58.48150988292983,96.44191277759356,47.019038461538464,46.83327158353893,-3.558087222406442
2018-07-13,47.77,47.959999,47.724998,47.8325,45.53252,50055600,6676334832.777394,3402189200,16.264860673501644,-48.0,0.21623388144577405,59.03679752776404,95.40957695769576,46.99355773076923,46.90728850327679,-4.590423042304234
2018-07-16,47.880001,48.162498,47.605,47.727501,45.432579,60172400,6642606219.741294,3342016800,16.57542193288983,-32.0,0.24839718717277748,57.86988668824147,82.78943620178028,46.96903846153846,46.968044984515544,-17.210563798219717
2018-07-17,47.4375,47.967499,47.299999,47.862499,45.561089,62138000,6685195186.033429,3404154800,16.244392758274255,-32.0,0.2815346923757218,58.992185145764765,87.67969734664973,46.96663461538461,47.034300837514394,-12.320302653350264
2018-07-18,47.945,47.950001,47.482498,47.599998,45.311211,65573600,6652583504.994377,3338581200,15.93700852470265,-32.0,0.2833485019520978,55.875278800451134,76.89935552281997,46.9586538076923,47.076204331031846,-23.10064447718003
2018-07-19,47.422501,48.137501,47.422501,47.970001,45.66341,81147200,6695710688.211162,3419728400,15.958281990184725,-32.0,0.3110564439056489,59.15143808026647,92.09456931569133,46.954807692307696,47.14241149169615,-7.905430684308675
2018-07-20,47.945,48.107498,47.5425,47.860001,45.558701,82704800,6705957922.394645,3337023600,15.978035922418082,56.0,0.320445213881726,57.77797350550651,86.89069286300564,46.96192315384615,47.195566270089024,-13.10930713699436
2018-07-23,47.669998,47.990002,47.389999,47.9025,45.599163,63957600,6751260889.283812,3400981200,15.631297268438185,56.0,0.32753952410364917,58.18197814219096,88.58406147091125,46.969711576923075,47.24793173156391,-11.415938529088754
2018-07-24,48.112499,48.415001,48.012501,48.25,45.929955,74791600,6764732296.53052,3475772800,16.049448590009995,80.0,0.35708589793445356,61.431647286334595,92.96371302187092,47.00971161538462,47.322159010707324,-7.0362869781290875
2018-07-25,48.264999,48.712502,48.107498,48.705002,46.363075,66839600,6829914727.321722,3542612400,16.89080591531506,84.0,0.4124618671986582,65.24048563994644,99.68911955757152,47.0681731923077,47.424591824729,-0.310880442428477
2018-07-26,48.6525,48.990002,48.4025,48.552502,46.217907,76304000,6792574858.875316,3466308400,18.05901799128441,88.0,0.43898193579939715,62.99500763289409,79.04193624724664,47.1500963076923,47.50814072660093,-20.958063752753354
2018-07-27,48.747501,48.797501,47.525002,47.744999,45.449242,96096000,6729706125.398904,3370212400,17.206224988782147,88.0,0.39034093044899976,52.65958904648172,40.35919486544201,47.19317319230769,47.52568578388974,-59.64080513455799
2018-07-30,47.974998,48.049999,47.267502,47.477501,45.194595,84118000,6690737680.942247,3286094400,15.998252394854422,88.0,0.32644467918643727,49.74781908206621,27.54493169347838,47.23596161538462,47.52211654063865,-72.45506830652162
2018-07-31,47.575001,48.035,47.334999,47.572498,45.28503,157492000,6640114649.7237215,3443586400,14.87656355763582,88.0,0.28024145464527805,50.7885062007133,17.706589259797,47.28759615384615,47.52584850059134,-82.293410740203
2018-08-01,49.782501,50.439999,49.327499,50.375,47.952766,271742800,6880103723.418643,3715329200,16.627510662116748,100.0,0.46441012539341386,70.31767893745564,97.95117221545047,47.473461538461535,47.7368967598068,-2.0488277845495286
2018-08-02,50.145,52.095001,50.087502,51.8475,49.354485,249616000,7068170293.390532,3964945200,19.235029707849737,92.0,0.720873783382487,75.76061211709384,94.8731009576593,47.69423084615384,48.041385888709996,-5.126899042340696
2018-08-03,51.7575,52.185001,51.369999,51.997501,49.497261,133789600,7140400412.554902,4098734800,21.700168176442563,96.0,0.925557654645921,76.23861490701995,96.18708615904141,47.92336546153846,48.33443145250926,-3.8129138409585854
2018-08-06,52.0,52.3125,51.767502,52.267502,49.75428,101701600,7225307937.726004,4200436400,24.05398401272205,100.0,1.096913386779434,77.11348651428665,99.108067039868,48.15000015384616,48.625770011582645,-0.8919329601319892
2018-08-07,52.330002,52.375,51.689999,51.7775,49.287838,102349600,7149106306.413934,4098086800,26.099718828716522,100.0,1.1795775371771455,71.93692251707562,88.30151279550189,48.36153861538461,48.859231492206156,-11.698487204498106
2018-08-08,51.512501,51.952499,51.130001,51.8125,49.321156,90102000,7208535429.6458435,4188188800,27.020606505970314,96.0,1.233692440911227,72.08108909711083,88.9867798284013,48.55451946153846,49.07799212241311,-11.013220171598697
2018-08-09,52.3825,52.445,51.799999,52.220001,49.709064,93970400,7236945478.4848385,4282159200,28.21706835261293,100.0,1.2945381866754033,73.77060722203804,95.65429093357454,48.79451950000001,49.310733520752876,-4.345709066425459
2018-08-10,51.84,52.275002,51.6675,51.8825,49.560993,98444800,7208181542.086934,4183714400,29.100175120150702,96.0,1.300533626386077,69.99272550658914,89.1356790480653,49.007308038461545,49.50123474143785,-10.8643209519347
2018-08-13,52.327499,52.737499,51.924999,52.217499,49.881008,103563600,7179183734.086933,4287278000,30.246996175644025,92.0,1.31713357913506,71.55011976896809,90.49359624877302,49.208269538461536,49.70243950133134,-9.506403751226978
2018-08-14,52.540001,52.639999,52.064999,52.4375,50.091171,82992000,7203720787.97215,4370270000,31.311901441459252,92.0,1.3326791081647755,72.55742861874634,94.51555457891476,49.39259646153846,49.905036575306795,-5.484445421085235
2018-08-15,52.305,52.685001,52.0825,52.560001,50.208191,115230400,7271137823.347029,4485500400,32.334487200174195,92.0,1.3394435869411652,73.12796382011285,96.75506220570139,49.58384642307692,50.10170060676555,-3.2449377942986066
2018-08-16,52.9375,53.452499,52.8675,53.330002,50.943733,114001600,7337396251.152887,4599502000,33.814544639198125,52.0,1.3909036590657848,76.44317191159102,98.01944932228741,49.82846184615385,50.340834043301435,-1.9805506777125792
2018-08-17,53.360001,54.487499,53.290001,54.395,51.961082,141708000,7457212192.390368,4741210000,35.7439717135844,56.0,1.500327730854984,80.10000666353432,98.70675987416992,50.083750307692306,50.64114263268651,-1.2932401258300819
2018-08-20,54.525002,54.794998,53.7775,53.865002,51.454792,121150800,7356898656.5453825,4620059200,37.67633027012988,60.0,1.5266820465775197,73.94789171416744,82.99046785376635,50.31576961538462,50.879947030265285,-17.00953214623365
2018-08-21,54.200001,54.297501,53.5075,53.759998,51.354477,104639200,7319148457.2469015,4515420000,38.94268064689431,60.0,1.5215555412709207,72.7556213764023,78.01378907172737,50.547788730769234,51.093284139134525,-21.986210928272627
2018-08-22,53.525002,54.09,53.459999,53.762501,51.35688,76072400,7316130078.255756,4591492400,40.02390086199201,60.0,1.500399053737027,72.76689298306627,71.82816247871418,50.774711884615385,51.29100390660604,-28.171837521285813
2018-08-23,53.662498,54.262501,53.650002,53.872501,51.461952,75532800,7295474012.641282,4667025200,41.13376873582357,60.0,1.4754998221507805,73.28989224615873,74.82952919197479,51.01596200000001,51.48222591352412,-25.170470808025218
2018-08-24,54.150002,54.224998,53.7775,54.040001,51.621956,73905600,7308274024.311501,4740930800,42.164360332952874,60.0,1.452538887749597,74.10538508328708,79.39979214171245,51.249423538461535,51.67169073474455,-20.600207858287554
2018-08-27,54.287498,54.685001,54.0825,54.485001,52.047043,82100400,7335868025.151996,4823031200,43.409453743547104,60.0,1.4534949774609203,76.18562568808689,91.54168475444855,51.50423123076923,51.88008408772643,-8.458315245551436
2018-08-28,54.752499,55.134998,54.73,54.924999,52.467354,91107200,7332493667.747762,4914138400,44.81750253479603,84.0,1.4727795608249323,78.06222703916941,93.94378886447798,51.77432734615385,52.10563334048744,-6.056211135522011
2018-08-29,55.037498,55.872501,54.852501,55.744999,53.250668,109019200,7414257640.221487,5023157600,46.47658986729455,88.0,1.5365178576391898,81.05798581348897,96.96784852132022,52.06259653846154,52.37521598193281,-3.0321514786797836
2018-08-30,55.8125,57.064999,55.599998,56.2575,53.740234,195175200,7394274244.664488,5218332800,48.44765387341782,92.0,1.6098283653125947,82.65246085886041,84.28990272373542,52.35307723076923,52.66279257586371,-15.71009727626459
2018-08-31,56.627499,57.217499,56.5,56.907501,54.361156,173360400,7417832687.3678255,5391693200,50.32481449289596,96.0,1.700771681976228,84.44129105266789,93.98354196991764,52.67442334615385,52.97721542209603,-6.0164580300823545
2018-09-04,57.102501,57.294998,56.657501,57.09,54.535492,109560400,7456931068.317698,5501253600,52.09256113339153,100.0,1.76719987956767,84.91172849351118,96.06718314328377,53.03384646153847,53.281866131570396,-3.9328168567162303
2018-09-05,57.247501,57.4175,56.275002,56.717499,54.179661,133332000,7426879791.792048,5367921600,52.8872125945099,100.0,1.7693905542667494,79.61994768105981,84.61536263736262,53.389231,53.53635745515777,-15.38463736263738
2018-09-06,56.557499,56.837502,55.325001,55.775002,53.279331,137160000,7371335786.96825,5230761600,51.837280578183574,96.0,1.6757579540535872,68.06210544589055,60.205974610775286,53.70471192307692,53.70218297699793,-39.794025389224714
2018-09-07,55.462502,56.342499,55.177502,55.325001,52.849461,150479200,7258960601.864083,5080282400,50.61557936370232,92.0,1.547404606831833,63.33478177742938,47.12574930492753,53.89509657692308,53.82239171944253,-52.87425069507247
2018-09-10,55.237499,55.462502,54.1175,54.5825,52.140186,158066000,7210189145.664019,4922216400,47.92096780559581,76.0,1.3699777780189848,56.376866449194196,28.363884178424758,54.00028888461539,53.87869603652086,-71.63611582157525
2018-09-11,54.502499,56.075001,54.139999,55.962502,53.458435,142996000,7336557868.788853,5065212400,45.98899766619795,76.0,1.3254415015642564,64.24009017125388,63.23442495655721,54.15278892307692,54.03305203381561,-36.76557504344279
2018-09-12,56.235001,56.25,54.959999,55.267502,52.79454,197114800,7233417247.637396,4868097600,44.35001494817576,76.0,1.2200020655776314,58.51910021296416,42.933002220571886,54.26817353846154,54.12449277205149,-57.066997779428114
2018-09-13,55.880001,57.087502,55.642502,56.602501,54.069801,166825600,7288255881.788814,5034923200,43.50879232729992,76.0,1.2299853101399236,64.97207883533234,77.60991758241752,54.4537505,54.30804893708471,-22.390082417582466
2018-09-14,56.4375,56.709999,55.630001,55.959999,53.456043,127997200,7238478863.68841,4906926000,42.70884493815367,68.0,1.1725362930860044,60.12432562026505,56.29682158920551,54.613269692307696,54.43041560841177,-43.70317841079449
2018-09-17,55.537498,55.737499,54.317501,54.470001,52.032715,148780400,7121654862.21855,4758145600,40.232586890424464,68.0,0.9953039031652793,50.68045313069284,10.681848484848606,54.69980815384615,54.43334785964053,-89.3181515151514
2018-09-18,54.447498,55.462502,54.279999,54.560001,52.118702,126286800,7055174348.669579,4884432400,37.88989272124706,64.0,0.8522836101713693,51.179275162341625,13.409121212121224,54.80278896153846,54.44272957374123,-86.59087878787876
2018-09-19,54.625,54.904999,53.825001,54.592499,52.149742,108495200,7100882858.323855,4992927600,35.1902490411157,60.0,0.7331104733793197,51.37053546771248,21.36390295446142,54.89413511538461,54.453823605315954,-78.63609704553858
2018-09-20,55.060001,55.57,54.787498,55.0075,52.546162,106435200,7054296596.39788,5099362800,33.37630427250245,56.00000000000001,0.6644921642302322,53.856572884659236,32.91577812547759,54.99298126923077,54.49483667158884,-67.08422187452241
2018-09-21,55.195,55.34,54.322498,54.415001,51.980167,384986800,6739309528.998695,4714376000,31.15759145482316,52.0,0.5558939429398606,49.931850044155716,16.423108259737774,55.064327423076925,54.48892291813782,-83.57689174026223
2018-09-24,54.205002,55.314999,54.157501,55.197498,52.727665,110773600,6827593226.167589,4825149600,28.952184470644276,48.0,0.5268963058270089,54.63384338154675,38.20452002909407,55.136154192307686,54.54140996123872,-61.79547997090593
2018-09-25,54.9375,55.705002,54.924999,55.547501,53.062012,98217600,6886145926.884893,4923367200,27.298638824291295,36.0,0.5260933103018175,56.5972553236633,52.79691868293669,55.180481153846145,54.615935223369185,-47.20308131706331
2018-09-26,55.25,55.9375,54.939999,55.105,52.639309,95938800,6821946439.304229,4827428400,26.01546420725012,36.0,0.4841695923228002,53.447793186096874,39.23367379810754,55.22817338461538,54.65216224386035,-60.76632620189246
2018-09-27,55.955002,56.610001,55.884998,56.237499,53.721146,120724800,6818615947.258265,4948153200,25.501183422629776,36.0,0.5361475729110623,59.63820754822376,73.94627618504941,55.323461884615384,54.76959459616699,-26.053723814950583
2018-09-28,56.197498,56.459999,56.005001,56.435001,53.909798,91717600,6900255452.124659,5039870800,25.023636979768025,32.0,0.5865162634242509,60.62166405952136,79.9999754789347,55.42625034615385,54.89295803348795,-20.000024521065306
2018-10-01,56.987499,57.355,56.587502,56.814999,54.272793,94403200,6861817074.939571,5134274000,25.38611008223214,28.000000000000004,0.64960819743402,62.51420771392687,84.7025169128944,55.539423346153846,55.035331438414765,-15.29748308710561
2018-10-02,56.8125,57.5,56.657501,57.32,54.755188,99152800,6918601862.633326,5233426800,25.840894368910575,36.0,0.7319212374994066,64.92667325160525,95.10203948354817,55.66557715384616,55.204566146680335,-4.897960516451834
2018-10-03,57.512501,58.3675,57.445,58.017502,55.421486,114619200,6946247640.927959,5348046000,26.90833515069144,40.0,0.8437117134765657,67.99080270599438,92.2950340770576,55.80144257692309,55.41293176544475,-7.704965922942403
2018-10-04,57.695,58.087502,56.682499,56.997501,54.447132,128168000,6875550231.860505,5219878000,26.78002461300545,39.99999999999999,0.840314294786566,59.76768666886517,69.84041163245165,55.88115419230769,55.5303072643007,-30.159588367548352
2018-10-05,56.990002,57.102501,55.145,56.072498,53.563511,134322000,6868516428.756446,5085556000,24.921094801607303,40.0,0.7542868551315962,53.45386137945633,49.47710500321526,55.89375030769231,55.57046954101917,-50.52289499678474
2018-10-08,55.552502,56.200001,55.049999,55.942501,53.439335,118655600,6934035048.125108,4966900400,23.179126361471923,40.0,0.6679204467964368,52.612676644923916,46.6153102070028,55.88163496153846,55.5980274268696,-53.3846897929972
2018-10-09,55.91,56.817501,55.5625,56.717499,54.179661,107564000,7024457045.643834,5074464400,22.075393605084475,40.0,0.6544660306159429,56.961041600388484,60.807567887783236,55.87432719230769,55.680951247101476,-39.192432112216764
2018-10-10,56.365002,56.587502,54.012501,54.09,51.66972,167962400,6866604869.319553,4906502000,21.345136392175796,40.0,0.42686545918545704,42.666321129335664,1.7795411663700291,55.758942576923076,55.56310300657544,-98.22045883362998
2018-10-11,53.630001,54.875,53.080002,53.612499,51.213596,212497600,6780184662.728571,4694004400,21.33032725777041,-24.0,0.20559011166373153,40.66886957268021,10.070869057539111,55.6395195,55.41861382090318,-89.92913094246089
2018-10-12,55.105,55.720001,54.209999,55.5275,53.0429,161351600,6900396788.275425,4855356000,20.509967288979812,-24.0,0.18264694068044918,50.64766588794063,46.288395759204136,55.63000019230769,55.426679463799246,-53.71160424079587
2018-10-15,55.290001,55.4575,54.317501,54.34,51.908531,123164000,6782094313.304833,4732192000,19.748204460817107,-24.0,0.06786073047211971,45.533488833200096,23.82975842260372,55.592115538461535,55.346184688703005,-76.17024157739628
2018-10-16,54.732498,55.747501,54.189999,55.537498,53.052456,116736000,6867350533.236493,4848928000,18.760145879054694,-24.0,0.07268207882204081,50.915968655350454,46.4774833011757,55.62884623076923,55.36035604509537,-53.522516698824305
2018-10-17,55.575001,55.66,54.834999,55.297501,52.823189,91541600,6878446804.180164,4757386400,17.84266291027531,-24.0,0.056486142870298295,49.85266589857939,41.938531229704424,55.60326926923077,55.35570011582905,-58.06146877029557
2018-10-18,54.465,54.935001,53.25,54.005001,51.58852,130325200,6864911631.397003,4627061200,18.233007916695733,-23.999999999999993,-0.05995211057189209,44.46688082876934,17.49407753913098,55.55471153846153,55.25564832947134,-82.50592246086902
2018-10-19,54.514999,55.314999,54.357498,54.827499,52.374218,132314800,6862493485.948383,4759376000,18.19425016284571,-24.0,-0.08488307141040252,48.29497296799385,33.04960115351349,55.486442230769235,55.22393356432532,-66.9503988464865
2018-10-22,54.947498,55.84,54.735001,55.162498,52.694225,115168400,6836436742.148615,4874544400,17.624658235199284,-24.0,-0.07672498008546569,49.812441613001795,39.3852820369861,55.45576911538462,55.219382781782706,-60.61471796301391
2018-10-23,53.9575,55.8125,53.674999,55.682499,53.19096,155071200,6972645344.122976,5029615600,17.873499119445412,-24.0,-0.02797739309202285,52.1595212484186,51.97198202695955,55.50240365384616,55.25368768683584,-48.02801797304045
2018-10-24,55.650002,56.057499,53.634998,53.772499,51.366425,163702000,6827526773.976669,4865913600,17.851076554529055,-24.0,-0.14183068085394268,44.01688658207942,17.215591601141572,55.47211511538462,55.14397000632948,-82.78440839885843
2018-10-25,54.427502,55.345001,54.1875,54.950001,52.491238,119423200,6865443065.559311,4985336800,17.830255601392437,-24.0,-0.13548388715340565,49.27430266073419,50.03343144707196,55.48586519230769,55.12960193178655,-49.96656855292804
2018-10-26,53.974998,55.047501,53.1675,54.075001,51.655399,189033600,6858907433.415286,4796303200,18.540814771285852,-24.000000000000007,-0.19876792186491343,45.830037364537866,26.622053945700053,55.44999984615384,55.051483344246805,-73.37794605429995
2018-10-29,54.797501,54.922501,51.522499,53.060001,50.68581,183742000,6841343978.300848,4612561200,20.114445407064824,-72.0,-0.32705293000793745,42.14950017322307,30.35540156639586,55.39788446153846,54.90396613356185,-69.64459843360414
2018-10-30,52.787498,53.794998,52.317501,53.325001,50.938957,146640000,6894690577.2584095,4759201200,21.575673854573868,-72.0,-0.40269442721393034,43.42692484789885,39.74646085997791,55.325865346153854,54.78700575329801,-60.253539140022085
2018-10-31,54.220001,55.112499,54.154999,54.715,52.266758,153435600,6920730882.084729,4912636800,21.51382707171595,-72.0,-0.3464854871079268,49.70088590113677,70.39693495038594,55.29384607692308,54.781671993794454,-29.60306504961406
2018-11-01,54.762501,55.59,54.202499,55.555,53.069176,233292800,7142253963.720561,5145929600,21.005756982305623,-72.0,-0.23149004415184038,53.08680462094939,88.91953693495037,55.31115376923078,54.838955549809675,-11.080463065049628
2018-11-02,52.387501,53.412498,51.357498,51.869999,49.549057,365314800,6959152497.36027,4780614800,22.069487317060712,-88.0,-0.4327160299366639,40.27758610249139,10.90427427568633,55.143173000000004,54.61903284241637,-89.09572572431367
2018-11-05,51.075001,51.0975,49.5425,50.397499,48.142448,264654800,6985532538.961815,4515960000,23.73099746138436,-92.0,-0.7029048674611076,36.4888164434901,13.123547678211557,54.91096138461538,54.30632663186701,-86.87645232178845
2018-11-06,50.48,51.18,50.422501,50.942501,48.663063,127531600,7033094059.876826,4643491600,25.19958857360708,-92.0,-0.8631050237271367,38.78404976031365,21.48889048179443,54.685096076923074,54.057154362839825,-78.51110951820557
2018-11-07,51.4925,52.514999,51.032501,52.487499,50.138924,133697600,7161831539.8631735,4777189200,25.421134007825025,-92.0,-0.8555343082805535,44.866854972275185,45.203368411875445,54.49923065384616,53.940883595222054,-54.79663158812455
2018-11-08,52.494999,52.529999,51.6875,52.122501,49.963989,101450400,7165143342.430536,4675738800,25.61458248085441,-88.0,-0.8689698069103784,43.76056374434137,39.600942379269775,54.27249984615384,53.80618858816857,-60.39905762073023
2018-11-09,51.387501,51.502499,50.5625,51.1175,49.000607,137463200,7190003881.072811,4538275600,26.295272574413996,-84.0,-0.9497644248464425,40.77901915279832,24.174984524172636,54.046345961538464,53.60702647052645,-75.82501547582736
2018-11-12,49.75,49.962502,48.447498,48.5425,46.532246,204542000,7011114485.401247,4333733600,27.691730264544468,-96.0,-1.207654630638558,34.325824048217655,1.2483835416052358,53.756730653846155,53.23187636159856,-98.75161645839475
2018-11-13,47.907501,49.294998,47.862499,48.057499,46.067333,187531600,6874638644.602475,4146202000,29.169654290731128,-100.0,-1.434632454200603,33.258275032267065,2.523454865939198,53.45346134615385,52.848589149628296,-97.4765451340608
2018-11-14,48.474998,48.619999,46.482498,46.700001,44.766037,243204000,6680929451.493326,3902998000,30.934139032952665,-100.0,-1.7044054332967917,30.407704829117236,2.388174056947784,53.06817296153846,52.39313817558176,-97.61182594305221
2018-11-15,47.0975,47.9925,46.724998,47.852501,45.870815,185915200,6825774985.197256,4088913200,32.572589150729804,-60.0,-1.8044052837761768,35.46495088835184,15.042576987630598,52.82826915384616,52.056794681094225,-84.9574230123694
2018-11-16,47.625,48.7425,47.365002,48.3825,46.378868,147713200,6896280447.690559,4236626400,33.403507024774115,-60.0,-1.8199105992939053,37.706829829259945,20.86194436191175,52.62711534615384,51.78462470471687,-79.13805563808825
2018-11-19,47.5,47.674999,46.247501,46.465,44.540783,167701200,6779682427.237992,4068925200,34.540040840338,-72.0,-1.9642818795508887,33.21160532369227,2.328060190319566,52.278557653846164,51.390578430293395,-97.67193980968044
2018-11-20,44.592499,45.3675,43.877499,44.244999,42.412708,271300800,6642211126.681281,3797624400,36.221638073342554,-76.0,-2.232102399643388,28.913866514211108,3.1376731579361197,51.89028838461539,50.861276250271665,-96.8623268420639
2018-11-21,44.932499,45.067501,44.137501,44.195,42.364784,124496800,6533108824.537625,3673127600,37.783121218275355,-76.0,-2.420484751286871,28.823399930728755,3.3298482779075287,51.45403846153847,50.3674780095108,-96.67015172209247
2018-11-23,43.735001,44.150002,43.025002,43.072498,41.288773,94496000,6446591814.788292,3578631600,39.490758988385345,-84.0,-2.6300382091125485,26.796333939293575,0.49969505513786533,50.98384603846154,49.82710911991741,-99.50030494486212
2018-11-26,43.560001,43.737499,42.564999,43.654999,41.847141,179994000,6601256168.732854,3758625600,41.177423250844505,-88.0,-2.717779007020276,29.56460044120948,10.938283993978894,50.58576903846154,49.36991577770131,-89.0617160060211
2018-11-27,42.877499,43.692501,42.720001,43.560001,41.756084,165549600,6721694566.676298,3593076000,42.74361149455659,-88.0,-2.7631281449021614,29.369537555474025,9.984967385850476,50.15240373076923,48.9395517200938,-90.01503261414953
2018-11-28,44.182499,45.322498,43.732498,45.235001,43.361713,184250000,6885666173.909001,3777326000,42.66352455670331,-88.0,-2.6335512227879434,37.23308396305599,26.793798294029077,49.770576923076916,48.66514055564241,-73.20620170597091
2018-11-29,45.665001,45.700001,44.424999,44.887501,43.028606,167080000,6839801409.900788,3610246000,42.2674303590126,-88.0,-2.5297396601880564,36.32941474930019,25.986036363636366,49.355384692307695,48.3853154033726,-74.01396363636364
2018-11-30,45.072498,45.0825,44.2575,44.645,42.796154,158126000,6830218015.961395,3452120000,41.966865497770854,-64.0,-2.438921681966626,35.67863781672931,28.117609414960736,49.00432703846154,48.10825500312278,-71.88239058503926
2018-12-03,46.115002,46.235001,45.302502,46.205002,44.29155,163210000,6982926907.027231,3615330000,40.70312698400714,-64.0,-2.2155294120556306,42.77965444722295,54.086233890970874,48.667980923076925,47.96727329918776,-45.91376610902913
2018-12-04,45.237499,45.5975,44.067501,44.172501,42.343216,165377200,6840248553.235627,3449952800,40.088514170557936,-64.0,-2.177395611845526,37.04182118688846,26.02188166379895,48.28711553846154,47.68617905480348,-73.97811833620105
2018-12-06,42.939999,43.695,42.605,43.68,41.871113,172393600,7007897375.253976,3277559200,40.08247415711776,-64.0,-2.161992906702622,35.789189073078916,18.04938598957733,47.92634626923078,47.38942505074397,-81.95061401042267
2018-12-07,43.372501,43.622501,42.075001,42.122501,40.378105,169126400,6849153532.927643,3108432800,40.2631195124959,-96.0,-2.249532098893191,32.093055779563755,0.712411055479715,47.495480884615375,46.99928252846664,-99.2875889445203
2018-12-10,41.25,42.522499,40.8325,42.400002,40.644112,248104000,7061290652.843098,3356536800,40.83618112851157,-100.0,-2.2703444107360156,33.41255630838219,22.908326329313287,47.02182711538462,46.658595081913546,-77.0916736706867
2018-12-11,42.915001,42.947498,41.75,42.157501,40.411663,189126800,7000881161.97731,3167410000,40.99607960732428,-96.0,-2.2801222914022077,32.81253207497235,24.525696524628163,46.506538692307686,46.3251807054755,-75.47430347537183
2018-12-12,42.599998,42.98,42.255001,42.275002,40.524296,142510800,6866233430.783751,3309920800,41.11506327514526,-80.0,-2.2524254253554687,33.43628038491764,26.700633650970154,46.13750034615384,46.025167468032876,-73.29936634902984
2018-12-13,42.622501,43.142502,42.387501,42.737499,40.967648,127594400,6856937641.808637,3437515200,41.06962600412818,-80.0,-2.168162588135317,35.95655482400153,35.26142799418267,45.842884961538466,45.78163647040081,-64.73857200581733
2018-12-14,42.25,42.27,41.32,41.369999,39.656776,162814800,6711260899.040636,3274700400,41.442701394666415,-80.0,-2.186524609251883,32.08794241785182,9.949077288463204,45.47471180769231,45.45484850963038,-90.0509227115368
2018-12-17,41.362499,42.087502,40.682499,40.985001,39.28772,177151600,6610392002.071447,3097548800,42.015868920958404,-100.0,-2.2067052399357863,31.07427842117565,5.448030455459486,45.03230803846154,45.123748694102204,-94.55196954454051
2018-12-18,41.345001,41.8825,41.0975,41.517502,39.798161,135366000,6619876933.872722,3232914800,42.54809590965811,-96.0,-2.154889925059237,34.171775674414064,15.038319662019047,44.62442346153846,44.856619309353896,-84.96168033798095
2018-12-19,41.5,41.862499,39.772499,40.2225,38.556789,196189200,6508171309.17339,3036725600,43.49242780059183,-100.0,-2.1930417333461634,30.57338858762894,6.963262835353763,44.20538500000001,44.51335121236472,-93.03673716464623
2018-12-20,40.099998,40.5275,38.825001,39.2075,37.583824,259092000,6365499267.021237,2777633600,44.6461330790624,-100.0,-2.2789094836182997,28.077743508368187,5.161929824561444,43.84634653846154,44.120325196634,-94.83807017543856
2018-12-21,39.215,39.540001,37.407501,37.682499,36.121986,382978400,6081295351.469724,2394655200,46.074014964885386,-92.0,-2.4418668095167675,24.801967824037604,3.1152421410364965,43.44730807692308,43.643449182068515,-96.88475785896351
2018-12-24,37.037498,37.887501,36.647499,36.7075,35.187355,148676800,5947006845.483443,2245978400,47.568299227117954,-96.0,-2.6194900841150925,22.957798013689313,0.6704021597316,43.06298111538462,43.129675168581954,-99.32959784026839
2018-12-26,37.075001,39.307499,36.68,39.2925,37.66531,234330000,6178661513.793497,2480308400,47.54505678814263,-96.0,-2.5225910532834135,36.44970657322665,37.531048239652534,42.73375030769231,42.84543997090922,-62.468951760347466
2018-12-27,38.959999,39.192501,37.517502,39.037498,37.420864,212468400,6351806619.385321,2267840000,47.523474523379825,-92.0,-2.4382675726798695,35.783972213035284,34.26520881284331,42.37432715384615,42.56337019528632,-65.73479118715669
2018-12-28,39.375,39.630001,38.637501,39.057499,37.440041,169165600,6325813238.365271,2437005600,47.076972830423465,-56.0,-2.3428201212362936,35.882889838503246,37.10544860410376,42.089423269230764,42.30367603267252,-62.89455139589624
2018-12-31,39.6325,39.84,39.119999,39.435001,37.801907,140014000,6308312096.064078,2577019600,46.45519860583632,-56.0,-2.2112264299772306,37.82944719079238,42.9176399148699,41.90442334615385,42.09118158580789,-57.0823600851301
2019-01-02,38.7225,39.712502,38.557499,39.48,37.845043,148158800,6396822189.839765,2725178400,46.1239531273446,-56.0,-2.079337134204728,38.07080258247723,43.6104648450508,41.72307719230769,41.8977607275999,-56.3895351549492
2019-01-03,35.994999,36.43,35.5,35.547501,34.075397,365248800,6068884536.611375,2359929600,46.841121817957344,-80.0,-2.2660125391213697,27.883314481300133,0.6215372923683488,41.433654230769235,41.42737111814806,-99.37846270763164
2019-01-04,36.1325,37.137501,35.950001,37.064999,35.530052,234428400,6274687205.484133,2594358000,46.861323860134064,-80.0,-2.265390722014793,35.1003916337925,23.116676514032488,41.18019269230769,41.10423244272968,-76.88332348596751
2019-01-07,37.174999,37.2075,36.474998,36.982498,35.45097,219111200,6359190013.363974,2375246800,46.815660279577195,-80.0,-2.2456684012388237,34.89592798332717,22.504706639937254,40.9272118076923,40.798918780305264,-77.49529336006275
2019-01-08,37.389999,37.955002,37.130001,37.6875,36.12677,164101200,6416873404.894893,2539348000,46.08541998577626,-80.0,-2.1483853020412482,38.208379662184775,34.27340383862123,40.63692330769231,40.56844331509747,-65.72659616137877
2019-01-09,37.822498,38.6325,37.407501,38.327499,36.740269,180396400,6507439392.957578,2719744400,44.81805676527817,-80.0,-1.9966292750113368,41.13632138120699,44.440069853056215,40.38461553846154,40.40244743990506,-55.559930146943785
2019-01-10,38.125,38.4925,37.715,38.450001,36.8577,143122800,6634915695.524266,2862867200,43.641219489101374,-80.0,-1.84520625354903,41.705708242461796,58.67729487817003,40.14634634615384,40.25782177768987,-41.32270512182997
2019-01-11,38.220001,38.424999,37.877499,38.072498,36.495827,108092800,6603820111.623629,2754774400,42.548442018365776,-76.0,-1.7356561911093422,40.40854345761173,59.27414746543781,39.83355773076923,40.095945942305434,-40.725852534562186
2019-01-14,37.712502,37.817501,37.305,37.5,35.947048,129756800,6572804878.957156,2625017600,41.84044109707769,-72.0,-1.6757161685015092,38.45513852809642,46.08294930875572,39.57692307692308,39.90365365028281,-53.91705069124428
2019-01-15,37.567501,38.3475,37.512501,38.267502,36.682751,114843600,6665643043.470887,2739861200,40.6489052995099,-68.0,-1.5484329010053202,42.470286192672866,63.76732718894006,39.36875007692308,39.782457231743344,-36.23267281105995
2019-01-16,38.27,38.970001,38.25,38.735001,37.130894,122278800,6708101070.999736,2862140000,38.94741769365748,-52.0,-1.3937702167731985,44.83124682789167,74.53919354838696,39.238461615384615,39.704867881243835,-25.460806451613035
2019-01-17,38.549999,39.415001,38.314999,38.965,37.351368,119284800,6729789177.021362,2981424800,36.960694993561,-52.0,-1.2383648292207,46.005273128438006,79.83870967741937,39.106346153846154,39.65006285300355,-20.16129032258063
2019-01-18,39.375,39.470001,38.994999,39.205002,37.581421,135004000,6714158337.605948,3116428800,35.06470998407925,-52.00000000000001,-1.0833505930559681,47.266362833424665,85.3687096774193,38.9927885,39.61709538241069,-14.631290322580703
2019-01-22,39.102501,39.182499,38.154999,38.325001,36.737869,121576000,6632812338.875049,2994852800,33.917550805415274,-52.0,-1.0197543271940788,43.27530721958385,67.06230643926104,38.840865384615384,39.5213846874173,-32.937693560738964
2019-01-23,38.537498,38.785,37.924999,38.48,36.886459,92522400,6659708461.696301,3087375200,33.01137103226205,-48.0,-0.9459424684453737,44.16951290327248,75.06295338464635,38.67711542307693,39.44424508094195,-24.93704661535364
2019-01-24,38.5275,38.619999,37.935001,38.174999,36.594093,101766000,6629252557.39877,2985609200,32.16991838576262,-44.0,-0.9016632575346151,42.74169105001757,63.21017045454538,38.55423080769231,39.35022685272403,-36.78982954545462
2019-01-25,38.869999,39.532501,38.580002,39.439999,37.806702,134142000,6737340139.9474125,3119751200,30.416255058810286,-40.0,-0.75578452240471,49.965916770578396,96.97459004946182,38.49480765384615,39.356876641411134,-3.02540995053817
2019-01-28,38.947498,39.0825,38.415001,39.075001,37.456814,104768400,6839754504.26616,3014982800,28.929048956771844,-36.0,-0.6619957866487454,48.08092170976677,80.9573361082205,38.40086530769231,39.33599696426957,-19.0426638917795
2019-01-29,39.0625,39.532501,38.5275,38.669998,37.068588,166348800,6720578535.54175,2848634000,27.085189985735806,-32.0,-0.6132784035163183,46.00690700018192,61.27934398233705,38.34115369230769,39.28666370765701,-38.72065601766295
2019-01-30,40.8125,41.537498,40.057499,41.3125,39.601654,244439200,6890695616.240859,3093073200,26.555881655764185,72.0,-0.357322705580458,58.56554287468858,94.68403765341414,38.42211523076923,39.43672565523797,-5.315962346585855
2019-01-31,41.5275,42.25,41.139999,41.610001,39.886837,162958400,6865738486.360074,3256031600,26.511824854593588,76.0,-0.1289832874759469,59.70198087964493,87.05765419615769,38.573173000000004,39.59770901410923,-12.942345803842327
2019-02-01,41.740002,42.244999,41.482498,41.630001,39.906013,130672400,6785622271.905273,3386704000,26.470914967792318,76.0,0.05298045363129944,59.781841471920806,87.46210313447928,38.76249996153847,39.74824916121225,-12.537896865520727
2019-02-04,41.852501,42.915001,41.82,42.8125,41.039532,125982000,6888018392.107904,3512686000,26.847581107581735,84.0,0.28927127696453425,64.28811060349526,98.10271170754288,38.897884576923076,39.97523070482616,-1.8972882924571346
2019-02-05,43.215,43.77,43.087502,43.544998,41.741695,144406400,6937210655.765233,3657092400,27.67145340847416,88.0,0.5295357650237449,66.77177244351319,96.15052247210902,39.07124996153846,40.23965791187607,-3.849477527890985
2019-02-06,43.662498,43.892502,43.212502,43.560001,41.756084,112958400,6939702052.946409,3770050800,28.501542147862875,92.0,0.712939397947359,66.82266771656043,94.42813853633587,39.24442311538461,40.4856092517371,-5.571861463664125
2019-02-07,43.099998,43.485001,42.584999,42.735001,40.965237,126966800,6855057989.859437,3643084000,28.522143917172748,92.0,0.7826950716288437,61.265578913289225,80.60326069379431,39.3713461923077,40.65223086271954,-19.39673930620568
2019-02-08,42.247501,42.665001,42.105,42.602501,41.013371,95280000,6929070170.694828,3547804000,28.003293970567626,92.0,0.8178575501926488,60.396849698605315,78.38290152514371,39.49144238461538,40.796695317332905,-21.617098474856295
2019-02-11,42.762501,42.802502,42.3125,42.357498,40.777519,83973600,6860519544.694118,3463830400,27.621176976228206,88.0,0.8165417878116727,58.738296375935334,74.27728146931807,39.75336534615384,40.9123103308638,-25.722718530681938
2019-02-12,42.525002,42.75,42.424999,42.7225,41.12891,89134000,6934569375.722328,3552964400,27.266354052913034,84.0,0.8353225689911099,60.479486735169765,80.36085936032569,39.97096153846154,41.04639845450352,-19.639140639674313
2019-02-13,42.8475,43.119999,42.48,42.544998,40.958019,89960800,6862881329.518507,3463003600,27.226406680513815,80.0,0.8263578070206918,59.17179160131838,75.39929248757782,40.184903846153844,41.157405828243995,-24.600707512422176
2019-02-14,42.427502,42.814999,42.345001,42.700001,41.107243,87342800,6907482469.705486,3550346400,27.006705104557856,64.0,0.8222818618071557,59.98544223804271,78.22910484178826,40.37769234615385,41.27167213726296,-21.770895158211733
2019-02-15,42.8125,42.924999,42.4375,42.605,41.015774,98507200,6876667535.740903,3451839200,26.89694948056183,64.0,0.8021392966192593,59.206651280589625,76.00183560043399,40.542211615384616,41.370437164132376,-23.998164399566004
2019-02-19,42.427502,42.860001,42.372501,42.732498,41.138523,75891200,6912860866.31075,3527730400,26.69690385852847,64.0,0.7873876766387795,59.958015495833266,69.75220097611395,40.70692303846154,41.47133055938183,-30.247799023886046
2019-02-20,42.797501,43.330002,42.747501,43.0075,41.403275,104457600,6901652450.577902,3632188000,26.93710288850531,64.0,0.7887945421624707,61.60087215778615,67.84737382665882,40.89673080769231,41.58512088831651,-32.15262617334117
2019-02-21,42.950001,43.092499,42.575001,42.764999,41.169819,68998800,6883319098.569586,3563189200,26.880350956552224,60.0,0.7615628665224818,59.29075797068534,53.21572080378303,41.099230769230765,41.67251926695973,-46.78427919621697
2019-02-22,42.895,43.25,42.845001,43.2425,41.629509,75652800,6956169936.095604,3638842000,26.97939059981287,40.00000000000001,0.7696399768726607,62.28959725790109,68.63684570630086,41.29057684615385,41.788814136073825,-31.363154293699143
2019-02-25,43.540001,43.967499,43.487499,43.557499,41.932755,87493600,6894195302.762271,3726335600,27.704956369858934,88.0,0.7923254966413467,64.16496967807726,77.98656536191447,41.47605753846154,41.91982782969799,-22.01343463808553
2019-02-26,43.427502,43.825001,43.2925,43.5825,41.956829,68280800,6900285938.684458,3794616400,28.03655370133848,88.0,0.8030640833929823,64.31664847695839,79.32890165310191,41.653653692307685,42.04298873120184,-20.67109834689809
2019-02-27,43.302502,43.75,43.182499,43.717499,42.086788,111341600,6998874386.384813,3905958000,28.148040725835365,88.0,0.8130949296127241,65.17384516793236,86.57717400116725,41.82721126923077,42.16702652889059,-13.422825998832753
2019-02-28,43.580002,43.727501,43.23,43.287498,41.672829,112861600,6912100437.572651,3793096400,28.25156439143962,88.0,0.7773857415556691,60.21222915181629,63.48985959187107,42.01807653846154,42.25002441563944,-36.51014040812893
2019-03-01,43.57,43.787498,43.2225,43.7425,42.110851,103544800,6999152050.303316,3896641200,28.412931609776347,84.0,0.7768458165359888,63.38835412598412,86.40488604524853,42.220480384615385,42.3605781626291,-13.595113954751472
2019-03-04,43.922501,44.4375,43.4925,43.962502,42.322655,109744800,6998571854.51411,4006386000,29.21528556751073,96.0,0.7851198716739987,64.84944803552726,77.29996525685316,42.44307665384615,42.47923918761954,-22.700034743146837
2019-03-05,43.985001,44.0,43.634998,43.8825,42.245636,78949600,7026691168.652662,3927436400,29.960328528264085,96.0,0.776273232575015,63.851543093652246,73.4766898335435,42.613942076923074,42.58318443298106,-26.5233101664565
2019-03-06,43.6675,43.872501,43.485001,43.630001,42.002548,83241600,7005746508.007502,3844194800,30.31313876690569,92.0,0.7403533161006024,60.67790799774972,61.40982624125501,42.789134384615394,42.66072640090838,-38.59017375874499
2019-03-07,43.467499,43.610001,43.005001,43.125,41.516388,99185600,6945906933.840229,3745009200,29.630466910378367,88.0,0.6634888765140943,54.810251925176935,36.44064718675409,42.96048061538462,42.69511703787813,-63.55935281324591
2019-03-08,42.580002,43.267502,42.375,43.227501,41.615074,95997600,7033299511.111764,3841006800,27.883271017681796,84.0,0.6038830406384577,55.745679726583106,41.404378404057184,43.0341345,42.73455288692419,-58.595621595942816
2019-03-11,43.872501,44.779999,43.837502,44.724998,43.056705,128044000,7146399064.510874,3969050800,27.95569534129145,100.0,0.6697599038055344,66.61767917464428,97.71305518214363,43.15394207692308,42.88199326567055,-2.2869448178563596
2019-03-12,45.0,45.6675,44.842499,45.227501,43.540459,129870400,7137741520.5942,4098921200,28.716327488184756,100.0,0.7538259486936454,69.33967746160373,86.63632498101744,43.292307461538456,43.05573457932458,-13.363675018982557
2019-03-13,45.5625,45.825001,45.23,45.427502,43.733006,124130000,7096017846.835669,4223051200,29.534144009923818,88.0,0.827053545700636,70.37507417969492,88.47829319469754,43.39288446153846,43.231421054930166,-11.521706805302472
2019-03-14,45.974998,46.025002,45.639999,45.932499,44.219166,94318000,7145013093.745432,4317369200,30.437171924727856,92.0,0.9152851439744794,72.86665361827627,97.46567262154925,43.48471142307692,43.43150090271312,-2.5343273784507696
2019-03-15,46.212502,46.8325,45.935001,46.529999,44.794392,156171600,7195909779.407698,4473540800,31.802265401011507,96.0,1.021645682291883,75.49294215144332,93.2136623667974,43.59894211538462,43.66101928028993,-6.78633763320261
2019-03-18,46.450001,47.0975,46.447498,47.005001,45.251652,104879200,7270939160.112373,4578420000,33.2252243401664,100.0,1.1312257999788358,77.36835709574251,98.04131286394924,43.763172884615386,43.90872162989808,-1.958687136050749
2019-03-19,47.087502,47.247501,46.48,46.6325,44.893055,126585600,7194657869.8136,4451834400,34.634851176988455,100.0,1.1744725269417842,72.67170659358608,87.37812470433562,43.918172846153844,44.110482990646375,-12.621875295664372
2019-03-20,46.557499,47.372501,46.182499,47.040001,45.285355,124140800,7249425986.406344,4575975200,35.37716791905358,92.0,1.227478190209716,74.49570365420274,93.346674667999,44.09826911538461,44.32748432467257,-6.653325332000997
2019-03-21,47.505001,49.0825,47.452499,48.772499,46.953232,204136800,7375915457.187774,4780112000,37.02067397928486,96.0,1.3932234569841953,80.46532262515399,95.37829295564667,44.330961384615385,44.65674467099312,-4.62170704435333
2019-03-22,48.834999,49.422501,47.695,47.762501,45.980904,169630800,7219541087.87094,4610481200,38.693805715777515,100.0,1.4266340283091097,70.15599152208003,76.44555140893208,44.531634576923075,44.886800695364,-23.554448591067917
2019-03-25,47.877499,47.994999,46.650002,47.185001,45.42495,175381200,7183682528.61854,4435100000,38.63516724180262,92.0,1.3904840881413492,65.02590932878758,68.2511573960756,44.704134576923074,45.05703775496667,-31.748842603924402
2019-03-26,47.915001,48.220001,46.145,46.697498,44.955624,199202000,7090561158.55173,4235898000,37.908878930142336,92.0,1.3074263847262486,60.972648042380584,61.333769232526606,44.86153834615384,45.17855332867285,-38.66623076747339
2019-03-27,47.1875,47.439999,46.637501,47.1175,45.359962,119393600,7113993605.735399,4355291600,37.234468355029215,40.0,1.260957672538055,63.10632577258924,67.29335689345773,45.03019226923077,45.32217900803041,-32.70664310654228
2019-03-28,47.237499,47.389999,46.8825,47.18,45.420135,83121600,7128325108.106044,4438413200,36.60822996385275,40.0,1.2151664288289155,63.4267582579065,59.847781530489115,45.19067303846154,45.45979537780594,-40.15221846951089
2019-03-29,47.4575,47.52,47.134998,47.487499,45.71616,94256000,7206667350.484004,4532669200,36.136389974209855,40.0,1.1899718825744188,65.0357620605062,57.751066484250515,45.37230765384615,45.60999564611661,-42.24893351574949
2019-04-01,47.91,47.919998,47.095001,47.810001,46.026638,111448000,7288396586.280013,4644117200,36.030232045121025,40.0,1.1823982878442578,66.69088441103152,61.53847071235053,45.54798076923077,45.77295900566353,-38.461529287649476
2019-04-02,47.772499,48.615002,47.762501,48.505001,46.695705,91062800,7355959122.789883,4735180000,36.44751072181761,40.0,1.2184315308580196,69.98802652077184,75.74356867491417,45.738269307692306,45.97533248672549,-24.25643132508584
2019-04-03,48.3125,49.125,48.287498,48.837502,47.015812,93087200,7385136305.08103,4828267200,37.16846405617265,40.0,1.2593017408447764,71.44435509813223,83.22583512544813,45.94038476923077,46.187345043264344,-16.77416487455188
2019-04-04,48.697498,49.092499,48.285,48.922501,47.097641,76457200,7429401338.686769,4904724400,37.83348801513541,40.0,1.2837520906538344,71.82079794808514,84.74447452495055,46.14057715384615,46.38994918820773,-15.255525475049465
2019-04-05,49.112499,49.275002,48.982498,49.25,47.412918,74106400,7490839137.827976,4978830800,38.57428209871244,40.0,1.3144039705252837,73.28226032372851,94.73681320005707,46.36990415384616,46.601804803896044,-5.263186799942921
2019-04-08,49.105,50.057499,49.084999,50.025002,48.159012,103526800,7587447047.504891,5082357600,39.7416178665287,84.0,1.3852635348630216,76.40132319522074,99.16940553850621,46.61153884615384,46.85537496657041,-0.8305944614937757
2019-04-09,50.080002,50.712502,49.807499,49.875,48.014606,143072800,7465716844.32015,4939284800,41.16241811517995,88.0,1.4130278370095368,74.5863807453159,81.66389418110816,46.83894261538462,47.079050894972596,-18.336105818891838
2019-04-10,49.669998,50.185001,49.544998,50.154999,48.284161,86781200,7544361802.5762825,5026066000,41.98919939817831,88.0,1.4410137166170927,75.74466046105549,87.79413780223841,47.080192576923075,47.3068989027524,-12.205862197761586
2019-04-11,50.212502,50.25,49.610001,49.737499,47.882236,83603200,7494068782.103438,4942462800,42.795367927571355,88.0,1.413213323527664,70.57920770766137,78.65347404336109,47.315096346153844,47.48694335440037,-21.346525956638914
2019-04-12,49.799999,50.035,49.052502,49.717499,47.862988,111042800,7533343089.866712,4831420000,42.50197093202526,88.0,1.3737319520356266,70.33176986756416,78.21559793515132,47.568653999999995,47.65216969851886,-21.784402064848678
2019-04-15,49.645,49.962502,49.502499,49.807499,47.949615,70146400,7556216309.303976,4901566400,42.22953086473245,84.0,1.3343236757722323,70.82740445454722,77.79134287329008,47.82173084615385,47.811823720850796,-22.208657126709923
2019-04-16,49.865002,50.342499,49.639999,49.8125,47.954433,102785600,7503909339.298567,5004352000,42.28298423711026,80.0,1.288641218007207,70.85653912559076,76.50126553458718,48.01740399999999,47.96002196375074,-23.498734465412827
2019-04-17,49.884998,50.845001,49.6525,50.782501,48.88826,115627200,7607416297.889964,5119979200,42.70170088177621,100.0,1.3155437457638683,75.88679423549334,98.33333333333333,48.23105784615385,48.16909448495439,-1.6666666666666667
2019-04-18,50.779999,51.037498,50.630001,50.965,49.063953,96783200,7669762000.516488,5216762400,43.223984476302846,100.0,1.3361875980431535,76.70158890859707,98.1611146438413,48.44403853846154,48.37619859717999,-1.838885356158699
2019-04-22,50.7075,51.235001,50.584999,51.1325,49.225197,77758000,7722996159.795999,5294520400,43.845684266137724,100.0,1.3504961706489311,77.45458121922158,97.04820734341263,48.64403857692308,48.58036907146296,-2.9517926565873784
2019-04-23,51.107498,51.9375,50.974998,51.869999,49.935184,93292000,7803202881.444369,5387812400,44.862211098557374,76.0,1.4051481500905112,80.45050696246344,98.15192334017797,48.84942319230769,48.824045362465704,-1.8480766598220388
2019-04-24,51.84,52.119999,51.762501,51.790001,49.858185,70162400,7743834757.21654,5317650000,45.909591271661725,80.0,1.425571961332885,79.22076456976107,91.39509553979015,49.03346165384615,49.04374578006084,-8.604904460209848
2019-04-25,51.7075,51.939999,51.279999,51.32,49.405712,74172800,7678652824.406844,5243477200,45.861609422903314,80.0,1.3878347312654213,72.23465638731979,74.50203203122486,49.21375011538461,49.212357203760035,-25.497967968775136
2019-04-26,51.224998,51.25,50.529999,51.075001,49.169846,74596400,7716987343.093902,5168880800,44.46448332222716,80.0,1.3229086651867519,68.82737727507192,65.93320221666073,49.368942423076916,49.35033081829633,-34.06679778333927
2019-04-29,51.099998,51.4925,50.965,51.1525,49.244461,88818800,7691309870.10812,5257699600,43.395759331353034,80.0,1.263147038883666,69.32035679165068,68.45965945524982,49.46048092307693,49.48382483175586,-31.540340544750187
2019-04-30,50.764999,50.849998,49.7775,50.1675,48.296192,186139600,7640544777.100205,5071560000,40.679680020724,80.0,1.1233549152686138,56.985252555622765,36.34878860517219,49.552980884615394,49.534467436810985,-63.65121139482781
2019-05-01,52.470001,53.827499,52.307499,52.630001,50.666843,259309200,7491272071.334942,5330869200,40.42018386429548,100.0,1.1974682324902304,70.9178787122122,74.92149209727249,49.76240396153847,49.763766219269435,-25.07850790272751
2019-05-02,52.459999,53.162498,52.032501,52.287498,50.337116,127985200,7421049576.97823,5202884000,39.86380649258233,96.0,1.214565683504425,67.63640614560464,67.74864989443968,49.977403961538464,49.950709314138365,-32.25135010556031
2019-05-03,52.7225,52.959999,52.557499,52.9375,50.962872,83569600,7495276407.1377325,5286453600,39.34717036170583,92.0,1.2659719293588054,70.43256410446236,79.4219884393063,50.20125011538461,50.17195306864664,-20.5780115606937
2019-05-06,51.072498,52.209999,50.875,52.119999,50.175861,129772400,7607551391.783863,5156681200,37.104514487963975,84.0,1.2266066925853565,63.05393870412493,59.22388059701485,50.39125007692307,50.316252767265404,-40.77611940298515
2019-05-07,51.470001,51.855,50.2075,50.715,48.823277,155054800,7548023524.7125435,5001626400,34.45422975900446,84.0,1.0697068667077474,52.81348506046093,25.44910789200189,50.51538473076923,50.34578959931982,-74.55089210799811
2019-05-08,50.474998,51.334999,50.4375,50.724998,48.832897,105358000,7510164684.675953,5106984400,31.99325108211349,80.0,0.9353868223112443,52.87214025689986,23.3950181222266,50.627500000000005,50.37387911048132,-76.6049818777734
2019-05-09,50.099998,50.419998,49.165001,50.18,48.308235,139634400,7596393416.405511,4967350000,30.708286390920556,72.0,0.7760150174728295,49.27635593981093,21.769424887688995,50.69192303846153,50.35951769489011,-78.23057511231102
2019-05-10,49.355,49.712502,48.192501,49.294998,47.638988,164834800,7670676712.374659,4802515200,30.14988835904078,-28.0,0.5717091416880606,44.03871838801598,19.565171096777657,50.709519038461536,50.280664384157504,-80.43482890322234
2019-05-13,46.927502,47.369999,45.712502,46.43,44.870235,229722400,7639838971.056031,4572792800,30.848963248608054,-32.0,0.1765783826921492,32.1318541994096,8.841629885999945,50.613653615384614,49.99542998533102,-91.15837011400006
2019-05-14,46.602501,47.424999,46.352501,47.165001,45.580555,146118800,7715112705.121362,4718911600,31.445607189258926,-32.0,-0.07637672914444238,36.84912078329307,17.89894685112016,50.53346134615385,49.7857685790102,-82.10105314887984
2019-05-15,46.567501,47.9375,46.505001,47.73,46.126572,106178800,7790531133.211852,4825090400,31.501830114205863,-32.0,-0.22861939819995314,40.285107851294505,24.861352382508528,50.445192038461535,49.633489425009444,-75.13864761749147
2019-05-16,47.477501,48.1175,47.209999,47.52,45.923626,132125600,7748673352.477285,4692964800,31.378500846608258,-31.999999999999993,-0.36204463010157184,39.426457841832324,22.273551056149522,50.35461511538462,49.476934652786525,-77.72644894385049
2019-05-17,46.732498,47.724998,46.689999,47.25,45.662685,131516400,7759474607.888353,4561448400,31.538152371116894,-32.0,-0.4839926650090831,38.296253199012135,18.94637792225923,50.24288438461539,49.311976530357896,-81.05362207774077
2019-05-20,45.880001,46.087502,45.07,45.772499,44.234837,154449200,7818293605.004036,4406999200,32.42122230658801,-52.0,-0.6918837389108816,32.76167937655488,8.021685186604108,50.09038438461538,49.049793009590644,-91.9783148133959
2019-05-21,46.305,47.0,46.174999,46.650002,45.082863,113459200,7835485059.676212,4520458400,32.35803114637253,-52.0,-0.776876406624126,38.45092805669889,19.524280389071464,49.97240373076924,48.87203071258393,-80.47571961092854
2019-05-22,46.165001,46.427502,45.637501,45.695,44.159931,118994400,7733812306.118685,4401464000,32.55212429049711,-52.0,-0.9107953068937817,34.98179828943998,7.9214205223600125,49.814230692307696,48.63669510424438,-92.07857947763998
2019-05-23,44.950001,45.134998,44.452499,44.915001,43.406139,146118800,7785731121.522075,4255345200,33.23926520140486,-64.0,-1.067560230958108,32.40983378315161,5.961998066387284,49.625865346153844,48.36101405948554,-94.03800193361272
2019-05-24,45.049999,45.535,44.654999,44.7425,43.239433,94858800,7709736481.582803,4160486400,33.489226304324355,-64.0,-1.1919765876357644,31.852079536374944,3.9176083866790004,49.393557615384616,48.09297598100513,-96.08239161332101
2019-05-28,44.73,45.147499,44.477501,44.557499,43.06065,111792800,7624639881.912954,4048693600,33.802377140479564,-64.0,-1.2906279259144355,31.23131976967298,1.525608427170314,49.14711526923077,47.831088797226975,-98.47439157282969
2019-05-29,44.105,44.837502,44.0,44.345001,42.855286,113924800,7604575562.066555,3934768800,34.312353389127374,-76.0,-1.370162257318924,30.496135786718497,5.3738490261212455,48.88605761538462,47.57286007150646,-94.62615097387875
2019-05-30,44.487499,44.807499,44.1675,44.575001,43.077553,84873600,7627783621.174148,4019642400,34.785902762871764,-76.0,-1.3985135168829075,32.35230005126836,10.065659495611559,48.60548076923077,47.350796436580055,-89.93434050438843
2019-05-31,44.057499,44.497501,43.747501,43.767502,42.297188,108174400,7525378810.972548,3911468000,35.42798575770719,-84.0,-1.4692044408503264,29.385182892454992,0.45768889191966866,48.296923115384615,47.085367219055605,-99.54231110808033
2019-06-03,43.900002,44.48,42.567501,43.325001,41.869545,161584400,7491794669.273336,3749883600,36.533221990477294,-88.0,-1.5431452224105513,27.876411810242544,13.64865110786507,47.98942315384616,46.806821573199635,-86.35134889213492
2019-06-04,43.860001,44.9575,43.630001,44.91,43.401302,123872000,7606801999.69543,3873755600,36.995325936154906,-88.0,-1.4570516669673097,39.79963096245909,42.207196794089455,47.75230773076923,46.66631627148114,-57.79280320591055
2019-06-05,46.07,46.247501,45.285,45.634998,44.101944,119093600,7574321342.046245,3992849200,36.07447983917456,-88.0,-1.3151602754722589,44.332859498850574,55.27022617481558,47.540096115384614,46.5899223254455,-44.72977382518442
2019-06-06,45.77,46.3675,45.537498,46.305,44.749439,90105200,7650856514.504143,4082954400,35.103580010609896,-88.0,-1.135556771873894,48.213878926268954,72.46730342257106,47.39153842307692,46.568816968005095,-27.532696577428933
2019-06-07,46.627499,47.98,46.442501,47.537498,45.940533,122737600,7702944789.236029,4205692000,32.81081088798063,-84.0,-0.8835820294891406,54.498351589162574,91.82444190751818,47.19567292307692,46.64057111852323,-8.175558092481824
2019-06-10,47.952499,48.842499,47.904999,48.145,46.527634,104883600,7651761816.18771,4310575600,30.86994451420818,-80.0,-0.627634911900067,57.25205327669411,88.88447454485254,47.036346076923074,46.752010294928915,-11.115525455147457
2019-06-11,48.715,49.0,48.400002,48.702499,47.066387,107731600,7652658864.300538,4418307200,29.177131996316223,-76.0,-0.37548115410919536,59.66450282058722,95.3750323163673,46.87346142307692,46.89649093974899,-4.624967683632705
2019-06-12,48.487499,48.9925,48.3475,48.547501,46.916607,73012800,7624925546.510771,4345294400,27.56088053961139,-72.0,-0.18601031647693134,58.673103257091604,92.96542447966173,46.73605765384615,47.01878798124907,-7.034575520338255
2019-06-13,48.674999,49.197498,48.400002,48.537498,46.90694,86698400,7568122426.753931,4258596000,26.218836594079523,-68.0,-0.03624268794479235,58.60542341088882,90.04524436436392,46.652307576923086,47.13128501967506,-9.954755635636085
2019-06-14,47.887501,48.397499,47.575001,48.185001,46.56628,75046000,7604391129.038921,4183550000,24.445515954269887,-64.0,0.05339022544015393,56.14754217545923,84.72854512603848,46.55461538461538,47.20933805525469,-15.271454873961524
2019-06-17,48.224998,48.740002,48.0425,48.4725,46.844128,58676400,7618061050.62653,4242226400,22.89040229926778,-60.0,0.14594140002449052,57.70555840759752,89.06488192981074,46.488942307692305,47.3029056067173,-10.935118070189265
2019-06-18,49.012501,50.072498,48.802502,49.612499,47.945827,106204000,7647329794.458794,4348430400,22.446428122784457,43.99999999999999,0.30772994535381315,63.27701586688195,93.87076370583488,46.50115388461539,47.47398659881232,-6.129236294165117
2019-06-19,49.919998,49.970001,49.327499,49.467499,47.805706,84496800,7599656388.004648,4263933600,22.034166387478514,44.0,0.4194135071320133,62.155480009184494,91.93871763040003,46.61798076923076,47.62165418408548,-8.061282369599965
2019-06-20,50.092499,50.1525,49.5075,49.865002,48.189846,86056000,7608996332.53798,4349989600,21.78431323489804,52.0,0.533844873116287,64.03729373239781,96.20965012651939,46.721826961538454,47.78782809637544,-3.7903498734806207
2019-06-21,49.700001,50.212502,49.537498,49.695,48.025566,191202400,7507022323.495071,4158787200,21.59797153407123,56.0,0.6038539618718559,62.60355205840992,92.13821615826568,46.79740388461539,47.92910008923653,-7.861783841734324
2019-06-24,49.634998,50.040001,49.5425,49.645,47.977245,72881600,7464172277.200493,4085905600,21.42493995473205,56.0,0.6478342569154449,62.162724600886,88.48296763755759,46.87913465384615,48.056203786330116,-11.51703236244241
2019-06-25,49.607498,49.814999,48.822498,48.892502,47.250011,84281200,7391780276.55606,4001624400,20.426110177248745,56.0,0.6148806959733477,55.794990778714286,71.7647300408727,46.9423078076923,48.11815180215751,-28.235269959127304
2019-06-26,49.442501,50.247501,49.337502,49.950001,48.271988,104270000,7427873663.175166,4105894400,19.8945182657253,68.0,0.6664140861643162,61.72824002530373,92.18134034165573,47.10298096153846,48.25384433533103,-7.818659658344269
2019-06-27,50.072498,50.392502,49.892502,49.935001,48.2575,83598800,7358486324.779966,4022295600,19.53243141373829,72.0,0.6979982057023761,61.60193766771244,83.76217080313367,47.22932707692307,48.37837445863984,-16.237829196866322
2019-06-28,49.669998,49.875,49.262501,49.48,47.817776,124442400,7322423163.138231,3897853200,18.457239694117906,72.0,0.6784928269278936,57.7424592674864,67.61307271940619,47.374904,48.45997635059245,-32.38692728059381
2019-07-01,50.7925,51.122501,50.162498,50.387501,48.694801,109012000,7264511059.776054,4006865200,18.558469557438286,80.0,0.7278719651880223,62.75463125130011,79.28118393234674,47.58538476923077,48.60275595425227,-20.718816067653265
2019-07-02,50.352501,50.782501,50.34,50.682499,48.979885,67740800,7301634005.888266,4074606000,18.65246871623578,80.0,0.7817970910022183,64.23947998872148,87.59684284707541,47.813846269230766,48.75681099467803,-12.40315715292459
2019-07-03,50.82,51.110001,50.672501,51.102501,49.385777,45448000,7345523788.745408,4120054000,19.00745731592633,80.0,0.8486411856885283,66.29946339475731,99.43622269203657,48.06557711538461,48.930565809887064,-0.5637773079634427
2019-07-05,50.837502,51.27,50.724998,51.057499,49.342278,69062000,7360730044.869238,4050992000,19.468123029231055,92.0,0.8877508873864812,65.86168144537339,93.41592563903941,48.32375011538461,49.088116416562094,-6.584074360960581
2019-07-08,50.202499,50.349998,49.602501,50.005001,48.325138,101354400,7368526975.242471,3949637600,18.519495738940886,92.0,0.8243156179203623,56.47006639643514,48.733534941061755,48.532596269230766,49.156033793113046,-51.266465058938245
2019-07-09,49.799999,50.377499,49.702499,50.310001,48.6199,82312000,7434377063.017285,4031949600,17.66567334211879,92.0,0.7895521946301471,58.32466452399102,60.776375259345926,48.78423084615385,49.24151284547504,-39.223624740654074
2019-07-10,50.462502,50.932499,50.389999,50.807499,49.100689,71588400,7472975416.934336,4103538000,17.41105318857676,88.0,0.7930045986662506,61.22650133798506,81.10314108017059,49.07201923076923,49.3575118198843,-18.89685891982941
2019-07-11,50.827499,51.0975,50.427502,50.4375,48.743118,80767200,7394618703.131609,4022770800,17.329055270745265,84.0,0.7571567944362272,57.99236307994887,65.98572748868017,49.284615384615385,49.43751094433732,-34.01427251131983
2019-07-12,50.612499,51.0,50.549999,50.825001,49.117596,70380800,7410259315.357804,4093151600,17.25291434704459,80.0,0.7513541011570268,60.354319991233375,81.81823753361579,49.484230884615386,49.540287985497514,-18.181762466384207
2019-07-15,51.022499,51.467499,51.0,51.302502,49.57906,67789600,7430198200.677345,4160941200,17.639117968965568,100.0,0.7763366394578597,63.10710677839814,93.76193052478997,49.6764425,49.67082235694214,-6.238069475210029
2019-07-16,51.147499,51.5275,50.875,51.125,49.40752,67467200,7414430004.508762,4093474000,17.809163894220585,84.0,0.7729030083322002,61.400389907396644,82.22957272828805,49.814423346153845,49.77853921939087,-17.770427271711945
2019-07-17,51.012501,51.272499,50.817501,50.837502,49.129677,56430000,7362961153.480845,4037044000,17.87662458070626,84.0,0.7384705166145764,58.634391689818244,69.53649869161082,49.91798111538462,49.856980906843404,-30.46350130838918
2019-07-18,51.0,51.470001,50.924999,51.415001,49.687775,74162400,7422155050.612965,4111206400,18.15722725420658,84.0,0.749146171062435,62.307523642051606,95.03315454002379,50.02230811538462,49.97238980263278,-4.966845459976214
2019-07-19,51.447498,51.625,50.59,50.647499,48.94606,83717200,7347739599.951709,4027489200,17.859215602920184,96.0,0.6877477787231498,55.28178291816164,51.66865348264721,50.10307726923077,50.02239789132665,-48.33134651735279
2019-07-22,50.912498,51.807499,50.9025,51.805,50.064678,89111600,7436359067.05786,4116600800,17.805504147416308,100.0,0.7241423057653265,62.20371434720779,99.8866665638699,50.22875042307692,50.154442491969114,-0.11333343613011201
2019-07-23,52.115002,52.227501,51.822498,52.209999,50.45607,73420800,7503434181.511829,4190021600,18.24432447729234,100.0,0.7767118149207022,64.28671711056016,99.3332571428574,50.383558038461544,50.30670593700844,-0.6667428571425998
2019-07-24,51.9175,52.287498,51.7925,52.1675,50.414997,59966400,7534326330.435259,4130055200,18.719910326442715,100.0,0.8056571019806569,63.88881613137479,95.53079575135457,50.525673423076924,50.44454253426707,-4.469204248645431
2019-07-25,52.2225,52.310001,51.682499,51.755001,50.016357,55638400,7491544926.195591,4074416800,18.94599600614898,84.0,0.7862478527885415,60.00658369585166,79.50138504155129,50.60807734615385,50.54161353172877,-20.49861495844872
2019-07-26,51.869999,52.432499,51.785,51.935001,50.190308,70475600,7453722381.95506,4144892400,19.313035264287123,88.0,0.7764400609395707,61.116912792604964,81.77663003663001,50.70298126923077,50.64482741826738,-18.223369963369993
2019-07-29,52.115002,52.66,52.110001,52.419998,50.659012,86693600,7464755344.800447,4231586000,19.94294244365127,92.0,0.7985967931269613,64.01576900041476,89.42722932721186,50.80125034615385,50.776321535432764,-10.572770672788145
2019-07-30,52.189999,52.540001,51.827499,52.195,50.44157,135742800,7469041947.504721,4095843200,19.918786883186847,92.0,0.7889066796768915,61.71700153915038,79.17131392726908,50.89740419230769,50.881408829104416,-20.82868607273092
2019-07-31,54.105,55.342499,52.825001,53.259998,51.470798,277125600,7287685086.644296,4372968800,22.282565264442297,100.0,0.8572814263507524,67.64034337724362,56.54666666666678,51.03644257692307,51.05760061954113,-43.45333333333323
2019-08-01,53.474998,54.5075,51.685001,52.107498,50.357002,216071600,7136300562.023383,4156897200,22.794373850390652,88.0,0.8091444737294111,57.30690951599416,31.930527497217746,51.16009626923077,51.13537079587141,-68.06947250278225
2019-08-02,51.3825,51.607498,50.407501,51.005001,49.291546,163448400,7135619933.942813,3993448800,21.820523226587227,88.0,0.6742608387841571,49.51417976599187,12.107401056697437,51.2006731923077,51.125713773955006,-87.89259894330256
2019-08-05,49.497501,49.662498,48.145,48.334999,46.711239,209572000,6978527041.563383,3783876800,21.40192329586884,-12.0,0.3479072804790704,36.55123795730891,2.639791961068705,51.13913465384615,50.91899416106945,-97.36020803893129
2019-08-06,49.077499,49.517502,48.509998,49.25,47.595505,143299200,7045731610.478246,3927176000,21.01322336020177,-12.0,0.1612439481263266,42.14154286905104,15.352555102821103,51.1302885,50.79536496395319,-84.6474448971789
2019-08-07,48.852501,49.889999,48.455002,49.759998,48.088371,133457600,7155008502.842481,4060633600,20.303651422118893,-12.0,0.05384381083428025,45.047768088497094,22.438321978231624,51.10615376923077,50.71867111477147,-77.56167802176837
2019-08-08,50.049999,50.8825,49.8475,50.857498,49.14901,108038000,7257826858.251176,4168671600,18.917026266487145,-12.0,0.05663465699196735,50.77764799804616,37.68667421836389,51.1128845,50.72895458775136,-62.31332578163611
2019-08-09,50.325001,50.689999,49.822498,50.247501,48.743992,98478800,7255840824.107122,4070192800,17.60843943450447,-12.0,0.009515078830695245,47.79468645679529,29.21154973415069,51.07999988461539,50.69329135902904,-70.78845026584932
2019-08-12,49.904999,50.512501,49.787498,50.119999,48.620308,89927600,7248398446.727167,3980265200,16.361885005553585,-12.0,-0.03768150324813746,47.170918037059316,27.44007328101051,51.043942192307696,50.65082525836022,-72.55992671898949
2019-08-13,50.255001,53.035,50.119999,52.2425,50.679302,188874000,7334574269.265136,4169139200,17.01224561118931,-12.0,0.09508685555901764,57.187694313510235,56.92949731566479,51.129999846153844,50.76872709107428,-43.07050268433521
2019-08-14,50.790001,51.610001,50.647499,50.6875,49.170822,146189600,7200535771.682792,4022949600,17.616151887851053,-12.0,0.0739784545611144,49.74587445716475,35.32477045151377,51.14451903846153,50.76271026951322,-64.67522954848623
2019-08-15,50.865002,51.285,49.9175,50.435001,48.925888,108909600,7174055168.991165,3914040000,17.474210930122553,-11.999999999999993,0.03645510386974138,48.63905783658355,31.816621301371473,51.13019219230769,50.738435508808536,-68.18337869862853
2019-08-16,51.07,51.790001,50.959999,51.625,50.080284,110481600,7240610189.340514,4024521600,17.675021573461073,-12.0,0.1015697196657328,53.85049242782908,48.35012828761768,51.17586526923076,50.8041069526005,-51.64987171238232
2019-08-19,52.654999,53.182499,52.5075,52.587502,51.013988,97654400,7166104111.956696,4122176000,18.66327144012905,-12.0,0.22820874093421395,57.598062313958785,61.722856786781094,51.24365376923077,50.93621028944491,-38.277143213218906
2019-08-20,52.720001,53.337502,52.580002,52.59,51.016407,107537200,7061405610.110096,4229713200,19.662141007202628,-12.000000000000007,0.325025948584063,57.60768386949789,69.86247544204325,51.293172923076924,51.058713230967506,-30.13752455795674
2019-08-21,53.247501,53.412498,52.900002,53.16,51.569347,86141600,7062666228.729557,4315854800,20.630917752950467,-12.0,0.4426459722574876,59.846654654129544,95.20649082353704,51.371442153846154,51.21436410274769,-4.793509176462961
2019-08-22,53.297501,53.610001,52.6875,53.115002,51.5257,89014800,7056153247.219943,4226840000,21.287835289915815,-12.0,0.5261644298676345,59.579133270709846,90.9423804314034,51.4590383076923,51.355152095136745,-9.057619568596612
2019-08-23,52.357498,53.012501,50.25,50.66,49.14415,187272000,6924469657.866672,4039568000,19.85809989491606,-12.0,0.3897623276548643,47.186135865309275,42.77397531987878,51.429999807692305,51.30365934734884,-57.22602468012122
2019-08-26,51.465,51.797501,51.264999,51.622501,50.077858,104174400,6960172878.415703,4143742400,18.530488456702,-11.999999999999996,0.3552335543809946,51.450018743590086,61.44519135697216,51.46749988461538,51.32727724754522,-38.55480864302783
2019-08-27,51.965,52.137501,50.8825,51.040001,49.512787,103493200,6882656203.523172,4040249200,17.59229803850609,-12.0,0.27766561458658146,48.87813477586737,32.76656682807046,51.43807684615385,51.30599752550483,-67.23343317192953
2019-08-28,51.025002,51.43,50.830002,51.3825,49.845032,63755200,6936316796.541149,4104004400,16.762589134562116,-12.0,0.24105058922530276,50.44664361745825,41.726638278635804,51.40624996153846,51.31166437546743,-58.273361721364196
2019-08-29,52.125,52.330002,51.665001,52.252499,50.688999,83962000,7000707978.193507,4187966400,15.908723106092676,-12.000000000000004,0.27901821791118664,54.28367801027227,64.48656809425663,51.40951915384615,51.38135582913651,-35.513431905743374
2019-08-30,52.540001,52.612499,51.799999,52.185001,50.62352,84573600,6996284544.709692,4103392800,15.341968754589931,-12.0,0.30020078491111235,53.934740191579166,61.40827043784153,51.42605761538461,51.440885101052324,-38.59172956215847
2019-09-03,51.607498,51.744999,51.055,51.424999,49.886261,80092000,7002088205.161374,4023300800,14.342101025160364,-12.0,0.2527487814505349,50.034787410288736,40.825960507526005,51.40644215384616,51.43970835282622,-59.174039492473995
2019-09-04,52.0975,52.369999,51.830002,52.297501,50.732658,76752400,7058231618.462558,4100053200,13.745248138566334,-12.0,0.2822922570133173,54.13501872102157,64.4549859295908,51.40173073076923,51.50324854891317,-35.54501407040919
2019-09-05,53.0,53.4925,52.877499,53.32,51.72456,95654800,7100226495.958366,4195708000,14.015159133923165,-12.0,0.38378872069340275,58.439335671035366,91.36902042588686,51.444999961538464,51.63782273047516,-8.630979574113129
2019-09-06,53.512501,53.605,53.127499,53.314999,51.719715,77449200,7083601147.636165,4118258800,14.3428044589107,-8.0,0.45853614128956366,58.41046264418065,91.22018118446998,51.44711538461539,51.76205800969922,-8.779818815530023
2019-09-09,53.709999,54.110001,52.767502,53.5425,51.940403,109237600,7100484939.942304,4227496400,14.992638729167705,96.0,0.5300216800325401,59.39333143272463,85.29790536323694,51.50230776923077,51.89394260157335,-14.70209463676306
2019-09-10,53.465,54.195,52.927502,54.174999,52.553974,127111600,7223584921.601919,4354608000,15.654347398718945,100.0,0.6304444960843583,62.07669114160154,99.49300380228135,51.62423076923077,52.06290974219755,-0.5069961977186463
2019-09-11,54.517502,55.927502,54.432499,55.897499,54.224941,177158400,7393632588.746937,4531766400,17.294644697777382,96.0,0.8393461953148744,68.23325420170781,99.47154576079421,51.91509615384616,52.34695339092366,-0.5284542392057912
2019-09-12,56.200001,56.605,55.715,55.772499,54.103676,128906800,7281381995.697948,4402859600,19.141992356184005,100.0,0.9834789090104152,67.37840735094983,86.90006294256501,52.16596150000001,52.6006975101145,-13.099937057434994
2019-09-13,55.0,55.197498,54.255001,54.6875,53.05114,159053200,7268303477.732586,4243806400,19.359586600348557,88.0,0.9986430361620791,60.31489343753895,66.79652529749796,52.35548080769232,52.755275472328236,-33.20347470250203
2019-09-16,54.432499,55.032501,54.389999,54.974998,53.330036,84632400,7337786922.874234,4328438800,19.56163839850135,88.0,1.0220775285326127,61.467593638204605,71.77484736791253,52.513846192307696,52.919699363266886,-28.225152632087465
2019-09-17,54.990002,55.205002,54.779999,55.174999,53.524052,73274800,7400716083.787451,4401713600,19.858618909413824,88.0,1.0447447743666984,62.28822445340648,75.23806934651756,52.703365346153845,53.08675859561749,-24.761930653482445
2019-09-18,55.264999,55.712502,54.860001,55.692501,54.026077,101360000,7497319957.143611,4503073600,20.454126534968115,76.0,1.0918803000274053,64.4008653345596,83.55857657657663,52.91769234615385,53.279776551497676,-16.441423423423373
2019-09-19,55.502499,55.939999,55.092499,55.240002,53.587105,88242400,7439793825.526383,4414831200,21.148392352359274,76.0,1.080269976256993,61.17382347260022,75.40544144144143,53.03298088461539,53.42497843657192,-24.59455855855857
2019-09-20,55.345001,55.639999,54.3675,54.432499,52.803768,221652400,7240785347.993278,4193178800,20.989892308734465,76.0,0.994446606052179,55.8002832518276,60.855837837837875,53.17701930769231,53.49960958941844,-39.144162162162125
2019-09-23,54.737499,54.959999,54.412498,54.68,53.043873,76662000,7239035497.282502,4269840800,20.842713696797144,52.0,0.9356170185007926,57.04571203800531,59.68584698883647,53.3402885,53.58704591612819,-40.31415301116353
2019-09-24,55.2575,55.622501,54.297501,54.419998,52.791641,124763200,7137341154.203861,4145077600,21.191702640578452,52.0,0.8581222588123794,55.283416656253976,43.06180745892247,53.44778842307692,53.64874607048907,-56.93819254107753
2019-09-25,54.637501,55.375,54.285,55.2575,53.604084,87613600,7206065583.56166,4232691200,21.500484592093446,52.0,0.8544370965629184,59.61160490319836,64.88597518487312,53.55048065384615,53.767913028230616,-35.11402481512688
2019-09-26,55.0,55.235001,54.7075,54.9725,53.327618,75334000,7206422473.247176,4157357200,21.7872106899288,52.0,0.8190776435576339,57.56951985170015,57.45926121655303,53.64211526923077,53.857141692806124,-42.54073878344697
2019-09-27,55.134998,55.240002,54.32,54.705002,53.068119,101408000,7189888816.598604,4055949200,21.53671231968883,52.00000000000001,0.7607012784559757,55.64282667780995,48.334492636026,53.70153842307692,53.91994616000567,-51.665507363974
2019-09-30,55.224998,56.145,55.197498,55.9925,54.317093,103909600,7260350014.378872,4159858800,22.043159932755746,52.0,0.8090022427956214,62.20007456322365,73.93615912176992,53.812211423076924,54.07346866667192,-26.063840878230074
2019-10-01,56.267502,57.055,56.049999,56.147499,54.467457,139223200,7148140244.216256,4299082000,23.128128676420882,92.0,0.8499900724885592,62.910912992065796,67.58923842472814,54.02326907692308,54.227100543214746,-32.41076157527186
2019-10-02,55.764999,55.895,54.482498,54.740002,53.102062,138449200,7060170580.2407,4160632800,22.343875352926656,92.0,0.7601375849546699,53.13867678510584,17.32147047195363,54.14317296153846,54.26509324371736,-82.67852952804637
2019-10-03,54.607498,55.240002,53.782501,55.205002,53.553158,114426000,7169100995.675064,4275058800,20.968364466544063,92.0,0.7181718174001404,55.59288114508015,43.46834025006573,54.30336530769231,54.33471611455312,-56.53165974993427
2019-10-04,56.41,56.872501,55.9725,56.752499,55.054356,138478800,7270651541.245125,4413537600,20.85892644516102,80.0,0.8005554147018614,62.6107394895907,90.75626913866132,54.50990373076923,54.51381114310474,-9.243730861338683
2019-10-07,56.567501,57.482498,56.459999,56.764999,55.066475,122306000,7221310561.259814,4535843600,21.12312563757252,96.0,0.8569749805114597,62.66206900097946,80.60811941198878,54.68346142307693,54.68056579917105,-19.391880588011215
2019-10-08,56.455002,57.014999,56.0825,56.099998,54.421375,111820000,7113687083.422303,4424023600,21.006834947005732,96.0,0.8383637345729795,58.09287016786731,62.63510483927415,54.83403823076923,54.785708925158374,-37.36489516072585
2019-10-09,56.7575,56.947498,56.41,56.7575,55.059204,74770400,7135596909.209189,4498794000,20.89885073433657,92.0,0.8666785734009608,61.112184558032794,80.40544357198127,55.03913442307692,54.931767523294795,-19.594556428018727
2019-10-10,56.982498,57.610001,56.825001,57.522499,55.801323,113013600,7223415818.694032,4611807600,21.237944065028568,92.0,0.9400114462901143,64.33211336544477,97.71386022207724,55.240095884615386,55.12367355860629,-2.2861397779227612
2019-10-11,58.237499,59.41,58.077499,59.052502,57.285538,166795600,7300711908.5116,4778603200,22.523211485717365,96.0,1.108805116544687,69.73039538149361,93.64730229183513,55.46057673076923,55.41469788759842,-6.352697708164854
2019-10-14,58.724998,59.532501,58.6675,58.967499,57.203075,96427600,7271170204.764667,4682175600,23.77403250977601,100.0,1.2216340477521825,69.10462934525842,90.17387826086946,55.677980576923076,55.67786834036891,-9.826121739130555
2019-10-15,59.0975,59.412498,58.720001,58.830002,57.069702,87360000,7211563934.701402,4594815600,24.935509174973326,96.0,1.285142605846353,68.0409665062365,87.78262608695647,55.881346038461544,55.9113597225638,-12.217373913043533
2019-10-16,58.342499,58.810001,58.299999,58.592499,56.839294,73903200,7222431719.913223,4520912400,25.514683383950878,28.0,1.3013084151127643,66.14702008288754,83.65213913043466,56.05124988461538,56.10996263200352,-16.347860869565338
2019-10-17,58.772499,59.037498,58.380001,58.82,57.059998,67585200,7245302964.3222475,4588497600,26.187817723853634,28.0,1.3172924375851593,67.09194716193042,87.60867826086951,56.16365376923078,56.310706140744,-12.39132173913049
2019-10-18,58.647499,59.395,58.572498,59.102501,57.334038,97433600,7273437691.9392,4685931200,27.02524435992074,27.999999999999993,1.337339344791907,68.27610411672497,92.52173913043467,56.29173076923076,56.51750575994815,-7.478260869565336
2019-10-21,59.380001,60.247501,59.330002,60.127499,58.328369,87247200,7337862330.8369,4773178400,28.268649967718357,48.0,1.4195714989306154,72.18673455763567,98.14382057231246,56.5009615,56.78491266661866,-1.8561794276875416
2019-10-22,60.290001,60.549999,59.904999,59.990002,58.194977,82293600,7277259282.405272,4690884800,29.57639401377182,52.0,1.456852525689662,70.92372486056773,91.72519888443257,56.693846269230775,57.02232669131357,-8.274801115567422
2019-10-23,60.525002,60.810001,60.305,60.794998,58.975891,75828800,7348582509.202842,4766713600,30.922321074708247,56.0,1.533675204481625,73.81258850961365,99.68986052922779,56.91000007692307,57.30178382529034,-0.3101394707722043
2019-10-24,61.127499,61.200001,60.452499,60.895,59.072899,69275200,7361325404.874024,4835988800,32.36652202853661,60.0,1.5843635003501788,74.15610367219612,94.04004024620616,57.11009619230769,57.56794798637995,-5.959959753793841
2019-10-25,60.790001,61.682499,60.720001,61.645,59.800461,73477200,7429077249.553183,4909466000,33.93680414129956,64.0,1.665850187992497,76.63189529835523,99.33037488042415,57.35644226923076,57.86995183924069,-0.6696251195758581
2019-10-28,61.855,62.3125,61.68,62.262501,60.399475,96572800,7510381928.04425,5006038800,35.67062738356212,68.0,1.7599683257408287,78.46140437089007,99.15291825497673,57.65759619230769,58.195325851148795,-0.8470817450232894
2019-10-29,62.2425,62.4375,60.642502,60.822498,59.002575,142839600,7396189219.730592,4863199200,35.80696724496486,72.0,1.6987789541676932,65.56934397987443,71.22490355900293,57.89384611538462,58.38993119550814,-28.775096440997086
2019-10-30,61.189999,61.325001,60.302502,60.814999,58.9953,124522000,7396493065.885942,4738677200,35.50120872713422,72.0,1.6308810481868292,65.50897807449152,62.78668284709107,58.13980769230769,58.56956584769272,-37.21331715290893
2019-10-31,61.810001,62.2925,59.314999,62.189999,60.329155,139162000,7526073712.823761,4877839200,34.08083104715972,72.0,1.6687857537780317,70.81464402377725,94.01810416480866,58.406442269230766,58.83774608119697,-5.981895835191333
2019-11-01,62.384998,63.982498,62.290001,63.955002,62.041332,151125200,7672288607.518405,5028964400,33.86072847443979,84.0,1.8202636313349316,75.93254075886034,99.51612837943307,58.75192311538462,59.21680207518238,-0.48387162056692484
2019-11-04,64.332497,64.462502,63.845001,64.375,62.448776,103272000,7746292617.526485,5132236400,33.916660687326825,88.0,1.9517032490067407,76.96757027885808,98.58008994072699,59.12384611538462,59.59889081035406,-1.4199100592730036
2019-11-05,64.262497,64.547501,64.080002,64.282501,62.359043,79897600,7735610926.447788,5052338800,34.0151489974451,92.0,2.02506253636777,76.19043354994574,95.70328334008917,59.442692307692305,59.945824898475976,-4.296716659910834
2019-11-06,64.192497,64.372498,63.842499,64.309998,62.385715,75864400,7793582745.51839,5128203200,33.8250703447015,92.0,2.0616536186435894,76.26714718520881,96.02505638909295,59.75663457692308,60.269096980070344,-3.974943610907041
2019-11-07,64.684998,65.087502,64.527496,64.857498,63.105721,94940400,7810535867.662084,5223143600,34.0717126280919,100.0,2.1105024310403877,77.80084900995821,96.01552394169404,60.145769038461545,60.608978537102175,-3.9844760583059697
2019-11-08,64.672501,65.110001,64.212502,65.035004,63.278435,69986400,7868825831.140595,5293130000,33.915058754190916,100.0,2.138883005641418,78.29068501643539,98.70583306097227,60.52384603846154,60.9368322750946,-1.2941669390277388
2019-11-11,64.574997,65.6175,64.57,65.550003,63.779549,81821200,7940102524.149856,5374951200,34.080447592412995,96.0,2.177826304765958,79.69086480047815,98.92904420007227,60.86221157692307,61.278548625087595,-1.0709557999277264
2019-11-12,65.387497,65.697502,65.230003,65.489998,63.721134,87388800,7949914578.294999,5287562400,34.282893803045084,100.0,2.1787321795243244,79.05111315651534,96.74886169266196,61.19778846153846,61.59050783804407,-3.251138307338048
2019-11-13,65.282501,66.195,65.267502,66.1175,64.331688,102734400,8035480389.252222,5390296800,34.77294809157285,100.0,2.204670193314797,80.788059715036,98.87354667535679,61.583077,61.92584059078155,-1.126453324643215
2019-11-14,65.9375,66.220001,65.525002,65.660004,63.886559,89182800,7980944707.782177,5301114000,35.24319517655172,100.0,2.1633721449362255,75.85019617069202,91.88998062563928,61.925481,62.20244528776069,-8.11001937436073
2019-11-15,65.919998,66.445,65.752502,66.440002,64.645477,100206400,8079704658.587526,5401320400,35.82163778004177,100.0,2.1685843731873433,78.28690940487175,99.92990183311353,62.26846188461538,62.516338377556195,-0.07009816688646041
2019-11-18,66.449997,66.857498,66.057503,66.775002,64.971443,86703200,8148526078.858402,5488023600,36.61227922828892,92.0,2.1746784622936417,79.25505165600379,98.90625109794505,62.565481115384614,62.83179494218166,-1.0937489020549562
2019-11-19,66.974998,67.0,66.347504,66.572502,64.774406,76167200,8124887837.397918,5411856400,37.43284149610107,96.0,2.138516526837968,77.01950790979191,94.43724210315652,62.857981230769234,63.10888435387191,-5.562757896843474
2019-11-20,66.385002,66.519997,65.099998,65.797501,64.020325,106234400,8123018035.8281975,5305622000,36.32493869585612,96.0,2.0239905258189808,68.99802276242485,74.46923024824416,63.12596196153846,63.30804114247399,-25.530769751755834
2019-11-21,65.922501,66.002502,65.294998,65.502502,63.733326,121395200,8072830884.350326,5184226800,35.29617180991438,92.0,1.8876640745839381,66.17290092355913,52.573316683035365,63.39173130769231,63.47059379858703,-47.426683316964635
2019-11-22,65.647499,65.794998,65.209999,65.445,63.677364,65325200,8059989491.417345,5118901600,34.22092415874716,88.0,1.7547567059572486,65.60898939308456,50.752192952591145,63.646539,63.61684610980281,-49.247807047408855
2019-11-25,65.677498,66.610001,65.629997,66.592499,64.793869,84020400,8141008832.154731,5202922000,33.93191239141076,52.0,1.722168155540814,70.93244205598805,87.09419252757176,63.934615846153854,63.83726484241001,-12.905807472428224
2019-11-26,66.735001,66.790001,65.625,66.072502,64.287918,105207600,8116626246.751628,5097714400,33.80701879232652,52.0,1.6355287253793307,65.95048843141994,66.72650527462261,64.1632698076923,64.00283796519444,-33.27349472537739
2019-11-27,66.394997,66.995003,66.327499,66.959999,65.151428,65235600,8175019919.3852,5162950000,33.85613190201285,52.0,1.6198078074422142,69.84350594339509,98.56498551747826,64.43134661538461,64.2218869307356,-1.435014482521736
2019-11-29,66.650002,67.0,66.474998,66.8125,65.007927,46617600,8188339360.521043,5116332400,33.90591906911983,52.0,1.577265198717214,68.44291651475787,92.28395061728398,64.662789,64.41378419512554,-7.716049382716028
2019-12-02,66.817497,67.0625,65.862503,66.040001,64.256279,94487200,8121804378.777589,5021845200,32.93787228034023,84.0,1.4643357109843294,61.48833388937329,47.89819322477144,64.86067365384616,64.53424469919031,-52.10180677522856
2019-12-03,64.577499,64.8825,64.072502,64.862503,63.110588,114430400,8230584728.508825,4907414800,31.27477184433203,84.0,1.2652391412678554,52.69837709993151,26.421455800305008,64.98442376923077,64.55856012887992,-73.57854419969499
2019-12-04,65.267502,65.827499,65.169998,65.434998,63.667633,67181600,8217557035.499079,4974596400,29.32369625043831,84.0,1.1405022374584348,55.99233852671636,45.56845857421955,65.10644288461539,64.6234814526666,-54.43154142578045
2019-12-05,65.947502,66.472504,65.682503,66.394997,64.601692,74424400,8277377879.374973,5049020800,28.085675011484874,84.0,1.106357834331888,60.90832333022114,77.67547001703691,65.32076976923076,64.75470482654315,-22.324529982963078
2019-12-06,66.870003,67.75,66.824997,67.677498,65.849548,106075600,8366825007.572828,5155096400,27.887669529299185,100.0,1.1693062269326617,66.32101029317396,98.02849654846855,65.58471203846153,64.97120802457698,-1.9715034515314507
2019-12-09,67.5,67.699997,66.227501,66.730003,64.927658,128042400,8326173761.212362,5027054000,27.069689421954156,96.0,1.1297156943328872,59.73992958341696,72.2638326383861,65.75932757692308,65.10148913386757,-27.73616736161389
2019-12-10,67.150002,67.517502,66.464996,67.120003,65.307121,90420400,8348296177.96172,5117474400,26.31013646513377,84.0,1.1169343289703022,61.43621190125204,82.8688689973454,65.88105838461539,65.25100867950701,-17.131131002654605
2019-12-11,67.202499,67.775002,67.125,67.692497,65.864174,78756800,8407059717.06714,5196231200,25.808959858979545,96.0,1.1398608794244467,63.84439889709219,97.77164078325463,66.00865442307692,65.4318596662102,-2.2283592167453774
2019-12-12,66.945,68.139999,66.830002,67.864998,66.031982,137310400,8486720370.830468,5333541600,25.629588363579757,100.0,1.1585941724648876,64.56248924309529,93.2390607786557,66.14644276923077,65.61209213537981,-6.760939221344305
2019-12-13,67.864998,68.824997,67.732498,68.787498,66.929581,133587600,8611137433.534966,5467129200,25.962328725270726,32.0,1.2336576451038184,68.19989309967538,99.21096182110666,66.31865430769231,65.84730738461093,-0.7890381788933365
2019-12-16,69.25,70.197502,69.245003,69.964996,68.075264,128186000,8676742760.765755,5595315200,27.089585311578066,36.0,1.3723407459450812,72.1318991311584,96.20398367346938,66.51509653846153,66.15232135612123,-3.7960163265306246
2019-12-17,69.892502,70.442497,69.699997,70.102501,68.209061,114158400,8686353283.684544,5709473600,28.263749535388083,40.0,1.4763254460806081,72.55861095988419,94.66253898158477,66.71000026923076,66.4449272556678,-5.337461018415229
2019-12-18,69.949997,70.474998,69.779999,69.934998,68.046082,116028400,8622078299.075354,5593445200,29.371615181737432,43.99999999999999,1.5276086562029718,71.1298228807373,91.56578934215646,66.87865392307693,66.70345101450722,-8.43421065784354
2019-12-19,69.875,70.294998,69.737503,70.004997,68.114212,98369200,8618106970.929989,5691814400,30.337743093736808,44.0,1.5559631295899692,71.3834235891734,92.65909732704252,67.05230773076923,66.94800997639558,-7.34090267295749
2019-12-20,70.557503,70.662498,69.639999,69.860001,67.973106,275978000,8460888425.865395,5415836400,31.453987517703645,52.0,1.548879766806678,70.01153302001126,87.82249640212221,67.19625007692308,67.16371301518109,-12.177503597877791
2019-12-23,70.1325,71.0625,70.092499,71.0,69.082321,98572000,8546757861.641234,5514408400,32.71915400797196,56.0,1.6166191632948994,74.20846906686218,98.93933001634959,67.40163453846154,67.44788242146397,-1.0606699836504099
2019-12-24,71.172501,71.222504,70.730003,71.067497,69.147995,48478800,8564720770.905581,5562887200,33.98430918494618,60.0,1.656652705691144,74.43658813406891,97.20204021623827,67.57961511538461,67.71600201987405,-2.797959783761728
2019-12-26,71.205002,72.495003,71.175003,72.477501,70.519913,93121200,8655372565.992855,5656008400,35.781143522334716,64.0,1.7816177351390223,78.67899807960502,99.72074998938982,67.798942,68.06870564803154,-0.27925001061018034
2019-12-27,72.779999,73.4925,72.029999,72.449997,70.493164,146266000,8593115298.250814,5509742400,37.826590319975956,68.0,1.8570274221977456,78.40565919147306,85.65033525813271,68.0249995,68.39324574817735,-14.349664741867276
2019-12-30,72.364998,73.172501,71.305,72.879997,70.911545,144114400,8692084835.187716,5653856800,38.647664023679035,68.0,1.929248374483663,79.59896585293343,91.28420275534525,68.2974031923077,68.7255976927568,-8.71579724465476
2019-12-31,72.482498,73.419998,72.379997,73.412498,71.429649,100805600,8791436509.662643,5754662400,39.52828549632675,68.0,2.0063247174485923,80.9992600328197,98.79921915173546,68.60163380769231,69.07277549329334,-1.2007808482645292
2020-01-02,74.059998,75.150002,73.797501,75.087502,73.059425,135480400,8914395625.02034,5890142800,41.03688308194584,80.0,2.1774666190028995,84.5837404942483,99.24879807692307,68.97249926923077,69.51831079008642,-0.7512019230769225
2020-01-03,74.287498,75.144997,74.125,74.357498,72.349144,146322800,8834778429.751335,5743820000,42.437723697163555,80.0,2.228503782682168,77.70369298192009,89.31575904778758,69.27115307692307,69.87676910193187,-10.684240952212422
2020-01-06,73.447502,74.989998,73.1875,74.949997,72.925636,118387200,8947911136.945019,5862207200,42.47260125862892,80.0,2.2903589874715493,79.18367257239123,96.61295454918783,69.6125951923077,70.25256376104802,-3.387045450812173
2020-01-07,74.959999,75.224998,74.370003,74.597504,72.582664,108872000,8896977461.431128,5753335200,42.62288332176435,92.0,2.284600985668689,75.95355411248056,88.76465331506775,69.90634538461539,70.57441118615557,-11.235346684932246
2020-01-08,74.290001,76.110001,74.290001,75.797501,73.750252,132079200,8983699793.29926,5885414400,43.178006841571246,96.0,2.3497806482371715,79.08192898472004,95.17001694899012,70.25192234615385,70.96130672792182,-4.82998305100988
2020-01-09,76.809998,77.607498,76.550003,77.407501,75.316742,170108400,9089465251.394472,6055522800,44.26242892376586,100.0,2.5025022568223108,82.39181401613364,97.48983965984796,70.68913388461539,71.43880259992761,-2.5101603401520394
2020-01-10,77.650002,78.167503,77.0625,77.582497,75.487038,140644800,9081190904.806093,6196167600,45.45004886714956,100.0,2.607597189396742,82.71201494209733,93.13977454598681,71.17836442307693,71.89389107400704,-6.860225454013194
2020-01-13,77.910004,79.267502,77.787498,79.239998,77.09977,121532000,9198205868.19268,6317699600,46.870913321135255,100.0,2.792442618742541,85.41700174807906,99.70022898085162,71.70932596153847,72.43804714259912,-0.29977101914836807
2020-01-14,79.175003,79.392502,78.042503,78.169998,76.05867,161954400,9066841677.856543,6155745200,48.22430677946078,96.0,2.820085703059135,77.0371620633897,85.88739808223947,72.16221061538462,72.86263609499919,-14.112601917760532
2020-01-15,77.962502,78.875,77.387497,77.834999,75.732704,121923600,9018277331.380333,6033821600,48.62863592299103,96.0,2.78288209444041,74.57053736297235,81.04650818941384,72.55288373076924,73.2309592731474,-18.95349181058615
2020-01-16,78.397499,78.925003,78.022499,78.809998,76.681381,108829200,9099370583.07207,6142650800,49.02345861403335,92.0,2.799797909973435,76.88980929810441,92.79747937002055,73.01749892307693,73.64422140106241,-7.202520629979456
2020-01-17,79.067497,79.684998,78.75,79.682503,77.530319,137816400,9236451469.374714,6280467200,49.67764873463559,96.0,2.85074605137423,78.75696087702062,99.97022672320452,73.500672,74.09150151950224,-0.029773276795485432
2020-01-21,79.297501,79.754997,79.0,79.142502,77.00489,110843200,9167450495.731638,6169624000,50.31090520021929,100.0,2.8150985490372733,74.73259521996289,91.69498305084731,73.9410568076923,74.46564970324282,-8.305016949152675
2020-01-22,79.644997,79.997498,79.327499,79.425003,77.279762,101832400,9095257143.937979,6271456400,50.9913543200316,100.0,2.777624391376847,75.43965013105264,91.59331618012237,74.38567238461539,74.83300920670631,-8.406683819877625
2020-01-23,79.480003,79.889999,78.912498,79.807503,77.651947,104472000,9182095357.14492,6375928400,51.002182900181914,96.0,2.747123277638593,76.4024916029233,97.21005791778505,74.80951873076923,75.20149022843177,-2.789942082214948
2020-01-24,80.0625,80.832497,79.379997,79.577499,77.428146,146537600,9075408316.973078,6229390800,51.42199378022609,88.0,2.673572248041509,74.51089446329976,83.58406157647936,75.1792303846154,75.5256390263257,-16.415938423520636
2020-01-27,77.514999,77.942497,76.220001,77.237503,75.151344,161940000,9104788672.875212,6067450800,48.47556039473416,88.0,2.3988123901174134,58.611851673140656,45.051643898597725,75.45365353846154,75.65244376511639,-54.948356101402275
2020-01-28,78.150002,79.599998,78.047501,79.422501,77.277351,162234000,9229926242.675346,6229684800,46.663322232671725,88.0,2.330509636585788,65.92365941823323,78.44865323570689,75.81855750000001,75.93170726399666,-21.55134676429312
2020-01-29,81.112503,81.962502,80.345001,81.084999,78.894928,216229200,9211544432.620205,6445914000,45.97463048956329,100.0,2.3830584919489297,70.23272078475944,84.71914937411411,76.24471142307692,76.31343257777468,-15.280850625885893
2020-01-30,80.135002,81.022499,79.6875,80.967499,78.780609,126743200,9327844364.87244,6319170800,44.831533159483456,96.0,2.3876986664704987,69.56318986827168,82.6730025819761,76.67192288461538,76.65817823868025,-17.326997418023893
2020-01-31,80.232498,80.669998,77.072502,77.377502,75.28756,199588400,9162098649.89558,6119582400,42.093580938959406,92.0,2.077742362560386,52.95334883861841,20.156740068482524,76.91721142307692,76.71146148025949,-79.84325993151748
2020-02-03,76.074997,78.372498,75.555,77.165001,75.080811,173788400,9186925828.531946,5945794000,39.39405238267398,88.0,1.7942694821457934,52.15944027709299,25.12681228971912,77.1517308076923,76.74505700024027,-74.87318771028087
2020-02-04,78.827499,79.910004,78.407501,79.712502,77.559494,136616400,9287626144.194277,6082410400,37.01526794962206,80.0,1.7549472825942303,59.917751532118416,64.88491146783876,77.43000007692308,76.9648677409632,-35.11508853216124
2020-02-05,80.879997,81.190002,79.737503,80.362503,78.191948,118826800,9271059999.795416,6201237200,35.356421657859855,80.0,1.7559918238846564,61.62766268650755,75.02928598383585,77.73432723076922,77.21654442681778,-24.970714016164152
2020-02-06,80.642502,81.305,80.065002,81.302498,79.106529,105425600,9376060155.800827,6306662800,33.86453290829527,76.0,1.8117842499796097,64.0182259622369,89.69951160374198,78.05826957692308,77.5192076544609,-10.300488396258032
2020-02-07,80.592499,80.849998,79.5,80.0075,78.031281,117684000,9346857220.217218,6188978800,32.15230022159765,64.0,1.7315444670058042,58.60170441540301,69.4888585286433,78.3119235,77.7035256059823,-30.51114147135669
2020-02-10,78.544998,80.387497,78.462502,80.387497,78.401909,109348800,9456206020.217218,6298327600,29.987223038200742,64.0,1.6792589906929294,59.67974682023962,75.41935999395699,78.51576946153847,77.90233830183547,-24.58064000604301
2020-02-11,80.900002,80.974998,79.677498,79.902496,77.928871,94323200,9394595777.9877,6204004400,28.276681676329364,64.0,1.58046819311798,57.61743444004042,67.85009197031849,78.72903861538461,78.05049813132914,-32.14990802968151
2020-02-12,80.3675,81.805,80.3675,81.800003,79.779526,113730400,9507535484.6885,6317734800,27.098383272294804,56.0,1.6364250418200186,63.00395380926687,97.46392587938331,78.99250038461538,78.32823923271216,-2.536074120616693
2020-02-13,81.047501,81.555,80.837502,81.217499,79.211403,94747600,9513147199.298992,6222987200,26.004249039976997,56.00000000000001,1.6151496037168158,60.46348219162873,88.37295719923306,79.24711557692308,78.54225847473349,-11.62704280076694
2020-02-14,81.184998,81.495003,80.712502,81.237503,79.230911,80113600,9540534343.99734,6303100800,24.903960865239558,-12.0,1.5816703105736565,60.52235305688074,88.68515374634299,79.45634642307692,78.74190621734583,-11.314846253657002
2020-02-18,78.839996,79.9375,78.652496,79.75,77.780151,152531200,9648552686.449814,6150569600,23.614749286007395,-12.0,1.418754154286873,54.07443272638736,65.47013172996274,79.54644253846155,78.81657983087577,-34.52986827003726
2020-02-19,80.0,81.142502,80.0,80.904999,78.906624,93984000,9703461950.559637,6244553600,22.128540987073745,-12.000000000000007,1.3670818249535017,57.83111461599913,85.59998399999995,79.67423107692306,78.97127754710719,-14.40001600000005
2020-02-20,80.657501,81.162498,79.552498,80.074997,78.097115,100566000,9668170030.601873,6143987600,20.603684196178513,-12.0,1.2448075404335839,54.3881214217891,72.31995199999983,79.70634642307692,79.05303454361777,-27.68004800000017
2020-02-21,79.654999,80.112503,77.625,78.262497,76.329391,129554000,9605020200.838451,6014433600,20.175285412363134,-12.0,0.9902358640668751,47.708472012328045,43.31995199999983,79.70990407692308,78.9944762070535,-56.68004800000017
2020-02-24,74.315002,76.044998,72.307503,74.544998,72.703712,222195200,9648864500.03457,5792238400,21.563307871597,-68.0,0.48294775450246163,37.52809875626368,23.55878606752924,79.58336557692307,78.66488522875323,-76.44121393247076
2020-02-25,75.237503,75.6325,71.532501,72.019997,70.241074,230673600,9473045770.636053,5561564800,23.041708594150712,-72.0,-0.12142845389703893,32.461342136946016,4.745641737224863,79.32221169230769,78.17267128588263,-95.25435826277514
2020-02-26,71.6325,74.470001,71.625,73.162498,71.355362,198054800,9489056877.038477,5759619600,24.414509265093443,-72.0,-0.5024190963308541,36.63036614720659,15.867580030915567,79.07144226923076,77.80154733878021,-84.13241996908444
2020-02-27,70.275002,71.5,68.239998,68.379997,66.691002,320605600,9195987740.755003,5439014000,26.44002259817656,-80.0,-1.1767005159433381,28.6562222119385,1.0320602975215412,78.65749976923077,77.10365472109278,-98.96793970247846
2020-02-28,64.315002,69.602501,64.092499,68.339996,66.651978,426510000,9427045540.356527,5012504000,28.974225878446287,-84.0,-1.6947649499309705,28.60014176591767,23.98022165249275,78.23115334615385,76.45449481582665,-76.01977834750726
2020-03-02,70.57,75.360001,69.43,74.702499,72.857315,341397200,9692736398.386467,5353901200,28.730548236160107,-84.0,-1.5737922306912822,46.52590948568543,59.901196335853406,78.03480703846154,76.32471734798763,-40.0988036641466
2020-03-03,75.917503,76.0,71.449997,72.330002,70.543419,319475600,9496838793.9957,5034425600,28.26951632237705,-84.0,-1.6503371004528873,42.264809845990854,46.50671861641667,77.75605715384616,76.02881250739595,-53.49328138358334
2020-03-04,74.110001,75.849998,73.282501,75.684998,73.815544,219178400,9687846227.486294,5253604000,27.841415259578497,-84.0,-1.4238658833093751,49.331783238676344,66.3851014239025,77.69634542307692,76.00334476610736,-33.6148985760975
2020-03-05,73.879997,74.887497,72.852501,73.230003,71.421188,187572800,9569864824.369234,5066031200,27.554863268674524,-84.0,-1.426044834170625,44.991968966659385,52.506834648622956,77.45817242307692,75.79791204269199,-47.49316535137704
2020-03-06,70.5,72.705002,70.307503,72.2575,70.472725,226176800,9711608162.371044,4839854400,27.90361962881455,-44.0,-1.4890793531169635,43.364532587192535,47.832463259078054,77.11865323076924,75.53565929878889,-52.167536740921946
2020-03-09,65.9375,69.522499,65.75,66.542503,64.898895,286744800,9545338471.435036,4553109600,29.091004694894956,-44.0,-1.977393003537955,35.28677631301855,14.352689768757417,76.5638456923077,74.86949957295266,-85.64731023124259
2020-03-10,69.285004,71.610001,67.342499,71.334999,69.572998,285290000,9793859738.541647,4838399600,29.356287677700205,-44.0,-1.955133156961395,44.605439821000274,42.42823915806905,76.33144173076923,74.60768471569692,-57.57176084193095
2020-03-11,69.347504,70.305,67.964996,68.857498,67.156685,255598800,9733237049.862484,4582800800,29.602621876019363,-44.0,-2.1130477938947365,41.2949355639839,29.744056243681356,76.01192238461539,74.18174495897864,-70.25594375631864
2020-03-12,63.985001,67.5,62.0,62.057499,60.524651,418474000,9323512808.59921,4164326800,30.848142308429058,-80.0,-2.7551398337268864,33.86567269606374,0.4093913007321179,75.3328838076923,73.28365266572096,-99.59060869926789
2020-03-13,66.222504,69.980003,63.237499,69.4925,67.776024,370732000,9640634766.337168,4535058800,31.09478975236885,-80.0,-2.633700299877688,45.42647126880655,53.51785714285719,74.91480676923078,73.00282654233422,-46.48214285714281
2020-03-16,60.487499,64.769997,60.0,60.552502,59.056835,322423600,9392902904.653648,4212635200,31.833323562295327,-88.0,-3.221703920937429,37.04167389818474,3.453137499999981,74.11673,72.0805802799391,-96.54686250000002
2020-03-17,61.877499,64.402496,59.599998,63.215,61.653576,324056000,9556702636.446562,4536691200,32.578676933489724,-92.0,-3.4332829411872154,40.560480603482226,22.04269243381802,73.47086461538461,71.42387062957324,-77.95730756618197
2020-03-18,59.942501,62.5,59.279999,61.6675,60.144287,300233600,9701691270.994688,4236457600,33.320769863849435,-96.0,-3.6833715417682527,39.18947956095502,14.279311346931138,72.75086473076922,70.70117650886412,-85.72068865306886
2020-03-19,61.8475,63.209999,60.6525,61.195,59.68346,271857200,9545167473.666595,3964600400,33.722442164518284,-96.0,-3.8750264676734076,38.75869544425884,11.45335457814867,72.03134565384616,69.9970152859853,-88.54664542185134
2020-03-20,61.794998,62.9575,57.0,57.310001,55.894432,401693200,9185278820.437288,3562907200,34.683703324616246,-100.0,-4.290938065260946,35.320786761615196,1.6315842105263145,71.0894225,69.05723644998639,-98.36841578947369
2020-03-23,57.02,57.125,53.1525,56.092499,54.706993,336752800,9346979334.595726,3226154400,36.07701655965335,-100.0,-4.665017817612878,34.29416865314002,12.952965124173572,70.12307634615385,68.09688552776518,-87.04703487582643
2020-03-24,59.09,61.922501,58.575001,61.720001,60.195492,287531200,9599723339.375414,3513685600,35.704921235094154,-88.0,-4.456020109995578,42.598964098201066,39.41799945958126,69.3724031923077,67.62452371089368,-60.58200054041874
2020-03-25,62.6875,64.5625,61.075001,61.380001,59.863892,303602000,9349224500.12184,3210083600,34.59042853838043,-88.0,-4.268617118443629,42.251495903961725,42.079018838612065,68.66586476923077,67.16196647304972,-57.920981161387935
2020-03-26,61.630001,64.669998,61.59,64.610001,63.014111,252087200,9591490605.602686,3462170800,33.52470717925812,-88.0,-3.8154823858209426,46.69940936735855,62.07503930244943,68.03913407692308,66.97293199356456,-37.92496069755057
2020-03-27,63.1875,63.967499,61.762501,61.935001,60.405178,204216800,9419226123.019754,3257954000,32.53510877435883,-84.0,-3.630371328799498,43.69762577884735,47.582286464456914,67.34144192307693,66.59975191996718,-52.417713535543086
2020-03-30,62.685001,63.880001,62.349998,63.702499,62.129025,167976400,9548227243.948015,3425930400,31.616195969809493,-80.0,-3.3029725538818653,46.160210455118936,61.50706311033376,66.781442,66.38514059256221,-38.49293688966625
2020-03-31,63.900002,65.622498,63.0,63.572498,62.002243,197002000,9437237321.742546,3228928400,30.18308634773155,-56.0,-3.0191932794719563,46.00084188028431,61.92242544838652,66.35942276923078,66.17679669681687,-38.07757455161349
2020-04-01,61.625,62.18,59.782501,60.227501,58.739864,176218400,9326434747.150606,3052710000,29.603236854919725,-56.0,-3.0292896966212055,41.98427257844002,42.044271214808255,65.90586523076922,65.73610812668228,-57.95572878519174
2020-04-02,60.084999,61.287498,59.224998,61.232498,59.720024,165934000,9483518933.817272,3218644000,29.185590081904383,-56.0,-2.922507474198291,43.57827708410243,64.79550357586267,65.44701907692307,65.40250737655766,-35.20449642413733
2020-04-03,60.700001,61.424999,59.7425,60.352501,58.861767,129880000,9447816618.178452,3088764000,28.747123321926384,-56.0,-2.8757404512265197,42.47773596542389,57.73858985382354,65.13826923076923,65.02843283014599,-42.26141014617645
2020-04-06,62.724998,65.777496,62.345001,65.6175,63.996735,201820400,9630822449.348257,3290584400,26.903730081090846,-56.0,-2.386327730080808,50.52779826078915,98.73270454897576,65.03355784615385,65.07206743532036,-1.2672954510242422
2020-04-07,67.699997,67.925003,64.75,64.857498,63.255489,202887200,9441673799.028746,3087697200,25.359496895394265,-56.00000000000001,-2.036317037102478,49.45195777098572,79.23503552512396,64.65490396153847,65.05617340307441,-20.764964474876038
2020-04-08,65.684998,66.842499,65.307503,66.517502,64.874489,168895200,9539050332.772415,3256592400,23.92556608010458,-52.0,-1.6064642715257023,51.86284561412325,90.4721562757509,64.43134626923077,65.16441996580964,-9.527843724249104
2020-04-09,67.175003,67.517502,66.175003,66.997498,65.342644,161834800,9575514844.46799,3418427200,22.78551581424574,-48.0,-1.2130874748883258,52.567317268105604,93.72140929671829,64.09721165384616,65.30020352389782,-6.2785907032817025
2020-04-13,67.077499,68.425003,66.457497,68.3125,66.62516,131022800,9691553742.951654,3549450000,21.985653396173827,-44.0,-0.7861614778090456,54.53056951234073,98.85783779536285,63.908076923076926,65.52333659620169,-1.142162204637154
2020-04-14,70.0,72.0625,69.512497,71.762497,69.989944,194994800,9840667008.706871,3744444800,22.1600733370399,60.0,-0.1675027567035272,59.29119242909183,97.66307339231571,63.88903834615384,65.98549662611268,-2.336926607684297
2020-04-15,70.599998,71.582497,70.157501,71.107498,69.351128,131154400,9884385080.68125,3613290400,22.322034710701253,60.0,0.26685960036438416,58.04856101224394,92.56084244426997,64.06461507692308,66.36490413528952,-7.439157555730026
2020-04-16,71.845001,72.050003,70.587502,71.672501,69.902168,157125200,9960395700.588106,3770415600,22.58680542256502,60.0,0.6492023177211195,58.84972186465578,96.96203357942998,64.07759592307693,66.75805945860141,-3.037966420570007
2020-04-17,71.172501,71.737503,69.214996,70.699997,68.953697,215250000,9998581243.284319,3555165600,22.267467184755994,60.0,0.8637815940807201,56.83769112684219,89.38654108875697,64.14846126923076,67.05005483203834,-10.613458911243042
2020-04-20,69.487503,70.419998,69.212502,69.232498,67.52243,130015200,9872872117.903532,3425150400,21.969902361691606,60.0,0.9049901485609695,53.84601311014005,77.95519720269571,64.42442276923077,67.21171728892439,-22.044802797304282
2020-04-21,69.07,69.3125,66.357498,67.092499,65.43528,180991600,9781917009.920525,3244158800,20.58403624508222,60.0,0.7562506040818278,49.734894005136354,61.285295223323075,64.33211503846154,67.20288630455963,-38.714704776676925
2020-04-22,68.402496,69.474998,68.050003,69.025002,67.320061,116862400,9824971975.437737,3361021200,19.352819498357825,60.0,0.7852583159106388,53.20912702885891,76.33887028800463,64.65798042307692,67.3378578375552,-23.661129711995365
2020-04-23,68.967499,70.4375,68.717499,68.7575,67.059166,124814400,9705963038.125721,3236206800,18.544648750493703,60.0,0.7776971520624443,52.66647907878421,73.17370129870125,64.8711535,67.44301651625481,-26.826298701298757
2020-04-24,69.300003,70.752502,69.25,70.7425,68.99514,126161200,9830444554.075518,3362368000,17.904688005715858,60.0,0.921258096032517,56.233396375748256,86.41625792809452,65.22019196153846,67.68742270023594,-13.583742071905473
2020-04-27,70.449997,71.135002,69.987503,70.792503,69.0439,117087600,9877636867.173481,3479455600,17.449429122790683,60.0,1.027224794629774,56.32268587486032,82.63251965811962,65.5893266923077,67.91742864836661,-17.36748034188039
2020-04-28,71.269997,71.457497,69.550003,69.644997,67.924751,112004800,9776787839.061832,3367450800,16.82095319991542,60.0,1.0070019311988005,53.61921568505755,64.21163473499699,66.06374961538462,68.04539667441352,-35.78836526500301
2020-04-29,71.182503,72.417503,70.972504,71.932503,70.155754,137280800,9821914681.861862,3504731600,16.612663176588732,100.0,1.1621611130554612,57.95207653121802,92.23067681217461,66.67298053846153,68.33333047630882,-7.769323187825391
2020-04-30,72.489998,73.6325,72.087502,73.449997,71.635765,183064000,9961729785.498243,3687795600,16.86629950465607,76.0,1.39153422575734,60.58278097105234,97.4913683872527,67.12413423076923,68.71234281139705,-2.508631612747286
2020-05-01,71.5625,74.75,71.462502,72.267502,70.482468,240616800,9838951246.692621,3447178800,17.48485315756827,80.0,1.4610544795749547,57.560670320820975,70.4200487530416,67.54288426923077,68.97568793647875,-29.5799512469584
2020-05-04,72.292503,73.422501,71.580002,73.290001,71.479729,133568000,9953308641.965021,3580746800,18.059224406701027,80.0,1.5804385931975986,59.44457272251802,82.60353110431195,67.87673042307692,69.29526668192477,-17.39646889568805
2020-05-05,73.764999,75.25,73.614998,74.389999,72.552536,147751200,9945627396.315168,3728498000,19.19366637212864,88.0,1.7437115871390176,61.428258235204076,90.32891980232338,68.3557688076923,69.67265426104146,-9.671080197676622
2020-05-06,75.114998,75.809998,74.717499,75.157501,73.301086,142333600,9917942997.215488,3870831600,20.416699405707686,92.0,1.912985897638535,62.795640601658285,93.09709600634756,68.7963458076923,70.07893920466802,-6.9029039936524486
2020-05-07,75.805,76.292503,75.4925,75.934998,74.059372,115215200,9930183558.180382,3986046800,21.699209347862443,96.0,2.0858303642961147,64.1809251143963,96.40156195190637,69.27182657692308,70.51272133765558,-3.5984380480936213
2020-05-08,76.410004,77.587502,76.072502,77.532501,75.822105,133838400,10054304141.892065,4119885200,23.265772524671075,100.0,2.3249158083806094,66.90741264382378,99.51023169715698,69.93740349999999,71.03270501634775,-0.4897683028430295
2020-05-11,77.025002,79.262497,76.809998,78.752502,77.015205,145946400,10139551692.05115,4265831600,25.148203659543533,100.0,2.58306071404931,68.85704260339458,95.45154717585588,70.6112498076923,71.60454182995161,-4.548452824144117
2020-05-12,79.457497,79.922501,77.727501,77.852501,76.135063,162301200,9995735822.347277,4103530400,27.051411550038928,100.0,2.684079455367524,65.77831206489554,81.526107715108,71.28432673076924,72.06735362032556,-18.473892284892003
2020-05-13,78.037498,78.987503,75.802498,76.912498,75.215797,200622400,9934950480.059902,3902908000,27.52487206107859,96.0,2.6576513985043846,62.62862696973256,71.79664822706506,71.71874973076923,72.42625320400515,-28.203351772934933
2020-05-14,76.127502,77.447502,75.3825,77.385002,75.677879,158929200,10084259277.755207,4061837200,27.70409430466677,92.0,2.644351657104451,63.57284141434428,75.5362787247585,72.20057680769231,72.79356792963439,-24.463721275241493
2020-05-15,75.087502,76.974998,75.052498,76.927498,75.230446,166348400,10242387600.772112,3895488800,27.661002367063553,88.0,2.5673005245876226,61.94097826477296,71.125537936956,72.60096126923077,73.09978497188371,-28.874462063044014
2020-05-18,78.292503,79.125,77.580002,78.739998,77.002975,135178400,10310195098.85923,4030667200,28.332487863632526,60.0,2.622262736723016,65.697654227651,86.78767154894021,73.05259588461539,73.51757852952196,-13.212328451059788
2020-05-19,78.7575,79.629997,78.252502,78.285004,76.558029,101729600,10213266119.4919,3928937600,29.106201051325172,60.0,2.5991451452425025,63.99011249610053,80.64424121090325,73.43615373076923,73.87072115696478,-19.355758789096747
2020-05-20,79.169998,79.879997,79.129997,79.807503,78.046921,111504800,10303215108.90203,4040442400,29.90069133138807,60.0,2.672866096131088,67.07398662340397,98.64068541852073,73.74557703846155,74.31048277496738,-1.3593145814792649
2020-05-21,79.665001,80.222504,78.967499,79.212502,77.465057,102688800,10240620275.167345,3937753600,30.745888510425512,88.0,2.6527001961590884,64.74054680294711,88.31354623927191,74.05730796153846,74.673595310155,-11.686453760728076
2020-05-22,78.942497,79.807503,78.837502,79.722504,77.963806,81803200,10308087015.314623,4019556800,31.42762427943984,88.0,2.6473544204413457,65.83760498781538,92.43284833944911,74.36692346153846,75.04758854643981,-7.567151660550894
2020-05-26,80.875,81.059998,79.125,79.182503,77.435715,125522000,10190025376.065384,3894034800,32.46823010234586,96.0,2.569919850628949,63.581836501602425,70.39818216762826,74.6931736923077,75.3538785059628,-29.60181783237174
2020-05-27,79.035004,79.677498,78.272499,79.527496,77.773087,112945200,10278853824.536877,4006980000,32.751863232718,96.0,2.50748571358929,64.42056226643669,74.49018726591768,75.08913515384614,75.66303535737296,-25.509812734082324
2020-05-28,79.192497,80.860001,78.907501,79.5625,77.807327,133560800,10234903462.88689,4140540800,33.419642848426996,92.0,2.432787085269453,64.50987257236189,75.07285892634216,75.56875057692308,75.95188459016015,-24.92714107365784
2020-05-29,79.8125,80.287498,79.1175,79.485001,77.731552,153532400,10177821331.23333,3987008400,34.039723920156774,88.0,2.3403561931639416,64.12607672306106,73.78282147315859,75.97105823076923,76.21359691681495,-26.217178526841415
2020-06-01,79.4375,80.587502,79.302498,80.462502,78.687485,80791200,10242894447.865496,4067799600,34.72113651024626,84.0,2.3192453894554745,66.80838259553306,90.05416562630059,76.42125061538462,76.5283306266805,-9.945834373699428
2020-06-02,80.1875,80.860001,79.732498,80.834999,79.051758,87642800,10326650348.610062,4155442400,35.452103320505,76.0,2.3059902994906736,67.79653135561922,96.25469829379946,76.80942365384615,76.84734309877824,-3.745301706200534
2020-06-03,81.165001,81.550003,80.574997,81.279999,79.486954,104491200,10373268998.154373,4259933600,36.375897723646176,100.0,2.304824741261939,68.98447270199831,95.84449723393827,77.21278888461539,77.17568798035022,-4.155502766061741
2020-06-04,81.097504,81.404999,80.195,80.580002,78.802376,87560400,10341429188.205769,4172373200,36.85591036545305,96.0,2.221805529074061,64.92715012327899,85.07117732114081,77.633366,77.42785938921315,-14.928822678859193
2020-06-05,80.837502,82.9375,80.807503,82.875,81.046753,137250400,10470624975.922277,4309623600,37.846520292587506,96.0,2.314519029165325,70.95808058335341,98.83341067042863,78.05423126923077,77.83135128630848,-1.1665893295713767
2020-06-08,82.5625,83.400002,81.830002,83.364998,81.525948,95654400,10562014042.65145,4405278000,38.91332223389254,100.0,2.3998696855996116,72.06265523161763,99.31998057309372,78.43557746153846,78.24125104287822,-0.6800194269062796
2020-06-09,83.035004,86.402496,83.002502,85.997498,84.100357,147712400,10674536247.271574,4552990400,40.6659598049792,100.0,2.6493909157335906,77.10154342127242,95.01847294654591,78.96365423076924,78.81578785451687,-4.981527053454092
2020-06-10,86.974998,88.692497,86.522499,88.209999,86.264069,166651600,10767078042.841522,4719642000,42.70206428164731,100.0,2.9911880742062635,80.31507860015053,95.36950007092126,79.5375003076923,79.51165534677489,-4.630499929078743
2020-06-11,87.327499,87.764999,83.870003,83.974998,82.122482,201662400,10576287820.21372,4517979600,42.61875381410106,96.0,2.887055419742353,62.29409621585696,54.72648843118779,79.90615411538462,79.84227332108784,-45.273511568812204
2020-06-12,86.18,86.949997,83.555,84.699997,82.831497,200146000,10511144336.894588,4718125600,42.3345008894463,68.0,2.830403768299206,63.79190251597612,61.68425368219837,80.2731731923077,80.20210470471096,-38.31574631780164
2020-06-15,83.3125,86.419998,83.144997,85.747498,83.855888,138808800,10592946181.476864,4856934400,41.79440457913703,68.0,2.8373245910340614,65.89959641798475,71.73704831805142,80.65057703846153,80.61287457843608,-28.262951681948575
2020-06-16,87.864998,88.300003,86.18,88.019997,86.078247,165428800,10714675933.3408,5022363200,41.8567957433388,68.0,2.991694676184906,69.98201313986885,93.12723275512838,81.05394226923076,81.16155031336675,-6.8727672448716275
2020-06-17,88.787498,88.849998,87.772499,87.897499,85.958466,114406400,10626813966.328672,4907956800,42.06515275484736,88.0,3.068774592742585,69.49901390962646,90.21321144890032,81.40567292307693,81.66050947533958,-9.786788551099665
2020-06-18,87.852501,88.362503,87.305,87.932503,85.992691,96820400,10644896486.625256,5004777200,41.922232991807334,88.0,3.096985392407518,69.5636575535487,90.39020686043463,81.7933653076923,82.12510158827739,-9.609793139565356
2020-06-19,88.660004,89.139999,86.287498,87.43,85.501274,264476000,10592279735.01956,4740301200,41.080739362294494,96.0,3.0437088805505965,67.35667816546137,81.82302611501187,82.19788461538461,82.51805702618277,-18.176973884988126
2020-06-22,87.834999,89.864998,87.787498,89.717499,87.738312,135445200,10708492172.993279,4875746400,40.556630470722176,100.0,3.1497604353003084,71.75042232959859,98.47467393478266,82.67221142307692,83.05134902424331,-1.5253260652173473
2020-06-23,91.0,93.095001,90.567497,91.6325,89.611076,212155600,10675126676.167635,5087902000,41.00852420708524,100.0,3.3497181669668947,74.80748737396942,88.66278382459038,83.23778842307692,83.68698983726232,-11.33721617540962
2020-06-24,91.25,92.197502,89.629997,90.014999,88.029243,192623200,10540271867.85248,4895278800,40.81573373173794,96.0,3.3391753622388194,68.10365177224377,74.9338555334862,83.6714423076923,84.15573125672437,-25.066144466513798
2020-06-25,90.175003,91.25,89.392502,91.209999,89.197891,137522400,10671871210.576078,5032801200,40.48185876605192,76.0,3.388189684890733,70.22648751481262,83.26673619766855,84.16855749999999,84.67826960807811,-16.733263802331447
2020-06-26,91.102501,91.330002,88.254997,88.407501,86.457207,205256800,10486973716.025793,4827544400,39.44441711921399,76.0,3.1644182774540326,60.12087166295743,53.55461516518351,84.49932665384615,84.95450897044269,-46.44538483481648
2020-06-29,88.3125,90.542503,87.82,90.445,88.44976,130646000,10608261873.674105,4958190400,38.212199389738814,76.0,3.115572584704992,64.158988431222,73.36683482740304,84.9313458076923,85.36121200966916,-26.633165172596968
2020-06-30,90.019997,91.495003,90.0,91.199997,89.18811,140223200,10693145137.447622,5098413600,37.43387544395521,76.0,3.10202574754031,65.55099844712868,80.9547413247271,85.37278784615386,85.79371460154552,-19.04525867527291
2020-07-01,91.279999,91.839996,90.977501,91.027496,89.019409,110737200,10595245823.612759,4987676400,36.841126896386584,76.0,3.042300644376624,64.9304982673938,79.22106362972318,85.8283645,86.18140211254214,-20.77893637027682
2020-07-02,91.962502,92.6175,90.910004,91.027496,89.019409,114041600,10496898521.774746,5101718000,36.580669637198085,72.0,2.960837379568872,64.9304982673938,79.22106362972318,86.27067219230769,86.54037203013162,-20.77893637027682
2020-07-06,92.5,93.945,92.467499,93.462502,91.400696,118655600,10538056929.300697,5220373600,36.7935251922955,100.0,3.0575166407073198,69.63593837641292,93.78624597553132,86.80528765384616,87.05312239827002,-6.213754024468685
2020-07-07,93.852501,94.654999,93.057503,93.172501,91.117088,112424400,10441818586.91987,5107949200,37.21579493682129,100.0,3.0752850231866518,68.45784951414231,82.2826671905984,87.33172996153847,87.50640970210186,-17.71733280940159
2020-07-08,94.18,95.375,94.089996,95.342499,93.239212,117092000,10552987481.478954,5225041200,37.827940651915114,100.0,3.227265390961776,72.24206833715758,99.64235496179262,87.90403753846155,88.08686076120543,-0.3576450382073791
2020-07-09,96.262497,96.317497,94.672501,95.752502,93.64019,125642800,10592323015.33849,5350684000,38.66919541349116,96.0,3.3422671675267708,72.90353797643708,94.36694859092214,88.47778765384615,88.65468603815317,-5.633051409077867
2020-07-10,95.334999,95.980003,94.705002,95.919998,93.803986,90257200,10674084718.8079,5440941200,39.45036054924035,96.0,3.407641264066001,73.18466854539368,95.33998773036203,89.04086453846155,89.19285729458626,-4.66001226963797
2020-07-13,97.264999,99.955002,95.2575,95.477501,93.371246,191649200,10500386768.49303,5249292000,41.09828986062224,100.0,3.384727860909365,71.08634599630398,63.102593637809136,89.61384526923077,89.65838645795024,-36.89740636219087
2020-07-14,94.839996,97.254997,93.877502,97.057503,94.916397,170989200,10651379289.851137,5420281200,41.61340998868207,96.0,3.4542434127278483,73.95756140294674,76.12279750757358,90.15932615384615,90.20646916476873,-23.877202492426424
2020-07-15,98.989998,99.247498,96.489998,97.724998,95.56916,153198000,10635406696.92276,5573479200,42.53365662077157,92.0,3.5225900312440075,75.0832772488231,81.62337344484992,90.71163384615384,90.76339722663771,-18.376626555150086
2020-07-16,96.5625,97.404999,95.904999,96.522499,94.393204,110577600,10615871320.922758,5462901600,42.985763768669926,76.0,3.4400686294405034,69.2737941121015,71.71403020782364,91.11644157692307,91.18999735799787,-28.28596979217636
2020-07-17,96.987503,97.147499,95.839996,96.327499,94.202499,92186800,10592428289.098282,5370714800,43.35938140324846,76.0,3.320656492649263,68.35022627078564,70.10710834658296,91.4286531153846,91.57055303518321,-29.892891653417035
2020-07-20,96.417503,98.5,96.0625,98.357498,96.187714,90318000,10672185882.42259,5461032800,44.0344484750115,76.0,3.3511949781529893,72.46569942318203,83.95275058709193,91.9818261923077,92.07328969924372,-16.04724941290808
2020-07-21,99.172501,99.25,96.7425,97.0,94.860161,103433200,10589996191.096567,5357599600,44.830885673798484,76.0,3.228640447101455,66.26081110536137,67.32998724820065,92.45490323076923,92.43823120300344,-32.67001275179935
2020-07-22,96.692497,97.974998,96.602501,97.272499,95.126656,89001600,10587888615.632576,5446601200,45.45944609269342,72.0,3.1175661285043788,66.87398141783922,70.34269106527167,92.8981725,92.79632511389207,-29.657308934728334
2020-07-23,96.997498,97.077499,92.010002,92.845001,90.796814,197004400,10455807185.294167,5249596800,43.17572764087311,60.0,2.6418235469425184,50.73905468093126,10.50974197608555,93.08374957692308,92.79993073508525,-89.49025802391445
2020-07-24,90.987503,92.970001,89.144997,92.614998,90.571899,185438800,10606824410.667631,5064158000,40.33889225505106,60.0,2.220636686209531,50.06329994066453,32.0999018964376,93.26519184615384,92.78623201396782,-67.9000981035624
2020-07-27,93.709999,94.904999,93.480003,94.809998,92.718483,121214000,10711876328.508802,5185372000,37.93443179287475,60.0,2.0404402946242897,56.07557110719637,52.40516540001596,93.5297108846154,92.93614060552576,-47.59483459998404
2020-07-28,94.3675,94.550003,93.247498,93.252502,91.195351,103625600,10609046951.943495,5081746400,35.60632472664883,56.00000000000001,1.7517632095404423,51.351175981533636,37.997253470280604,93.75365326923078,92.95957478289422,-62.002746529719396
2020-07-29,93.75,95.230003,93.712502,95.040001,92.94339,90329200,10676756425.61923,5172075600,33.70100623183148,36.0,1.6482211034543468,55.93922634800703,54.532851742436804,93.95836488461538,93.11368042860576,-45.467148257563196
2020-07-30,94.1875,96.297501,93.767502,96.190002,94.068024,158130000,10821448620.410612,5330205600,32.323821592601234,36.0,1.6400531957976625,58.641665741382596,65.17115394488727,94.13365342307694,93.3415561005609,-34.82884605511274
2020-07-31,102.885002,106.415001,100.824997,106.260002,103.915878,374336800,11175026283.328348,5704542400,33.37315833089871,92.0,2.418268616342445,73.7971166870737,99.10249586508489,94.75846123076924,94.29847801903787,-0.8975041349151028
2020-08-03,108.199997,111.637497,107.892502,108.9375,106.534317,308151200,11038847215.572905,6012693600,35.00882281374763,96.0,3.2140125200018446,76.28543198821085,87.99601200400134,95.44028819230769,95.38285001762766,-12.003987995998653
2020-08-04,109.1325,110.790001,108.387497,109.665001,107.245773,173071600,11049833299.794367,6185765200,36.527654119250194,96.0,3.8588659428688743,76.92657873861857,91.23042792041794,96.25788434615384,96.44078712743303,-8.769572079582053
2020-08-05,109.377502,110.392502,108.897499,110.0625,107.634483,121776800,11117848886.534462,6307542000,37.937997474359726,24.0,4.351826625253366,77.28789437447836,92.99767922640882,97.01240357692308,97.44980289577131,-7.002320773591182
2020-08-06,110.404999,114.412498,109.797501,113.902496,111.389786,202428800,11275536988.823238,6509970800,39.696812562584384,36.0,4.9947803835289335,80.46963350234789,97.98158907760606,97.88557661538462,98.66852090349195,-2.0184109223939486
2020-08-07,113.205002,113.675003,110.292503,111.112503,108.857254,198045600,11173513497.914148,6311925200,41.32999800165014,36.0,5.219034964701763,72.52041433142281,86.93976503651865,98.65807688461538,99.59029735508514,-13.060234963481335
2020-08-10,112.599998,113.775002,110.0,112.727501,110.439476,212403600,11268040083.065626,6524328800,42.70729269606921,35.99999999999999,5.46408856573801,74.11446856143861,93.3313666436582,99.49269246153848,100.56342355100476,-6.668633356341792
2020-08-11,111.970001,112.482498,109.107498,109.375,107.155029,187902400,11109923915.83884,6336426400,43.55131054672486,36.0,5.326377335031509,65.60657776761403,80.06333115411769,100.10471161538462,101.216132917597,-19.936668845882306
2020-08-12,110.497498,113.275002,110.297501,113.010002,110.716232,165598000,11246045203.656376,6502024400,44.448675470232324,36.0,5.447756133366511,69.671813806564,94.44940756111971,100.86769242307693,102.08975284962685,-5.550592438880281
2020-08-13,114.43,116.042503,113.927498,115.010002,112.675652,210082000,11251011967.444641,6712106400,45.64639252848686,56.0,5.640314951055004,71.65685036738458,95.47049452281324,101.62413484615385,103.04680834224708,-4.5295054771867616
2020-08-14,114.830002,115.0,113.044998,114.907501,112.575211,165565200,11400910057.707872,6546541200,46.31644369983104,56.0,5.718726310200623,71.39892353381255,95.0208302213577,102.36086557692308,103.92537816874729,-4.979169778642294
2020-08-17,116.0625,116.087502,113.962502,114.607498,112.281319,119561600,11353928931.828909,6426979600,47.09437158113305,64.0,5.691057177791052,70.59795927434182,93.38545698324025,103.07961557692308,104.71664630439564,-6.614543016759749
2020-08-18,114.352501,116.0,114.0075,115.5625,113.216934,105633600,11413173874.363413,6532613200,47.816733185199205,64.0,5.680706225871404,71.68682279288163,97.6478405017921,103.85211553846155,105.5200428744404,-2.3521594982078873
2020-08-19,115.982498,117.162498,115.610001,115.707497,113.358986,145538000,11285915294.997398,6678151200,48.66079565775272,72.0,5.61942582506974,71.85723556729016,91.09410306998606,104.569423,106.27466910596334,-8.905896930013933
2020-08-20,115.75,118.392502,115.732498,118.275002,115.87439,126907200,11401610785.541323,6805058400,49.61953521228762,76.0,5.712190287973627,74.75477736582924,98.88095238095245,105.35980776923076,107.16358265366975,-1.1190476190475487
2020-08-21,119.262497,124.8675,119.25,124.370003,121.845657,338054800,11679787971.358643,7143113200,51.20302988964696,80.0,6.205983718590915,80.0150972998987,96.98120807380916,106.43086561538462,108.43813230895347,-3.018791926190848
2020-08-24,128.697495,128.785004,123.9375,125.857498,123.302956,345937600,11607888102.993235,7489050800,52.96145145539837,84.0,6.640796022139028,81.05273535663738,85.27967183414923,107.56663480769232,109.72845569347544,-14.720328165850775
2020-08-25,124.697502,125.18,123.052498,124.824997,122.291428,211495600,11748801797.559725,7277555200,54.172224605225196,84.0,6.823417593042677,78.02446729956112,79.87546287624055,108.58461553846153,110.84671801247725,-20.124537123759456
2020-08-26,126.18,126.9925,125.082497,126.522499,123.95446,163022400,11831593233.501133,7440577600,55.44481527867023,84.0,7.02415069169318,79.38795792682272,88.5020743990626,109.72009626923077,112.00788697451598,-11.497925600937398
2020-08-27,127.142502,127.485001,123.832497,125.010002,122.472694,155552400,11776335715.457182,7285025200,56.02759129889988,84.0,6.980717880759045,74.92707878580342,80.81564808060538,110.78692330769232,112.97100660603333,-19.184351919394615
2020-08-28,126.012497,126.442497,124.577499,124.807503,122.274284,187630000,11634985283.070658,7097395200,56.56874046054169,84.0,6.850983218280632,74.32491684540386,79.78655933328139,112.01625030769232,113.84778411669753,-20.213440666718604
2020-08-31,127.580002,131.0,126.0,129.039993,126.420876,225702700,11683736434.303099,7323097900,57.51556956141419,96.0,7.008899899036521,78.25798930690061,90.53251010904535,113.41721165384615,114.97313292286807,-9.467489890954662
2020-09-01,132.759995,134.800003,130.529999,134.179993,131.456528,151948100,11791558420.378614,7475046000,58.681544704831325,100.0,7.462778781121202,81.8868196335354,97.1500351298471,114.93144223076924,116.39586329895192,-2.8499648701529043
2020-09-02,137.589996,137.979996,127.0,131.399994,128.732956,200119000,11751826072.484135,7274927000,58.30562124669505,100.0,7.5115696798357305,74.63151854738567,73.61137947554674,116.39865346153846,117.50728038791846,-26.38862052445326
2020-09-03,126.910004,128.839996,120.5,120.879997,118.426498,257599600,11517700602.495996,7017327400,55.88615861347934,96.0,6.624992193873197,54.8327853652137,28.801901647191013,117.39249946153846,117.75711124807265,-71.198098352809
2020-09-04,120.07,123.699997,110.889999,120.959999,118.50486,332607200,11708021587.80875,7349934600,52.20443612226706,92.0,5.861263642832782,54.930704103628976,37.17239245172303,118.34519165384616,117.99436219265986,-62.82760754827697
2020-09-08,113.949997,118.989998,112.68,112.82,110.53009,231366600,11486921654.771242,7118568000,48.785693808998516,88.0,4.546761141102181,44.38673958286035,7.124404628025578,118.59749926923077,117.61107610431468,-92.87559537197441
2020-09-09,117.260002,119.139999,115.260002,117.32,114.938759,176940500,11497866390.82632,7295508500,45.58007752004761,84.0,3.8240396808733124,50.09030623138768,23.735702148656536,118.91990311538461,117.58951491140249,-76.26429785134346
2020-09-10,120.360001,120.5,112.5,113.489998,111.186493,182274400,11360704813.689121,7113234100,43.127156195937154,80.0,2.908698893732492,45.78628195283236,9.597634876076203,119.0670183846154,117.28584699203934,-90.4023651239238
2020-09-11,114.57,115.230003,110.0,112.0,109.72673,180860300,11318169711.590538,6932373800,41.288649074768045,64.0,2.0395437483232115,44.195288589992515,7.1479638524608795,119.14153761538462,116.8943027704068,-92.85203614753912
2020-09-14,114.720001,115.93,112.800003,115.360001,113.018547,140150100,11407274767.873306,7072523900,39.40989727546857,64.0,1.603373343819399,48.537973118122785,19.156546698577074,119.1975955,116.78065078741369,-80.84345330142293
2020-09-15,118.330002,118.830002,113.610001,115.540001,113.194885,184642000,11359168780.031158,7257165900,36.97827218505428,64.0,1.2577313078825512,48.76798308231097,19.799863445298577,119.36788388461538,116.68875080316083,-80.20013655470142
2020-09-16,115.230003,116.0,112.040001,112.129997,109.854095,154679000,11211520332.960087,7102486900,35.03467658957659,64.0,0.7005729115459047,44.69265149485285,7.6125707809250684,119.34490296153845,116.35106533626004,-92.38742921907493
2020-09-17,109.720001,112.199997,108.709999,110.339996,108.100433,178011000,11199788738.258886,6924475900,33.848791824198955,-40.0,0.11327696100812545,42.67660258847018,5.568832138930533,119.38201819230768,115.90580094098152,-94.43116786106947
2020-09-18,110.400002,110.879997,106.089996,106.839996,104.671463,287104900,11002591408.215551,6637371000,33.18597906610085,-43.99999999999999,-0.6273483787124405,38.97452725080657,2.3518344308560675,119.14471026923076,115.23425983424214,-97.64816556914393
2020-09-21,104.540001,110.190002,103.099998,110.080002,107.845718,195713800,11192232286.95909,6833084800,33.02655785565162,-48.0,-0.9419991106449288,43.83196350021461,20.011480505245427,118.95509488461538,114.8524629576316,-79.98851949475457
2020-09-22,112.68,112.860001,109.160004,111.809998,109.540604,183055400,11271390997.763826,7016140200,32.17444539811555,-48.0,-1.0397799278496507,46.29025302927621,24.97133170707175,118.83596015384616,114.62709518299222,-75.02866829292824
2020-09-23,111.620003,112.110001,106.769997,107.120003,104.945793,150718700,11140429754.616743,6865421500,31.764480219123516,-48.0,-1.47867014158156,41.04554003644939,15.617736256234345,118.54797957692307,114.07101428054835,-84.38226374376566
2020-09-24,105.169998,110.25,105.0,108.220001,106.02346,167743300,11178451633.18562,7033164800,31.652803081671827,-48.0,-1.7179299256554827,42.68574830994047,24.85438470166915,118.26557576923075,113.63760588939662,-75.14561529833085
2020-09-25,108.43,112.440002,107.669998,112.279999,110.001045,149981400,11318371207.684341,7183146200,30.955219514857173,-48.0,-1.5619321390962426,48.3927932646883,52.758620372572395,118.13374892307692,113.53704241610798,-47.241379627427605
2020-09-28,115.010002,115.32,112.779999,114.959999,112.626656,137672400,11417018267.40109,7320818600,29.585401144158535,-48.0,-1.208122680805161,51.80433216212959,68.16091745276809,118.0062488076923,113.6424466075074,-31.839082547231914
2020-09-29,114.550003,115.309998,113.57,114.089996,111.774307,99382200,11377036533.920248,7221436400,28.313426942795513,-48.0,-0.9865557071491224,50.63414825177346,63.16090078610336,117.61086392307692,113.6755984143587,-36.839099213896645
2020-09-30,113.790001,117.260002,113.620003,115.809998,113.459381,142675200,11406041586.922514,7364111600,26.64412201741328,-48.0,-0.6645124120379933,52.899354680657524,80.80099661767409,117.22442161538461,113.83370208736918,-19.199003382325913
2020-10-01,117.639999,117.720001,115.830002,116.790001,114.419518,116120400,11407884707.410727,7480232000,24.979397377587013,-48.0,-0.3264496205744081,54.189184203492474,87.03114760809984,116.91538330769231,114.05268719200849,-12.968852391900157
2020-10-02,112.889999,115.370003,112.220001,113.019997,110.726044,144712000,11336676801.15543,7335520000,24.223958479715737,-48.0,-0.3586064464012395,48.66781950976183,63.06418612480969,116.3960563076923,113.97619162223009,-36.93581387519032
2020-10-05,113.910004,116.650002,113.550003,116.5,114.135391,106243800,11432638802.68543,7441763800,23.18024537179911,-48.0,-0.10210678063707235,53.38894204019109,91.65526163024728,116.06874853846153,114.16314039095379,-8.344738369752704
2020-10-06,115.699997,116.120003,112.25,113.160004,110.863205,161498200,11347090935.536749,7280265600,22.49387296305249,-48.00000000000001,-0.16642032135588636,48.754267842295434,68.80987644120185,115.62076780769232,114.08883399162387,-31.190123558798152
2020-10-07,114.620003,115.550003,114.129997,115.080002,112.74424,96849000,11379828760.16284,7377114600,21.856527154930628,-48.0,-0.061749661561719904,51.367819853795254,81.94255500494765,115.08384507692307,114.16225384409617,-18.05744499505235
2020-10-08,116.25,116.400002,114.589996,114.970001,112.636444,83477200,11331403105.169872,7293637400,21.003926574269105,-48.0,0.01218595692728286,51.206688270501985,81.19015433854561,114.34499923076922,114.22208696675571,-18.809845661454382
2020-10-09,115.279999,117.0,114.919998,116.970001,114.595856,100506900,11429010867.098755,7394144300,20.024936380173013,-44.0,0.22951801178986386,54.030142451546894,94.10377404844544,113.78999950000001,114.42563615440343,-5.896225951554565
2020-10-12,120.059998,125.18,119.279999,124.400002,121.875061,240226800,11605720246.153774,7634371100,20.061259962610674,60.0,0.9898834563484087,62.671864707633084,96.13479682854307,113.92538430769231,115.16447806889207,-3.8652031714569173
2020-10-13,125.269997,125.389999,119.650002,121.099998,118.642036,262330500,11475925765.13706,7372040600,20.135404389239078,64.0,1.3110824632663878,57.50155003811266,78.96026870820346,113.93076888461539,115.60414621193709,-21.039731291796546
2020-10-14,121.0,123.029999,119.620003,121.190002,118.730217,150712000,11463992631.32224,7522752600,20.194788173585703,64.0,1.5549728024383995,57.60428030087213,76.29798666489918,114.25269203846155,116.01791330734916,-23.702013335100812
2020-10-15,118.720001,121.199997,118.150002,120.709999,118.259949,112559200,11540385357.02861,7410193400,19.77825454229104,64.0,1.6900436516194617,56.815494787638734,64.46468708651281,114.38307661538462,116.36547521050848,-35.53531291348719
2020-10-16,121.279999,121.550003,118.809998,119.019997,116.60424,115393800,11442679541.252144,7294799600,19.47591228483974,64.0,1.6417936599337395,54.011247371871335,51.632475570611355,114.59576888461538,116.56210645417451,-48.367524429388645
2020-10-19,119.959999,120.419998,115.660004,115.980003,113.625954,120639300,11338260621.093252,7174160300,18.221249815622468,64.0,1.3427744167619267,49.297714781479094,28.549753766097748,114.74884592307693,116.51898767979121,-71.45024623390225
2020-10-20,116.199997,118.980003,115.629997,117.510002,115.124893,124423700,11353488717.608541,7298584000,17.04740452180302,64.0,1.2152490106670513,51.587641837632,40.16706001018377,114.83153826923078,116.59239614795483,-59.83293998981624
2020-10-21,116.669998,118.709999,116.449997,116.870003,114.497894,89946000,11296974422.249512,7208638000,15.957405320399246,64.0,1.0504329003572082,50.558997127402286,35.30753763212415,114.8826921923077,116.6129596184767,-64.69246236787585
2020-10-22,117.449997,118.040001,114.589996,115.75,113.400604,101988000,11263569794.129843,7106650000,15.27134684924434,64.0,0.8199877552385857,48.72785688936606,26.63622729347239,115.02192307692309,116.54903668377472,-73.3637727065276
2020-10-23,116.389999,116.550003,114.279999,115.040001,112.70504,82572600,11236288146.16799,7024077400,14.728946307500722,64.0,0.573456877949198,47.5521038082559,21.23288593857582,115.2026925,116.43725626275436,-78.7671140614242
2020-10-26,114.010002,116.550003,112.879997,115.050003,112.714836,111850700,11256707905.728111,7135928100,14.649907280954677,64.0,0.37456866493957364,47.571295874522114,17.346168289981094,115.51846199999999,116.33449676180959,-82.6538317100189
2020-10-27,115.489998,117.279999,114.540001,116.599998,114.233368,92276800,11303182981.583202,7228204900,14.2933047118477,52.0,0.3381223024398423,50.58879555590055,29.736214270789056,115.76923107692308,116.35416352019406,-70.26378572921095
2020-10-28,115.050003,115.43,111.099998,111.199997,108.942978,143937800,11165893509.257046,7084267100,14.933016557979986,52.00000000000001,-0.1250550961276531,41.60479581330717,0.6997830161103334,115.7457695,115.9723734075871,-99.30021698388967
2020-10-29,112.370003,116.93,112.199997,115.32,112.979347,146129200,11212543697.510118,7230396300,14.946121410260787,52.0,-0.15785703408077723,49.040601911124405,29.531152587043156,116.06115399999999,115.92404945146954,-70.46884741295685
2020-10-30,111.059998,111.989998,107.720001,108.860001,106.650475,190272600,11123868716.431162,7040123700,16.019821888956333,48.0,-0.6970851731143455,40.36210875985274,6.451613633459382,116.08576938461539,115.40078660321254,-93.54838636654061
2020-11-02,109.110001,110.68,107.32,108.769997,106.562302,122866900,11107047433.335508,6917256800,17.09963557638794,-56.0,-1.1187931775068876,40.25522178138803,9.229771434103908,115.95076930769231,114.90961700297458,-90.77022856589609
2020-11-03,109.660004,111.489998,108.730003,110.440002,108.198402,107624400,11132783866.507744,7024881200,17.77591436992642,-56.0,-1.3032216347659187,43.25782256338812,21.92551891942687,115.77692326923078,114.57853441016165,-78.07448108057314
2020-11-04,114.139999,115.589996,112.349998,114.949997,112.616852,138235500,11216407862.57194,7163116700,16.960747064100577,-56.0,-1.0730936552991466,50.49384361687659,53.61908216041836,115.81000023076923,114.60605015755708,-46.38091783958164
2020-11-05,117.949997,119.620003,116.870003,119.029999,116.614059,126387100,11288563039.264013,7289503800,16.392923132594813,-56.0,-0.5550947237477004,55.96479489061142,89.38931899073572,115.93384642307691,114.9337500718121,-10.610681009264288
2020-11-06,118.32,119.199997,116.129997,118.690002,116.481567,114457900,11364992954.436327,7175045900,15.649269938593319,-56.0,-0.17005150701939442,55.41521347244417,92.43901810430461,116.00692338461538,115.21199095538158,-7.56098189569539
2020-11-09,120.5,121.989998,116.050003,116.32,114.155655,154515300,11224524355.638634,7020530600,15.639656675560484,-56.0,-0.055501550813232825,51.61056898423874,61.34970161550122,116.13384657692308,115.29406569942739,-38.65029838449879
2020-11-10,115.550003,117.589996,114.129997,115.970001,113.812172,138023400,11233300771.530834,6882507200,15.054045180869625,-56.0,0.006957914029911194,51.05311364454612,58.96388670264304,116.11346200000001,115.3441349809513,-41.03611329735696
2020-11-11,117.190002,119.629997,116.440002,119.489998,117.26667,112295000,11335739212.066008,6994802200,14.999838126090935,-56.0,0.33661158119728896,56.17947464274732,82.95841621791634,116.35692330769231,115.65123594532527,-17.04158378208367
2020-11-12,119.620003,120.529999,118.57,119.209999,116.991882,103162300,11299948139.130613,6891639900,15.15756240156021,-56.0,0.5687151143774543,55.67992160866093,81.04976565095645,116.51576934615385,115.91484802344932,-18.950234349043555
2020-11-13,119.440002,119.669998,117.870003,119.260002,117.040962,81581900,11344365210.703423,6973221800,15.072288681997204,-56.0,0.7480703712635943,55.75558514712017,81.39061777649869,116.68076938461537,116.16263720689753,-18.609382223501317
2020-11-16,118.919998,120.989998,118.150002,120.300003,118.061607,91183000,11391241236.97177,7064404800,15.32016201768948,-56.0,0.9630288959320694,57.385142127735485,88.47992344647903,116.80884638461538,116.46910874712735,-11.52007655352097
2020-11-17,119.550003,120.669998,118.959999,119.389999,117.168556,74271000,11354322925.482115,6990133800,15.550330115118024,-56.00000000000001,1.0478760945078704,55.4603324585713,82.27675968326652,116.61615396153846,116.68547098808088,-17.723240316733484
2020-11-18,118.610001,119.82,118.0,118.029999,115.833847,76322100,11280516854.798489,6913811700,15.400300883156847,-52.0,0.9939201834831124,52.61968794225316,73.00613810581301,116.49807707692307,116.78506565563043,-26.993861894186995
2020-11-19,117.589996,119.059998,116.809998,118.639999,116.432495,74113000,11326961067.343378,6987924700,14.821462280613913,20.0,0.9889812767431039,53.76360360999626,77.16428454864142,116.40000003846154,116.92246812558373,-22.835715451358585
2020-11-20,118.639999,118.769997,117.290001,117.339996,115.156685,73604300,11258329546.970486,6914320400,14.283969292538332,20.0,0.8701373779953059,50.940920756768094,64.93209839068567,116.27038453846154,116.95339611628124,-35.067901609314326
2020-11-23,117.18,117.620003,113.75,113.849998,111.731621,127959300,11136982993.30758,6786361100,13.950579028102668,20.0,0.48870556697642087,44.2276644630414,15.560165975103734,116.07153842307692,116.72351477433449,-84.43983402489626
2020-11-24,113.910004,115.849998,112.589996,115.169998,113.027046,113874200,11203351421.225233,6900235300,13.981197701768465,20.000000000000007,0.289592831084434,47.068922073219206,27.446823947484344,116.04038438461538,116.60843945771711,-72.55317605251565
2020-11-25,115.550003,116.75,115.169998,116.029999,113.871048,76499200,11210129822.77156,6976734500,13.665086922577661,20.0,0.19889668950426653,48.89559107305051,36.595768809410934,115.98346119230769,116.56559201640474,-63.40423119058906
2020-11-27,116.57,117.489998,116.220001,116.589996,114.420639,46691300,11190644173.719555,7023425800,13.089859851037756,19.999999999999996,0.1702439553374262,50.1031102130546,42.5531824354931,115.97269169230769,116.56739971889327,-57.4468175645069
2020-11-30,116.970001,120.970001,116.809998,119.050003,116.834869,169410200,11203676003.232996,7192836000,12.917237382569025,20.0,0.34209500457606623,55.11988848634347,76.90482692742222,116.09961488461538,116.75129625823452,-23.095173072577794
2020-12-01,121.010002,123.470001,120.010002,122.720001,120.436584,127728200,11276030690.119265,7320564200,13.43697952336523,80.0,0.7656009946681621,61.361365423466275,93.10662081497205,116.39499950000001,117.19342253540233,-6.89337918502795
2020-12-02,122.019997,123.370003,120.889999,123.080002,120.789879,89004200,11344219353.528032,7409568400,13.919597225533135,80.0,1.1174009128922506,61.920793038766185,96.41545201495768,116.70384561538461,117.62946545870587,-3.584547985042316
2020-12-03,123.519997,123.779999,122.209999,122.940002,120.652481,78967600,11338686893.531599,7330600800,14.481003042662072,88.0,1.3691256247442567,61.54759254300988,92.4933264092959,116.94769192307693,118.02283853583877,-7.506673590704099
2020-12-04,122.599998,122.860001,121.519997,122.25,119.975334,78260400,11345695383.447151,7252340400,14.699960609373148,88.0,1.4957003747736621,59.63972452383177,86.32709035019917,117.37269203846154,118.33596160725813,-13.672909649800836
2020-12-07,122.309998,124.57,122.25,123.75,121.447426,86712000,11371110969.654049,7339052400,15.403250500341597,96.0,1.697481727363396,62.37053109857031,93.15526104999637,117.69692280769232,118.73700148820197,-6.844738950003636
2020-12-08,124.370003,124.980003,123.089996,124.379997,122.065697,82225500,11401129474.279959,7421277900,16.17191059884105,100.0,1.886484180505036,63.48792235817566,95.1573392977099,118.29384573076923,119.15500115574257,-4.842660702290108
2020-12-09,124.529999,125.949997,121.0,121.779999,119.514061,115089200,11322310785.518976,7306188700,15.936307985240727,100.0,1.8056573824763547,56.085904550441406,68.7874424560298,118.79423042307691,119.34944544050238,-31.212557543970195
2020-12-10,120.5,123.870003,120.150002,123.239998,120.946892,81312200,11376081545.309149,7387500900,15.361941909112133,96.0,1.8382214081521795,58.97817074189168,79.71557786560048,119.28653796153846,119.63763451898367,-20.284422134399517
2020-12-11,122.43,122.760002,120.550003,122.410004,120.132339,86939800,11435483996.993244,7300561100,14.828601981278439,40.0,1.7765757939876181,56.69223015290611,73.50304839049042,119.57346130769231,119.84299522128119,-26.496951609509583
2020-12-14,122.599998,123.349998,121.540001,121.779999,119.514061,79184500,11377298561.224842,7221376600,14.558932808223988,40.0,1.6577752610212144,54.95120677922955,68.7874424560298,119.67923053846154,119.98647698266777,-31.212557543970195
2020-12-15,124.339996,127.900002,124.129997,127.879997,125.500557,157243700,11532873478.17628,7378620300,15.716721760270255,56.0,2.03241542167693,65.87787029654993,99.84285158119354,120.03269188461539,120.57118216913682,-0.15714841880644828
2020-12-16,127.410004,128.369995,126.559998,127.809998,125.431862,98208600,11570312340.575388,7280411700,16.910805788896766,60.0,2.2971915199493225,65.68099512096597,95.39096891735093,120.47461488461538,121.10739074920076,-4.609031082649062
2020-12-17,128.899994,129.580002,128.039993,128.699997,126.305305,94359800,11556832386.65317,7374771500,18.321440632351756,64.0,2.5494554314738735,67.03011698352489,93.10881186881375,120.96423011538461,121.66980602703774,-6.891188131186257
2020-12-18,128.960007,129.100006,126.120003,126.660004,124.303276,192541500,11434071086.566727,7182230000,18.688798664682707,64.0,2.5553099897170597,61.1010169940452,69.48800417972826,121.23999957692307,122.03945032133123,-30.51199582027173
2020-12-21,125.019997,128.309998,123.449997,128.229996,125.84407,121251600,11551330765.37033,7303481600,17.91579122903894,64.0,2.656018079625909,63.75797504563827,85.68392364793206,121.58692253846154,122.49800926049187,-14.316076352067938
2020-12-22,131.610001,134.410004,129.649994,131.880005,129.426163,168904800,11540685953.039602,7472386400,18.758503737524688,76.0,2.995821226082967,69.05069099770418,82.25807401710057,122.07230726923078,123.19297190786284,-17.741925982899424
2020-12-23,132.160004,132.429993,130.779999,130.960007,128.523254,88223700,11471711985.813902,7384162700,19.541022495404313,76.0,3.154518195801927,66.4178270002829,75.80647604397251,122.48230742307692,123.76830784061374,-24.193523956027494
2020-12-24,131.320007,133.460007,131.100006,131.970001,129.514481,54930100,11457280946.915571,7439092800,20.490433212990876,76.0,3.3234738251167784,67.8663871957479,82.88918192297594,122.96615365384615,124.37584066723494,-17.11081807702406
2020-12-28,133.990005,137.339996,133.509995,136.690002,134.146652,124486200,11539513746.416302,7563579000,22.103940178080368,88.0,3.7944964198778024,73.5979535392931,96.21876540503725,123.68384607692307,125.28800076595827,-3.781234594962746
2020-12-29,138.050003,138.789993,134.339996,134.869995,132.360489,121047300,11447300150.327875,7442531700,23.837383342815734,92.0,3.975103348310185,68.52263316248603,78.9699576571683,124.3080766923077,125.99777811662803,-21.030042342831706
2020-12-30,135.580002,135.990005,133.399994,133.720001,131.231903,96452100,11374682194.01661,7346079600,25.04116895388308,92.0,3.9795667669018115,65.45132518981424,72.80045897017862,124.93807688461538,126.56979462650743,-27.199541029821372
2020-12-31,134.080002,134.740005,131.720001,132.690002,130.221069,99116600,11339236503.801231,7246963000,25.46036363581047,92.0,3.855547396659915,62.738933725763935,66.55704855101338,125.66269242307693,127.0231433208402,-33.44295144898662
2021-01-04,133.520004,133.610001,126.760002,129.410004,127.002113,143301900,11306810626.29519,7103661100,24.156945717578033,88.0,3.4527910992150055,54.93199523313707,45.623226955699344,126.21038496153845,127.1999478155928,-54.376773044300656
2021-01-05,128.889999,131.740005,128.429993,131.009995,128.572327,97664900,11361396314.709856,7201326000,22.946629079219345,84.0,3.2255278564964556,57.6972841840248,49.28292028237817,126.78653865384616,127.4821735329563,-50.71707971762183
2021-01-06,127.720001,131.050003,126.379997,126.599998,124.244392,155088000,11220920507.965282,7046238000,21.40383720896516,80.0,2.6589198246628882,48.8079680382031,20.5345620689862,127.17153873076921,127.41682719718176,-79.4654379310138
2021-01-07,128.360001,131.630005,127.860001,130.919998,128.484024,109578200,11289224858.363317,7155816200,19.950663520011403,76.0,2.5293104569908564,55.96511568600387,48.69623825195254,127.628077,127.67632133072385,-51.30376174804746
2021-01-08,132.429993,132.630005,130.229996,132.050003,129.592987,105158200,11343556610.365498,7260974400,18.89976737898618,48.0,2.489083454319143,57.63366780602709,56.06263521841857,127.98692323076922,128.00029775067023,-43.93736478158143
2021-01-11,129.190002,130.169998,128.5,128.979996,126.580101,100384500,11300877758.470465,7160589900,17.723969905265587,48.0,2.18430010516812,51.88188655174585,36.04954655790001,128.21384607692306,128.07286799136133,-63.95045344209999
2021-01-12,128.5,129.690002,126.860001,128.800003,126.403465,91951100,11334993976.398764,7068638800,17.115151354256238,48.0,1.906259007056434,51.557012682579554,19.500457534394045,128.43923073076922,128.1267298438531,-80.49954246560596
2021-01-13,128.759995,131.449997,128.490005,130.889999,128.454559,88636800,11390092556.885738,7157275600,15.971356853372878,48.0,1.8334201181421008,55.07475481092784,36.34168778136579,128.77153838461538,128.33141644801213,-63.65831221863421
2021-01-14,130.800003,131.0,128.759995,128.910004,126.511398,90221800,11311954731.6949,7067053800,14.909261959695472,48.00000000000001,1.5975106169341018,51.2759244192403,20.38684782815387,128.97000007692307,128.3742747851964,-79.61315217184612
2021-01-15,128.779999,130.220001,127.0,127.139999,124.77433,111598500,11210060376.756657,6955455300,14.482497230186555,48.0,1.253279006392944,48.08303217845054,6.124111562969075,129.076154,128.28284694925594,-93.87588843703092
2021-01-19,127.779999,128.710007,126.940002,127.830002,125.4515,90757300,11210572872.03972,7046212600,14.1050734182611,48.0,1.0243424681468412,49.4056487606406,11.684169761214987,129.30884642307691,128.24930287894068,-88.31583023878501
2021-01-20,128.660004,132.490005,128.550003,132.029999,129.573349,104319500,11290533198.660114,7150532100,13.722583756078334,44.0,1.1683453117643126,56.645669526351256,58.792895906018025,129.64692338461538,128.5293544434636,-41.207104093981975
2021-01-21,133.800003,139.669998,133.589996,136.869995,134.323288,120150900,11300018713.861654,7270683000,15.007468570878627,100.0,1.653950123011441,63.18384939714796,78.93150647618458,130.20307688461537,129.1471796698737,-21.06849352381543
2021-01-22,136.279999,139.850006,135.020004,139.070007,136.482376,114459400,11377509923.148441,7385142400,16.233490543510946,84.0,2.191060831276161,65.71486582620062,94.2093654131931,130.86807719230768,129.88220391654974,-5.790634586806909
2021-01-25,143.070007,145.089996,136.539993,142.919998,140.260742,157611700,11455117657.354136,7542754100,18.217870169400204,88.0,2.894026499218313,69.64739460942147,88.40193417434163,131.44653876923076,130.84796644124975,-11.598065825658354
2021-01-26,143.600006,144.300003,141.369995,143.160004,140.496231,98390600,11476945199.77245,7641144700,20.060508393440227,88.0,3.4309484954782192,69.87933568708209,89.68470281585783,132.03692361538464,131.7599692233794,-10.315297184142159
2021-01-27,143.429993,144.300003,140.410004,142.059998,139.416702,140843800,11455582882.897356,7500300900,21.403555334953047,88.0,3.7247649826279314,67.33947971362474,83.37905194159404,132.5507698076923,132.52293431794388,-16.620948058405958
2021-01-28,139.520004,141.990005,136.699997,137.089996,134.539246,142621100,11333990895.283916,7357679800,21.365337236135435,88.0,3.5160482248947744,57.2200755447393,56.116279790532076,132.95192334615385,132.86123518328137,-43.883720209467924
2021-01-29,135.830002,136.740005,130.210007,131.960007,129.504639,177523800,11251617706.35608,7180156000,20.04270717889718,48.0,2.9032248822275335,49.029939811800766,27.975904546325925,133.0953853076923,132.79447754007535,-72.02409545367408
2021-02-01,133.75,135.380005,130.929993,134.139999,131.644104,106239800,11298649580.876865,7286395800,18.814550697175946,48.0,2.563909945582566,52.16341317097269,39.93417441968572,133.18230815384615,132.89414579636605,-60.06582558031429
2021-02-02,135.729996,136.309998,134.610001,134.990005,132.478256,83305400,11252587052.742638,7369701200,17.499187486171333,48.0,2.336653309230144,53.36721226914601,44.352648270847844,133.33730807692308,133.04939462626484,-55.64735172915216
2021-02-03,135.759995,135.770004,133.610001,133.940002,131.447815,89880900,11190169806.155062,7279820300,16.473715152392934,48.0,2.048213787196403,51.638507838904744,38.56750586253629,133.41307734615384,133.11536554283782,-61.43249413746371
2021-02-04,136.300003,137.399994,134.589996,137.389999,134.833603,84183100,11273754037.341276,7364003400,15.502193196322178,48.0,2.074100374922722,56.61166386294739,57.57576008014096,133.44000030769232,133.43200505818317,-42.42423991985905
2021-02-05,137.350006,137.419998,135.860001,136.759995,134.415894,75693800,11285398823.040094,7288309600,14.605408761699513,48.0,2.020488688669275,55.48950962974964,54.10466251393799,133.51269261538462,133.6785228316511,-45.89533748606202
2021-02-08,136.029999,136.960007,134.919998,136.910004,134.563339,71297200,11353200867.977936,7359606800,13.627490247965225,48.0,1.9674262485713427,55.71460463147999,50.5441628663324,133.63538503846152,133.91789180708435,-49.4558371336676
2021-02-09,136.619995,137.880005,135.850006,136.009995,133.678757,76774200,11288528178.849419,7282832600,12.862929613231168,48.00000000000001,1.8316367100493665,53.95172355563861,38.978442793203705,133.76307707692308,134.072862413967,-61.021557206796295
2021-02-10,136.479996,136.990005,134.399994,135.389999,133.069397,73046600,11271324198.230572,7209786000,12.181138319535576,48.0,1.6549171717766171,52.71432576163498,34.81179992807784,133.9930768846154,134.17042808700646,-65.18820007192215
2021-02-11,135.899994,136.389999,133.770004,135.130005,132.813843,64280000,11273777809.768,7145506000,11.738586886555314,48.0,1.4768619760156128,52.17392414691342,33.06452713103493,134.1515388076923,134.2415078583393,-66.93547286896506
2021-02-12,134.350006,135.529999,133.690002,135.369995,133.049744,60145100,11323462613.82143,7205651100,11.352889935922642,32.0,1.3396742075302939,52.65638700265252,36.62164275987015,134.48884638461539,134.32509949846232,-63.37835724012985
2021-02-16,135.490005,136.009995,132.789993,133.190002,130.907074,80576300,11262905708.335283,7125074800,11.286153688784287,32.0,1.0430213950984637,47.926790232452625,21.149722114896267,134.57615423076922,134.24101820227992,-78.85027788510374
2021-02-17,131.25,132.220001,129.470001,130.839996,128.597351,97918500,11262549284.995285,7027156300,12.168083979020585,32.0,0.6112499506564575,43.401217708207156,10.942448580687492,134.5296155,133.98909063174065,-89.0575514193125
2021-02-18,129.199997,130.0,127.410004,129.710007,127.48674,96856700,11337716557.673311,6930299600,13.476458316917377,32.0,0.17586009588669071,41.37794674346644,21.96755282067296,134.55769284615383,133.67212147383395,-78.03244717932704
2021-02-19,130.240005,130.710007,128.800003,129.869995,127.643997,87668800,11348272593.484755,7017968400,14.390971763558593,16.000000000000004,-0.15449883985471047,41.7916938531521,23.495613801755947,134.59884638461537,133.3904824757722,-76.50438619824405
2021-02-22,128.009995,129.720001,125.599998,126.0,123.840332,103916400,11264534221.429296,6914052000,15.952496436902551,-76.0,-0.7202839451808529,35.301283936510714,3.2573434200811144,134.4107695,132.8430393294187,-96.74265657991887
2021-02-23,123.760002,126.709999,118.389999,125.860001,123.702736,158273000,11390467862.425932,6755779000,18.527743078318878,-80.0,-1.1665225212035182,35.08898288493248,38.327345820211605,134.2934616923077,132.32577723094323,-61.6726541797884
2021-02-24,124.940002,125.559998,122.230003,125.349998,123.201469,111039900,11487502708.964891,6644739100,20.919043531062613,-80.0,-1.5435299352246545,34.280189958335214,35.71060470684305,134.2246155,131.80905284346596,-64.28939529315694
2021-02-25,124.68,126.459999,120.540001,120.989998,118.916206,148199500,11361833395.766136,6496539600,23.355340822396432,-80.0,-2.169122297375395,28.279094832847676,13.340165210826491,133.96153842307692,131.0076413735796,-86.65983478917352
2021-02-26,122.589996,124.849998,121.199997,121.260002,119.181572,164560400,11202683650.065683,6661100000,25.617616878634983,-80.0,-2.613000640400898,29.1067709834374,14.725511115799533,133.54730776923077,130.28559401257368,-85.27448888420047
2021-03-01,123.75,127.93,122.790001,127.790001,125.599648,116307900,11312655755.178524,6777407900,26.417946761211,-80.0,-2.410079186755368,45.490549932246466,48.22985688152172,133.19807723076923,130.10073527090157,-51.77014311847828
2021-03-02,128.410004,128.720001,125.010002,125.120003,122.97541,102260900,11216458900.619453,6675147000,26.8540607311139,-80.0,-2.436621145446111,41.288853690530054,36.182805532428304,132.66153861538461,129.73179213972367,-63.817194467571696
2021-03-03,124.809998,125.709999,121.839996,122.059998,119.96785,112966300,11116336421.119127,6562180700,27.83516836523171,-76.0,-2.6737513279480254,37.063651010712775,20.388883333333293,131.85923092307692,129.16351109233673,-79.6111166666667
2021-03-04,121.75,123.599998,118.620003,120.129997,118.070938,178155000,11046218871.385645,6384025700,29.236934886373234,-72.0,-2.98302717659827,34.65486088609937,9.875132775285532,130.9734614230769,128.4943619003118,-90.12486722471446
2021-03-05,120.980003,121.940002,117.57,121.419998,119.338821,153766600,11163390867.050728,6537792300,30.685032211515963,-100.0,-3.088436640052464,37.57514754837263,20.878519760986983,130.17961526923077,127.97033494473314,-79.12148023901301
2021-03-08,120.93,121.0,116.209999,116.360001,114.365562,154376600,11018683074.53248,6383415700,32.21587504698733,-72.0,-3.5394730272025896,31.608146393194545,0.9369268036318836,129.38230776923075,127.11031020808623,-99.06307319636812
2021-03-09,119.029999,122.059998,118.790001,121.089996,119.014488,129525800,11071364592.992405,6512941500,33.18610060813531,-72.0,-3.4751917005856967,41.034589660716115,33.65513315578864,128.9642304230769,126.66436100748724,-66.34486684421135
2021-03-10,121.690002,122.169998,119.449997,119.980003,117.923508,111943300,11003046733.32114,6400998200,34.038909803518116,-72.0,-3.473771963770943,39.65335439939057,26.000013241372017,128.4196151923077,126.16922337730301,-73.99998675862798
2021-03-11,122.540001,123.209999,121.260002,121.959999,119.869568,103026500,10973987773.702484,6504024700,34.36508144202975,-72.0,-3.275124090610973,43.318471630197784,42.56105957645306,127.91846111538462,125.85742897898427,-57.43894042354694
2021-03-12,120.400002,121.169998,119.160004,121.029999,118.955513,88105100,11049819577.468863,6415919600,35.05825810966443,-72.0,-3.156352975279262,42.02734162218717,38.52917049893363,127.42192253846154,125.4998415731336,-61.47082950106637
2021-03-15,121.410004,124.0,120.419998,123.989998,121.864769,92403800,11141707052.166475,6508323400,34.52475626469963,-72.0,-2.791203571811039,47.400972864968175,62.190229865670716,126.90653788461539,125.38800130845702,-37.809770134329284
2021-03-16,125.699997,127.220001,124.720001,125.57,123.417694,115227900,11104834031.984156,6623551300,32.9089832179918,-72.0,-2.3472692235460926,50.061867615063335,74.82013991684411,126.47615346153846,125.40148269301577,-25.179860083155887
2021-03-17,124.050003,125.860001,122.339996,124.760002,122.621574,111932600,11146808919.953974,6511618700,31.969500792572934,-72.0,-2.0373231304775743,48.70166139898549,68.34533679530989,126.00884569230769,125.35396560464423,-31.654663204690106
2021-03-18,122.879997,123.18,120.32,120.529999,118.464096,121229700,11043382098.115023,6390389000,31.528907996671958,-68.0,-2.1087066515153197,42.246206676964285,34.53236857995712,125.41346123076923,124.99663474504095,-65.46763142004288
2021-03-19,119.900002,121.43,119.68,119.989998,117.933342,185549500,10923569711.144735,6204839500,31.252600163943782,-64.0,-2.1836800694051135,41.49012899341343,30.21581451385862,124.82115350000001,124.6257727639268,-69.78418548614138
2021-03-22,120.330002,123.870003,120.260002,123.389999,121.275055,111912300,11005721159.749292,6316751800,30.145346760656903,-56.0,-1.9463095327728581,47.82204204727177,65.21343047894094,124.36961480769232,124.53423396659889,-34.786569521059064
2021-03-23,123.330002,124.239998,122.139999,122.540001,120.439629,95467100,10946622677.957396,6221284700,28.993115097052023,-56.00000000000001,-1.805961408257275,46.468147910068126,57.49319573238958,123.8761535,124.38651300611008,-42.50680426761042
2021-03-24,122.82,122.900002,120.07,120.089996,118.031616,88530500,10859343241.297987,6132754200,28.432434563914832,-52.0,-1.8708632889558174,42.714403593267924,35.240656632033335,123.37230711538463,124.06825248713896,-64.75934336796666
2021-03-25,119.540001,121.660004,119.0,120.589996,118.523056,98844700,10878665790.385733,6231598900,28.160311394872167,-44.0,-1.8605059215377935,43.71371224688869,39.78198187429941,122.97807634615384,123.810603858462,-60.21801812570058
2021-03-26,120.349998,121.480003,118.919998,121.209999,119.132431,94071200,10952893591.41987,6325670100,27.926684890741274,-44.0,-1.7817298995261126,44.99505239650034,28.70697508896791,122.65115296153847,123.6179664615389,-71.29302491103209
2021-03-29,121.650002,122.580002,120.730003,121.389999,119.309357,80819200,10929739664.453207,6406489300,27.265441450393602,-40.0,-1.6853472053628167,45.38378131876884,29.759037436492488,122.32499926923077,123.45293183475825,-70.24096256350751
2021-03-30,120.110001,120.400002,118.860001,119.900002,117.844894,85671900,10959780496.681173,6320817400,27.136881263323463,-16.0,-1.709487622125323,42.694043441155955,12.440203349282342,122.09038396153846,123.18975184699838,-87.55979665071766
2021-03-31,121.650002,123.519997,121.150002,122.150002,120.056313,118323800,10941308215.355263,6439141200,25.847575731532775,-16.0,-1.529432534151482,47.73170959938847,39.35407894736847,121.9476916923077,123.1127333398133,-60.64592105263153
2021-04-01,123.660004,124.18,122.489998,123.0,120.891762,75089100,10911539287.968313,6514230300,24.42532582856082,-16.000000000000004,-1.3031281941816815,49.53650113512609,49.52151913875602,121.85730715384616,123.10438272204937,-50.47848086124398
2021-04-05,123.870003,126.160004,123.07,125.900002,123.74205,88651200,10985271743.978079,6602881500,22.902442397508775,-16.0,-0.8796345694853187,55.21793485458393,84.21053827751201,122.04615346153847,123.3114656315272,-15.789461722487989
2021-04-06,126.5,127.129997,125.650002,126.209999,124.046738,80171300,10965770496.898663,6683052800,21.786536588890346,-16.0,-0.5130841390880363,55.79091033153847,88.87547224932145,122.23653796153846,123.52617180696963,-11.124527750678551
2021-04-07,125.830002,127.919998,125.139999,127.900002,125.707764,83466700,11048036476.94646,6766519500,20.991503828183756,-16.0,-0.08523858662192652,58.879796080854526,99.77929352515233,122.24076876923078,123.85015922867558,-0.2207064748476859
2021-04-08,128.949997,130.389999,128.520004,130.360001,128.125595,88844600,11134030630.489868,6855364100,20.950256642281882,88.0,0.44717865917485256,62.93898884276534,99.73982649433262,122.44230715384616,124.33236973025517,-0.2601735056673712
2021-04-09,129.800003,133.039993,129.470001,133.0,130.720337,106686700,11238327005.137262,6962050800,21.548931937850906,92.0,1.0698168356917108,66.73419967827178,99.71796175907568,122.86307646153847,124.97441641690293,-0.28203824092432267
2021-04-12,132.520004,132.850006,130.630005,131.240005,128.990494,91420000,11197146802.326542,6870630800,22.104844712307855,92.0,1.4050486624705343,62.163855170095665,87.30614234479108,123.29038446153847,125.43853408972493,-12.693857655208914
2021-04-13,132.440002,134.660004,131.929993,134.429993,132.125824,91266500,11273034390.716663,6961897300,23.032560748545507,100.0,1.906154707240617,66.62534189997402,98.54423445362643,123.79076888461539,126.10456808307863,-1.4557655463735708
2021-04-14,134.940002,135.0,131.660004,132.029999,129.766968,87222800,11205136164.689806,6874674500,23.96923011418941,100.0,2.0855840846844984,60.81515217298253,81.59850567524822,124.39346111538461,126.54348889173947,-18.40149432475179
2021-04-15,133.820007,135.0,133.639999,134.5,132.194611,89347100,11228786915.937122,6964021600,24.838994525144468,39.99999999999999,2.39943243356862,64.26874251012686,96.90210637559518,124.90923049999999,127.13286008494396,-3.0978936244048088
2021-04-16,134.300003,134.669998,133.279999,134.160004,131.860474,84922400,11251392847.413618,6879099200,25.456669913344808,40.0,2.5908588672120914,63.43989154069611,94.79556349414884,125.45461515384615,127.653389263837,-5.2044365058511675
2021-04-19,133.509995,135.470001,133.339996,134.839996,132.528793,94264200,11289894814.629189,6973363400,26.24240638195646,52.0,2.7655557611810764,64.42798891501675,96.20707405177615,125.94999965384615,128.18573050355278,-3.7929259482238584
2021-04-20,135.020004,135.529999,131.809998,133.110001,130.828461,94812300,11261349311.028921,6878551100,26.150987650280364,56.0,2.732904942938177,59.9860911280854,83.17108132915472,126.4146151153846,128.5504912810674,-16.828918670845287
2021-04-21,132.360001,133.75,131.300003,133.5,131.211761,68847100,11316145965.252865,6947398200,25.804120141668626,56.0,2.7072906329992747,60.644808839156795,84.43252419995977,126.78038442307691,128.9171215565439,-15.567475800040222
2021-04-22,133.039993,134.149994,131.410004,131.940002,129.678497,84566500,11264294968.497038,6862831700,25.61802497250373,56.0,2.53192584164546,56.62900470941614,71.18782272775456,127.0253845,129.14103862642952,-28.81217727224543
2021-04-23,132.160004,135.119995,132.160004,134.320007,132.017761,78657500,11300435409.418142,6941489200,25.77120112945516,56.0,2.555535867318156,60.88464293198792,88.35426371511068,127.393077,129.52466591336068,-11.645736284889313
2021-04-26,134.830002,135.059998,133.559998,134.720001,132.410843,66905100,11337010465.038542,7008394300,25.91343613233863,56.0,2.576819188089445,61.567182489986735,92.20406159769001,127.9388463076923,129.90950554940804,-7.795938402309983
2021-04-27,135.009995,135.410004,134.110001,134.389999,132.086502,66015800,11299431971.673063,6942378500,26.17070714791301,56.0,2.537803747803821,60.62725103599923,83.73750623217258,128.4926925,130.24139395315558,-16.262493767827426
2021-04-28,134.309998,135.020004,133.080002,133.580002,131.290421,107760100,11247218257.707718,6834618400,25.749030205462752,56.0,2.4137001094284187,58.275535966726,67.82182106330738,128.8846156923077,130.48869825292184,-32.17817893669262
2021-04-29,136.470001,137.070007,132.449997,133.479996,131.192123,151101000,11163491085.426273,6683517400,26.113418702049103,84.0,2.2809836735567615,57.97651868524714,44.254504889905185,129.30538473076925,130.71027586381652,-55.745495110094815
2021-04-30,131.779999,133.559998,131.070007,131.460007,129.206726,109839500,11088059264.008244,6573677900,25.631360967389774,84.0,1.9898707203974197,52.1552737569469,6.499999999999773,129.74269284615383,130.7658115035338,-93.50000000000023
2021-05-03,132.039993,134.070007,131.830002,132.539993,130.268219,75135100,11060553740.535172,6648813000,25.378163958092554,84.0,1.8252669112794422,54.770101912410155,24.499766666666762,130.20230811538462,130.8972323551239,-75.50023333333324
2021-05-04,131.190002,131.490005,126.699997,127.849998,125.658623,137564700,10989043018.968903,6511248300,24.322791779179806,84.0,1.3013723951752922,43.62092336494349,11.089680723548023,130.4576926923077,130.67151129178137,-88.91031927645197
2021-05-05,129.199997,130.449997,127.970001,128.100006,125.904335,84000900,10913849017.854628,6595249200,23.342803327332255,84.0,0.8960269321856913,44.27215839560627,13.500555930032954,130.71576988461538,130.4810294183161,-86.49944406996704
2021-05-06,127.889999,129.75,127.129997,129.740005,127.516243,78128300,10991381217.500162,6673377500,22.74179320390988,80.0,0.6990635759153747,48.47651358047516,29.315381566652277,131.09423153846154,130.42613872066306,-70.68461843334772
2021-05-07,130.850006,131.259995,129.479996,130.210007,128.195541,78973300,10977184782.77514,6752350800,21.480598226393422,76.0,0.5742740566048496,49.64891626492713,33.84770120761688,131.40423173076923,130.4101289635769,-66.15229879238312
2021-05-10,129.410004,129.539993,126.809998,126.849998,124.887535,88071200,10891694428.527605,6664279600,21.260172794578075,72.0,0.20192515051704163,42.24774414727712,1.4464884797604154,131.55230857692305,130.14641555886752,-98.55351152023958
2021-05-11,123.5,126.269997,122.769997,125.910004,123.962074,126142800,10991888357.098804,6538136800,22.139670242994985,-32.0,-0.16708761807615247,40.431877452080016,21.958075553793297,131.55269326923076,129.8326072952477,-78.0419244462067
2021-05-12,123.400002,124.639999,122.25,122.769997,120.870644,112172300,10928527173.323624,6425964500,23.075600946469525,-36.0,-0.7047809425514515,35.01742154526559,3.5087500296052725,131.4203855,129.3094509770812,-96.49124997039472
2021-05-13,124.580002,126.150002,124.260002,124.970001,123.036621,105861300,10902201764.475687,6531825800,23.240722277316554,-36.0,-0.9425200549745227,40.98091719363731,18.353574326921677,131.30769315384615,128.98801023803816,-81.64642567307833
2021-05-14,126.25,127.889999,125.849998,127.449997,125.478241,81918000,10948782444.703785,6613743800,22.651298188692884,-35.99999999999999,-0.9202074843091168,46.897011924011885,35.087682482201224,131.1957699230769,128.8740833315168,-64.91231751779878
2021-05-17,126.82,126.93,125.169998,126.269997,124.316505,74244600,10967343404.874058,6539499200,22.308767067072022,-36.0,-0.9863704846788579,44.60587804931381,27.125473017657836,130.93692365384615,128.68118804770074,-72.87452698234216
2021-05-18,126.559998,126.989998,124.779999,124.849998,122.918472,63342900,10908013121.764019,6476156300,22.11043089042519,-36.0,-1.1402431774507988,41.94988586672409,17.54383786728305,130.69115415384616,128.39739619231548,-82.45616213271695
2021-05-19,123.160004,124.919998,122.860001,124.690002,122.760963,92612000,10979945101.791174,6383544300,22.48737797464762,-36.0,-1.2605676954066212,41.64897024255876,20.64298269874126,130.31653911538461,128.12277440029212,-79.35701730125874
2021-05-20,125.230003,127.720001,125.099998,127.309998,125.340408,76857100,11032747541.112312,6460401400,21.62777766930078,-36.0,-1.1314710676465438,48.20147752928151,42.80875637383287,130.13500061538463,128.0625687410112,-57.191243626167136
2021-05-21,127.82,128.0,125.209999,125.43,123.489502,79295400,10965957561.2146,6381106000,20.71822255271864,-36.0,-1.1674040793143519,44.35271887908542,34.41556579244284,129.78615446153847,127.86756364908445,-65.58443420755717
2021-05-24,126.010002,127.940002,125.940002,127.099998,125.133675,63092900,10976052172.842999,6444198900,19.873635658749517,-36.0,-1.049033759916611,48.301655896156824,53.829086475630646,129.51461576923077,127.81070693433746,-46.170913524369354
2021-05-25,127.82,128.320007,126.32,126.900002,124.936775,72009500,10945808180.682722,6372189400,18.920334158530725,-36.0,-0.9602927773694745,47.86359787167561,51.60937381208312,129.20923138461538,127.74324730957173,-48.39062618791688
2021-05-26,126.959999,127.389999,126.419998,126.849998,124.887535,56575900,10939392305.260015,6315613500,18.035125622613275,-36.0,-0.8838117821844662,47.7470018192302,51.05439015226976,128.96846203846155,127.6770806940479,-48.94560984773024
2021-05-27,126.440002,127.639999,125.080002,125.279999,123.341827,94625600,10859551750.807491,6220987900,17.758124500522236,-36.00000000000001,-0.9390609308892408,44.113469444903735,41.56381220119141,128.65230815384615,127.49951908708138,-58.43618779880859
2021-05-28,125.57,125.800003,124.550003,124.610001,122.68219,71311100,10795086288.211971,6149676800,17.706930647741334,-36.0,-1.0250928857902721,42.62279214509923,38.87970804646511,128.37038503846154,127.28548071026054,-61.12029195353489
2021-06-01,125.080002,125.349998,123.940002,124.279999,122.357292,67637100,10760068303.569319,6082039700,17.89630679033133,-36.0,-1.1071398147208242,41.87226462501895,33.44310805572386,127.9842308846154,127.06285243542644,-66.55689194427613
2021-06-02,124.279999,125.239998,124.050003,125.059998,123.125206,59278900,10801414015.614746,6141318600,18.072156065593468,-36.0,-1.0965824762507879,44.36587251775764,40.29294107002801,127.6126923076923,126.91449284761707,-59.70705892997199
2021-06-03,124.68,124.849998,123.129997,123.540001,121.628738,76229200,10761526976.946978,6065089400,18.607272451789814,-36.0,-1.1970677127628448,40.701585716809966,12.45419876827985,127.1953846923077,126.66453048853433,-87.54580123172015
2021-06-04,124.07,126.160004,123.849998,125.889999,123.942383,75169300,10819123953.025309,6140258700,18.2871153316599,-36.0,-1.074689436950223,47.870210477151076,55.4944078816031,126.89961534615385,126.60715778567993,-44.5055921183969
2021-06-07,126.169998,126.32,124.830002,125.900002,123.95224,71057600,10850122371.892448,6211316300,17.893307430761975,-28.0,-0.965763888242904,47.89908305720864,55.67761280848409,126.6080771153846,126.55477587562957,-44.32238719151591
2021-06-08,126.599998,128.460007,126.209999,126.739998,124.779236,74403800,10810770838.014347,6285720100,16.876457244040655,-28.000000000000004,-0.8024092744324065,50.384224104073006,69.2855864797289,126.42653830769231,126.56849603299035,-30.71441352027109
2021-06-09,127.209999,127.75,126.519997,127.129997,125.1632,56877900,10810308278.464737,6342598000,15.93223921351371,-24.0,-0.6341695938181005,51.53996468076192,75.04676351451516,126.21846153846153,126.61008869721329,-24.953236485484837
2021-06-10,127.019997,128.190002,125.940002,126.110001,124.158981,71186400,10749878871.187937,6271411600,14.8572173721146,-12.0,-0.576498076598142,48.3666973156964,55.90991386507719,126.15153857692309,126.57304516408638,-44.09008613492281
2021-06-11,126.529999,127.440002,126.099998,127.349998,125.379784,53522400,10796211396.994127,6324934000,13.85898280510114,-12.0,-0.42582692120817,52.218213944766596,79.1743542695043,126.12269211538462,126.6305972260059,-20.825645730495694
2021-06-14,127.82,130.539993,127.07,130.479996,128.461349,96906500,10889766824.366314,6421840500,14.344505833491736,-12.0,-0.053240541102539396,60.27364369276436,99.19032344956719,126.15115330769231,126.9157378759314,-0.8096765504328179
2021-06-15,129.940002,130.600006,129.389999,129.639999,127.634369,62746300,10852948597.509691,6359094200,14.820462996905608,92.0,0.17227028708394698,57.47330312959572,87.14851615305928,126.12922992307693,127.11753499623278,-12.851483846940722
2021-06-16,130.369995,130.889999,128.460007,130.149994,128.136444,91815000,10888842788.655176,6450909200,14.66723195244219,96.0,0.3876727275481926,58.72708339966325,90.46385555055272,126.25615284615385,127.34216158910442,-9.53614444944728
2021-06-17,129.800003,132.550003,129.649994,131.789993,129.751099,96721700,10934868467.217312,6547630900,15.254079387028384,100.0,0.6828435315865988,62.55063204970377,91.93195842975054,126.48230626923078,127.6716305825041,-8.068041570249466
2021-06-18,130.710007,131.509995,130.240005,130.460007,128.441666,108953300,10863663407.60755,6438677600,15.799009147715564,80.0,0.8002252665843486,57.86861771767174,77.81322007650512,126.77807588461539,127.87817698380009,-22.186779923494882
2021-06-21,130.300003,132.410004,129.210007,132.300003,130.25325,79663300,10937849800.808388,6518340900,15.623961691293065,80.0,1.0298519448123784,62.09572896890241,97.34607387723533,127.05999903846154,128.20571965166675,-2.6539261227646773
2021-06-22,132.130005,134.080002,131.619995,133.979996,131.907196,74783600,11006553085.832373,6593124500,16.19991688512385,92.0,1.3320392175572806,65.49934518767056,99.08670361337728,127.31115284615385,128.63344382561738,-0.9132963866227235
2021-06-23,133.770004,134.320007,133.229996,133.699997,131.631577,60214200,10998266314.480707,6532910300,16.833567701987906,96.0,1.531279591160171,64.46043181209808,94.07822858604986,127.5969220769231,129.00874406075684,-5.921771413950145
2021-06-24,134.449997,134.639999,132.929993,133.410004,131.346039,68711000,10968130659.621016,6464199300,17.557759930126682,100.0,1.6467957745680337,63.339871402021636,87.46182083439982,127.92615307692307,129.3347633155156,-12.538179165600182
2021-06-25,133.460007,133.889999,132.809998,133.110001,131.050674,70783700,10936671594.229874,6393415600,18.13823279005587,60.0,1.6946011402059185,62.13646756889894,82.41381002775081,128.2499991923077,129.61441055140332,-17.586189972249198
2021-06-28,133.410004,135.25,133.350006,134.779999,132.694839,62111300,10968053983.38984,6455526900,19.26201897842699,68.0,1.8459630062731094,66.00802454068989,94.95165305083849,128.53730692307693,129.99704673278086,-5.0483469491615
2021-06-29,134.800003,136.490005,134.350006,136.330002,134.220856,64556100,11022956649.282347,6520083000,20.766599717688027,72.0,2.067161710385335,69.15998247797175,98.48338431752114,128.95653776923078,130.46615453035264,-1.5166156824788501
2021-06-30,136.169998,137.410004,135.869995,136.960007,134.841141,63261400,11049247563.764666,6583344400,22.472092398851373,76.0,2.267164949101357,70.36290001084836,96.02124879509351,129.3357688846154,130.9471806392154,-3.9787512049064935
2021-07-01,136.600006,137.330002,135.759995,137.270004,135.146332,52485800,11097721861.86894,6635830200,23.960404056375122,76.0,2.4227551110685965,70.96306436660929,98.64603534002515,129.73461511538463,131.41553792519943,-1.3539646599748554
2021-07-02,137.899994,140.0,137.75,139.960007,137.794678,78852600,11173771304.50734,6714682800,26.129496481416634,84.0,2.7316336241646297,75.5836336147545,99.65343999775381,130.2388462307692,132.04846156036984,-0.34656000224618577
2021-07-06,140.070007,143.149994,140.070007,142.020004,139.822861,108181800,11202573319.993963,6822864600,28.7897410059088,88.0,3.1068329763149336,78.41614822289462,92.30775357391404,130.8826925769231,132.78709433367578,-7.69224642608596
2021-07-07,143.539993,144.889999,142.660004,144.570007,142.333405,104911600,11277376446.47075,6927776200,31.535706325401822,92.0,3.5688061214319475,81.30701783256751,97.95923365267032,131.6503851153846,133.65990267932943,-2.040766347329673
2021-07-08,141.580002,144.059998,140.669998,143.240005,141.023972,105575500,11331877509.319424,6822200700,32.71306976922105,92.0,3.7839837123762265,75.61819819650142,89.47707371279274,132.3796161153846,134.369539888268,-10.522926287207241
2021-07-09,142.75,145.649994,142.649994,145.110001,142.865021,99890800,11395808087.476492,6922091500,34.14038224372158,100.0,4.05862129260467,77.95381040747353,96.71536844889243,133.1507700769231,135.16512960024815,-3.28463155110756
2021-07-12,146.210007,146.320007,144.0,144.5,142.264481,76299700,11352396089.970493,6845791800,35.59828666519001,100.0,4.178880043010395,75.41592190829877,87.6190101069305,133.95692388461538,135.85660148171124,-12.380989893069488
2021-07-13,144.029999,147.460007,143.630005,145.639999,143.386871,100827100,11357397585.37979,6946618900,37.16974517550837,100.0,4.316417388279689,76.92768901862976,87.57674483339906,134.71653926923076,136.58129759417707,-12.423255166600946
2021-07-14,148.100006,149.570007,147.679993,149.149994,146.842529,127050800,11427980033.65287,7073669700,38.986042753438646,92.0,4.65498422701458,80.83536263475501,97.49395719298235,135.61076973076922,137.51231214275654,-2.506042807017655
2021-07-15,149.240005,150.0,147.089996,148.479996,146.182922,106820300,11423207852.48707,6966849400,40.274397536826235,96.0,4.8137477590488515,78.11568685578045,91.15762755583157,136.4469235,138.32473316921903,-8.842372444168422
2021-07-16,148.460007,149.759995,145.880005,146.389999,144.125244,93251400,11354470770.560879,6873598000,40.681188571317264,96.0,4.716554209969729,70.18325928735287,78.31830449908863,137.18769280769232,138.9221602677954,-21.681695500911367
2021-07-19,143.75,144.070007,141.669998,142.449997,140.246155,121434600,11311968263.370031,6752163400,38.88276850093699,92.0,4.2723533585833025,58.187379125887055,51.75715083341241,137.8161541923077,139.18348150721795,-48.24284916658759
2021-07-20,143.460007,147.100006,142.960007,146.149994,143.888947,96350000,11364099095.10453,6848513400,38.05321721157981,88.0,4.17080141680097,64.34978564390836,72.96345050440637,138.53923096153846,139.69951946964625,-27.036549495593636
2021-07-21,145.529999,146.130005,144.630005,145.399994,143.150513,74993500,11366097821.866528,6773519900,37.282919585748154,80.0,3.9838783693441258,62.34401041185903,67.69659842113813,139.11307703846154,140.12177684226506,-32.303401578861866
2021-07-22,145.940002,148.199997,145.809998,146.800003,144.528885,77338200,11352830949.671267,6850858100,37.083841044743174,80.0,3.9037099946204705,64.564400075549,73.87757551020411,139.77307719230768,140.61646026135654,-26.122424489795886
2021-07-23,147.550003,148.720001,146.919998,148.559998,146.261658,71447400,11411576372.68323,6922305500,37.021463322875206,68.0,3.9368117523769115,67.18406197868387,85.49845906235792,140.48115426923076,141.20487046421903,-14.501540937642083
2021-07-26,148.270004,149.830002,147.699997,148.990005,146.685028,72434100,11426879689.706005,6994739600,37.22216666364458,68.0,3.9521847790821028,67.81020343833269,89.17476116296649,141.1426931923077,141.78154709649908,-10.825238837033504
2021-07-27,149.119995,149.210007,145.550003,146.770004,144.499344,104818600,11391940137.280052,6889921000,36.35116005207287,68.0,3.742095933576678,61.30655740861875,65.38054332678603,141.77000076923076,142.15106242268433,-34.619456673213975
2021-07-28,144.809998,146.970001,142.539993,144.979996,142.73703,118931200,11404021109.173918,6770989800,34.313135427656924,64.0,3.392058781872123,56.59337820302846,39.73586080771655,142.2576928076923,142.36061305804105,-60.26413919228345
2021-07-29,144.690002,146.550003,144.580002,145.639999,143.386871,56699500,11408338126.324415,6827689300,32.42068399069926,52.0,3.131807021626429,57.87919560995177,47.65906418749951,142.70615446153846,142.60353053522317,-52.34093581250049
2021-07-30,144.380005,146.330002,144.110001,145.860001,143.603439,70440600,11448952476.299664,6898129900,30.476111532645717,52.00000000000001,2.9097659784524126,58.322387241444666,50.30014398555984,143.17384692307692,142.8447505696511,-49.69985601444016
2021-08-02,146.360001,146.949997,145.25,145.520004,143.268707,62880000,11406046454.512566,6835249900,28.896578895530666,52.0,2.675520204131459,57.31864102910787,46.2185483268792,143.63961615384616,143.04291749041766,-53.7814516731208
2021-08-03,145.809998,148.039993,145.179993,147.360001,145.080231,64786600,11440025802.969069,6900036500,27.819116672326988,48.0,2.608284441297286,61.20946115035426,68.30734254325526,144.18769307692307,143.36270145409043,-31.692657456744747
2021-08-04,147.270004,147.789993,146.279999,146.949997,144.676559,56368300,11433679752.412973,6843668200,26.818616036495,44.0,2.493175938321258,59.89913583002585,64.70583837949091,144.65576992307692,143.62842705008373,-35.29416162050908
2021-08-05,146.979996,147.839996,146.169998,147.059998,144.784882,46397700,11436735947.567339,6890065900,25.83338835845149,36.0,2.3833539609090337,60.14564302869323,66.05388918927007,145.06846207692308,143.88261749081826,-33.946110810729934
2021-08-06,146.350006,147.110001,145.630005,146.139999,144.094666,54126800,11419912414.926437,6835939100,24.633926243942444,36.0,2.196760138595664,56.99026114980881,49.38273738756674,145.42153869230768,144.04983093594282,-50.61726261243326
2021-08-09,146.199997,146.699997,145.520004,146.089996,144.045349,48908700,11418254110.02268,6787030400,23.4603666482439,32.0,2.0215452505883604,56.81579537846706,48.69682602586643,145.76076915384616,144.20095427402111,-51.30317397413357
2021-08-10,146.440002,147.710007,145.300003,145.600006,143.562225,69023100,11366415327.616592,6718007300,22.83310851247553,28.000000000000004,1.822143554849447,55.037737081668084,41.975435146925044,145.9776921923077,144.30458773520473,-58.024564853074956
2021-08-11,146.050003,146.720001,145.529999,145.860001,143.818588,48493500,11344817500.038992,6766500800,22.250654529262043,20.0,1.6658923282180922,55.82766904138158,45.54189164924217,146.1253843846154,144.41980353259697,-54.45810835075783
2021-08-12,146.190002,149.050003,145.839996,148.889999,146.806183,72282600,11409894193.55318,6838783400,22.67729583185195,20.0,1.7661979902223948,63.80792824620099,87.10559890941124,146.2915379230769,144.75092912277498,-12.894401090588762
2021-08-13,148.970001,149.440002,148.270004,149.100006,147.01326,59375000,11434760993.539165,6898158400,23.21609246169334,-8.0,1.841410130080817,64.28947562181999,95.07252816626782,146.51692257692306,145.07308296553236,-4.927471833732187
2021-08-16,148.539993,151.190002,146.470001,151.119995,149.004959,103296000,11534992823.395134,7001454400,22.586467125462256,80.0,2.0404910131028373,68.61507757325977,99.1906713623072,146.74807619230768,145.52100237549294,-0.809328637692794
2021-08-17,150.229996,151.679993,149.089996,150.190002,148.087982,92229700,11521105471.57407,6909224700,22.212068946557775,84.0,2.09902512928133,64.72770731210923,80.31713904056957,146.96692242307694,145.86685419953048,-19.682860959430425
2021-08-18,149.800003,150.720001,146.149994,146.360001,144.311584,86326000,11442713404.40262,6822898700,20.910421888492294,84.0,1.8154375322213525,51.72961812108952,29.722620578727224,146.9946148076923,145.90338359215787,-70.27737942127278
2021-08-19,145.029999,148.0,144.5,146.699997,144.64682,86960300,11465074475.32782,6909859000,20.380705800089675,84.0,1.5996869586590208,52.63884276307921,30.640656613453487,146.90038415384615,145.96239199273876,-69.35934338654651
2021-08-20,147.440002,148.5,146.779999,148.190002,146.115982,60549600,11503798210.225647,6970408600,19.635104706266244,84.0,1.5312823559117703,56.50539969029951,51.3928356197561,146.88923053846153,146.1274001414248,-48.6071643802439
2021-08-23,148.309998,150.190002,147.889999,149.710007,147.614685,60131800,11538831813.970251,7030540400,18.3255801440283,84.0,1.5814924551165177,60.08534549217817,72.56284233146178,147.01692315384614,146.3927784272452,-27.437157668538212
2021-08-24,149.449997,150.860001,149.149994,149.619995,147.52594,48606400,11516944669.045113,6981934000,17.404544182170827,56.0,1.595627701443675,59.771601025845,71.30919208417043,147.2926923076923,146.63183150670852,-28.690807915829563
2021-08-25,149.809998,150.320007,147.800003,148.360001,146.283585,58991300,11484171589.347462,6922942700,16.400203718039776,56.0,1.4880061912847111,55.40997695988868,53.760512022783495,147.37769257692307,146.75984406176715,-46.239487977216505
2021-08-26,148.350006,149.119995,147.509995,147.539993,145.475082,48597200,11437385344.385475,6874345500,15.598024849224284,56.0,1.3213162651910864,52.714015158867696,42.33977665437851,147.46000023076925,146.81763287200664,-57.66022334562149
2021-08-27,147.479996,148.75,146.830002,148.600006,146.520248,55802400,11484468959.068407,6930147900,15.161543547558079,56.0,1.260220451126969,55.713682660743636,57.10320330395879,147.52923111538462,146.94966051111726,-42.89679669604121
2021-08-30,149.0,153.490005,148.610001,153.119995,150.976974,90956700,11561632683.256502,7021104600,15.39298806664242,92.0,1.5585607967904025,65.70428032816511,95.88420696095265,147.70461561538463,147.40672232510857,-4.1157930390473405
2021-08-31,152.660004,152.800003,151.289993,151.830002,149.705032,86453100,11537014209.620434,6934651500,15.607900834363594,92.0,1.6716364317484818,61.44401958650604,81.53501583147073,147.81384626923077,147.7343726713968,-18.46498416852927
2021-09-01,152.830002,154.979996,152.339996,152.509995,150.375504,80313700,11467043879.837328,7014965200,16.50463603465391,100.0,1.795422921453536,62.8128121185589,76.43127917224399,148.03461515384615,148.08812247351557,-23.568720827756007
2021-09-02,153.869995,154.720001,152.399994,153.649994,151.499573,71115500,11472561230.514072,7086080700,17.33731872063777,92.0,1.9628860695534343,65.05278693479471,87.3091363775329,148.3680766153846,148.50011295695887,-12.690863622467102
2021-09-03,153.759995,154.630005,153.089996,154.300003,152.140472,57808700,11505594768.008657,7143889400,18.110524071908504,92.0,2.123572888497222,66.29927638351259,93.51151469905145,148.70115369230768,148.92973444162857,-6.48848530094855
2021-09-07,154.970001,157.259995,154.389999,156.690002,154.497009,82278300,11555191450.994627,7226167700,19.612105722466392,48.0,2.4159220499090566,70.46992533756264,95.53296846903145,149.1176921923077,149.504569075582,-4.467031530968552
2021-09-08,156.979996,157.039993,153.979996,155.110001,152.939117,74420200,11535735486.646492,7151747500,20.75800570490197,48.0,2.491398697170041,64.7638029884544,83.1505106389149,149.4865382307692,149.91978625516853,-16.84948936108511
2021-09-09,155.490005,156.110001,153.949997,154.070007,151.913696,57305700,11484797605.462568,7094441800,21.80300755841683,48.0,2.439178330241532,61.24828475895607,69.56117158823344,149.7446153846154,150.22721001404494,-30.438828411766565
2021-09-10,155.0,155.479996,148.699997,148.970001,146.885056,140893200,11355126155.664242,6953548600,20.332245304374375,48.0,1.963629947830384,47.602187589762565,20.517741478829272,149.82230784615385,150.134083420412,-79.48225852117072
2021-09-13,150.630005,151.419998,148.75,149.550003,147.456924,102404300,11314088004.412594,7055952900,18.96653749704924,48.0,1.6149397228891473,48.993995563648355,26.07864645738494,149.91807726923076,150.09081820408517,-73.92135354261507
2021-09-14,150.350006,151.070007,146.910004,148.119995,146.046951,109296300,11268372206.317665,6946656600,18.39698162478665,48.0,1.209270791976337,45.766209319089135,12.368109930658456,149.99423096153848,149.94483130007885,-87.63189006934154
2021-09-15,148.559998,149.440002,146.369995,149.029999,146.944229,83281300,11329408877.661184,7029937900,18.061011557819263,48.0,0.9502510564523163,48.10905150066096,24.426115702479443,150.107308,149.87706594451745,-75.57388429752056
2021-09-16,148.440002,148.970001,147.220001,148.789993,146.707581,68034100,11383446769.349415,6961903800,17.749039352778116,48.0,0.7173405165807765,47.525919223854366,22.222203856749474,150.2299998076923,149.79654202270135,-77.77779614325053
2021-09-17,148.820007,148.820007,145.759995,146.059998,144.015793,129868800,11279042594.72108,6832035000,17.994914861027322,48.0,0.3089085492559889,41.38162181112312,2.6087217391304676,150.23769199999998,149.51976098398274,-97.39127826086953
2021-09-20,143.800003,144.839996,141.270004,142.940002,140.939453,123478900,11271087491.996927,6708556100,19.48098101063974,-36.0,-0.2634969014885371,35.700965278080886,10.444020887816587,150.00884596153847,149.03237142961362,-89.55597911218341
2021-09-21,143.929993,144.600006,142.779999,143.429993,141.422577,75834000,11249419926.517233,6784390100,20.860899578136987,-36.0,-0.6698722956446659,37.159935393885746,13.508381586956462,149.79076853846155,148.61738043482742,-86.49161841304354
2021-09-22,144.449997,146.429993,143.699997,145.850006,143.808746,76404300,11293360075.841482,6860794400,21.195190100018863,-35.99999999999999,-0.7875742335658913,43.92713475313284,28.6429304431754,149.58807665384617,148.4123897359513,-71.3570695568246
2021-09-23,146.649994,147.080002,145.639999,146.830002,144.775009,64838200,11335685058.85513,6925632600,21.18948786824922,-36.0,-0.7926393275661212,46.44240526924531,34.77173939622609,149.45884588461539,148.29517582958454,-65.2282606037739
2021-09-24,145.660004,147.470001,145.559998,146.919998,144.863739,53477900,11358364048.66106,6979110500,20.991526497544072,-36.0,-0.7803956111553134,46.678950517132286,35.33456647974343,149.48038423076923,148.19331080517088,-64.66543352025658
2021-09-27,145.470001,145.960007,143.820007,145.369995,143.335419,74150700,11391627082.484985,6904959800,21.37097928982911,-36.0,-0.8855565215325214,43.14456986077018,25.998692833584006,149.4292303076923,147.98417630108415,-74.001307166416
2021-09-28,143.25,144.75,141.690002,141.910004,139.923874,108972300,11298324154.781698,6795987500,22.318303645224542,-36.0,-1.2338664140328035,36.50070739639609,4.312669335445189,149.18769192307693,147.53423761211494,-95.68733066455482
2021-09-29,142.470001,144.449997,142.029999,142.830002,140.831009,74602000,11273046016.872494,6870589500,23.197961975234588,-36.0,-1.41930747039018,39.18246725026196,10.97817648313952,148.92307634615383,147.18577571492122,-89.02182351686048
2021-09-30,143.660004,144.380005,141.279999,141.5,139.519623,89056700,11196629655.669708,6781532800,24.22078543501558,-36.0,-1.6545186288423963,36.76513024222445,2.265971782840463,148.61076884615383,146.76460714344557,-97.73402821715953
2021-10-01,141.899994,142.919998,139.110001,142.649994,140.653519,94639600,11277855559.77525,6876172400,25.709945959499652,-72.0,-1.7282085492383317,40.20048092488459,29.598588830139246,148.3911531923077,146.4598209846718,-70.40141116986075
2021-10-04,141.759995,142.210007,138.270004,139.139999,137.192627,98322000,11222954668.028212,6777850400,27.280938902124884,-76.0,-2.0462477341726526,34.10952179039104,7.788676416951814,148.06807650000002,145.9176119487702,-92.21132358304818
2021-10-05,139.490005,142.240005,139.360001,141.110001,139.135086,80861100,11240362129.460766,6858711500,28.720291526436995,-76.0,-2.114953514572221,39.63750216510208,26.54203547907548,147.7799993846154,145.56149261923167,-73.45796452092452
2021-10-06,139.470001,142.149994,138.369995,142.0,140.012619,83221100,11316978642.70114,6941932600,30.287468735673087,-76.0,-2.0736837241209116,42.00475033978052,35.35540226860598,147.35230726923078,145.29767835114043,-64.64459773139403
2021-10-07,143.059998,144.220001,142.720001,143.289993,141.284561,61732700,11302162136.219007,7003665300,30.435142535780397,-76.0,-1.914812694859961,45.35015052026218,54.56511561905957,147.02384538461538,145.14896091772263,-45.43488438094043
2021-10-08,144.029999,144.179993,142.559998,142.899994,140.899994,58773200,11268058954.221779,6944892100,30.620648558145625,-76.0,-1.7996308947853095,44.51413485754532,50.325994671519936,146.65422996153845,144.9823707756691,-49.674005328480064
2021-10-11,142.270004,144.809998,141.809998,142.809998,140.811279,64452200,11246574887.555113,6880439900,31.02304922513256,-76.0,-1.6960592976352586,44.31113629383816,49.347776961231716,146.23730703846155,144.8214542737677,-50.652223038768284
2021-10-12,143.229996,143.25,141.039993,141.509995,139.529465,73035900,11204604064.789528,6807404000,31.62668942853153,-76.0,-1.6992890913480494,41.375866907866694,35.21730496216471,145.74538365384615,144.57616099422935,-64.78269503783528
2021-10-13,141.240005,141.399994,139.199997,140.910004,138.937851,78762700,11248282230.244253,6728641300,32.68451687036674,-72.0,-1.7303169685720547,40.057007079949884,28.695661531193842,145.13846065384615,144.3045938094716,-71.30433846880616
2021-10-14,142.110001,143.880005,141.509995,143.759995,141.747986,69907100,11311109570.183325,6798548400,32.17023246043675,-68.0,-1.5075581376954688,48.460755087345966,71.3912725391656,144.70192196153846,144.2642531569182,-28.608727460834405
2021-10-15,143.770004,144.899994,143.509995,144.839996,142.812851,67940300,11373184711.835155,6866488700,31.1585183287615,-64.0,-1.2296979125050314,51.249926621554366,99.09505142541725,144.34692153846152,144.30690077492426,-0.9049485745827516
2021-10-18,143.449997,146.839996,143.160004,146.550003,144.498932,85589200,11445284605.94775,6952077900,29.302085877702726,-60.0,-0.8615766886377969,55.368415451673734,96.61618120530323,144.2538446923077,144.47305649530023,-3.383818794696766
2021-10-19,147.009995,149.169998,146.550003,148.759995,146.677994,76378900,11497758438.848997,7028456800,27.766532746986993,-56.00000000000001,-0.3870484284724398,60.0641452576128,96.238502516607,144.22345976923077,144.79060749564835,-3.761497483393012
2021-10-20,148.699997,149.75,148.119995,149.259995,147.171005,58418800,11521054028.682158,7086875600,26.551456762372,48.0,0.029029820129721884,61.06229372559386,95.73166227584055,144.26730592307692,145.12167323671142,-4.268337724159455
2021-10-21,148.809998,149.639999,147.869995,149.479996,147.387909,61421000,11571370483.988474,7148296600,25.307346387052046,48.0,0.37223616510141255,61.51804575719138,97.64804796099232,144.2846135,145.444511959918,-2.3519520390076805
2021-10-22,149.690002,150.179993,148.639999,148.690002,146.608978,58883400,11516310925.705,7089413200,24.3658629250794,56.0,0.5738685531549947,58.85413864171672,87.38364731306473,144.2807676923077,145.68491862955372,-12.616352686935278
2021-10-25,148.679993,149.369995,147.619995,148.639999,146.559677,50720600,11524716285.5706,7038692600,22.98874000395639,56.0,0.7213139904829973,58.68092962980989,86.96025181375977,144.3799985,145.903813471809,-13.03974818624022
2021-10-26,149.330002,150.839996,149.009995,149.320007,147.230164,60893400,11484454223.718285,7099586000,22.311998150512277,64.0,0.8828594699794792,60.388269326122554,86.9416741358826,144.62538330769232,146.1568648442676,-13.058325864117405
2021-10-27,149.360001,149.729996,148.490005,148.850006,146.766739,56094900,11460930882.858473,7043491100,21.41829173049711,64.0,0.9618724072490465,58.5863502497146,82.90386451064126,144.83384534615385,146.35635678172926,-17.096135489358744
2021-10-28,149.820007,153.169998,149.720001,152.570007,150.434708,100077900,11526199570.387333,7143569000,21.806409504760772,72.0,1.3095678377907518,66.98366636311587,95.70514705045483,145.0923069230769,146.81662716826781,-4.294852949545163
2021-10-29,147.220001,149.940002,146.410004,149.800003,147.703445,124953200,11641241533.583914,7018615800,20.682594322928136,72.0,1.3460859575850463,57.61543024121584,75.8769165442437,145.20653773076924,147.03761797061836,-24.1230834557563
2021-11-01,148.990005,149.699997,147.800003,148.960007,146.875214,74588300,11657730075.250992,6944027500,19.639051654083545,72.0,1.2923487812690553,55.09883797155742,69.8640608543979,145.2849996153846,147.18001715797996,-30.13593914560209
2021-11-02,148.660004,151.570007,148.649994,150.020004,147.920395,69122000,11653469314.718077,7013149500,19.32032459061251,72.0,1.3200775487563305,57.61477979282421,72.98462101596375,145.46384611538463,147.39038655368515,-27.015378984036243
2021-11-03,150.389999,151.970001,149.820007,151.490005,149.369812,54511500,11683640931.021658,7067661000,19.156684056040774,72.0,1.4440237848360198,60.887829553381735,83.21684308701889,145.8323076923077,147.69406199415292,-16.783156912981116
2021-11-04,151.580002,152.429993,150.639999,150.960007,148.847214,60394600,11644840543.244492,7007266400,19.16080513250485,72.0,1.4823975050142906,59.115356025767404,77.92215459869405,146.1450001923077,147.9359838464379,-22.077845401305943
2021-11-05,151.889999,152.199997,150.059998,151.279999,149.380417,65463900,11654017821.547752,7072730300,18.87063945959952,72.0,1.5210953939856893,59.874834852372416,72.04141009592631,146.521154,148.18368867262768,-27.95858990407369
2021-11-08,151.410004,151.570007,150.160004,150.440002,148.550964,55020900,11620848991.306753,7017709400,18.601199906187425,72.0,1.467071524729846,56.88742359456246,59.61540794266981,146.8207696923077,148.35082299317378,-40.38459205733019
2021-11-09,150.199997,151.429993,150.059998,150.809998,148.916321,56787900,11626237851.07595,7074497300,18.29463504564237,64.0,1.4375417180509942,57.88420441105618,65.08872641011244,147.2696158076923,148.53298410479053,-34.91127358988755
2021-11-10,150.020004,150.130005,147.850006,147.919998,146.062607,65187100,11565053012.04466,7009310200,17.111218199494193,64.0,1.1674822772849325,48.4596384031102,22.3372091750378,147.53153876923076,148.4875777266579,-77.6627908249622
2021-11-11,148.960007,149.429993,147.679993,147.869995,146.013245,41000000,11532955962.901804,6968310200,16.09297692759254,44.0,0.9386037607042681,48.31306714917082,21.597519169395728,147.75730780769229,148.44183085801657,-78.40248083060428
2021-11-12,148.429993,150.399994,147.479996,149.990005,148.106674,63804000,11578842869.701056,7032114200,15.223915199363729,44.00000000000001,0.9177042532897417,54.58491224521138,52.95864167926786,148.0150005769231,148.55651042408942,-47.04135832073214
2021-11-15,150.369995,151.880005,149.429993,150.0,148.116531,59222800,11547177004.572886,7091337000,15.087749583523168,44.0,0.8916691491525626,54.61287479754589,53.1064968400861,148.28807773076923,148.66343557786058,-46.8935031599139
2021-11-16,149.940002,151.490005,149.339996,151.0,149.103958,59256200,11579423239.236927,7150593200,14.909825796206297,44.0,0.9408818835276804,57.436553779844786,67.89940937817414,148.6030778076923,148.83651442394498,-32.10059062182586
2021-11-17,151.0,155.0,150.990005,153.490005,151.562683,88807000,11601348297.506327,7239400200,16.060856362919534,100.0,1.1673494459751055,63.52207371597504,82.42147027775098,149.06384742307694,149.18121742957868,-17.578529722249012
2021-11-18,153.710007,158.669998,153.050003,157.869995,155.887665,137827700,11699936612.601856,7377227900,18.07490541331862,100.0,1.680879080986898,71.29628863881518,92.85073407493579,149.71615476923077,149.82483058294324,-7.149265925064216
2021-11-19,157.649994,161.020004,156.529999,160.550003,158.534058,117305600,11792683777.00742,7494533500,20.410311124547352,96.0,2.277851608919377,74.83090052435334,96.528798210459,150.3619243076923,150.6192877990215,-3.471201789541013
2021-11-22,161.679993,165.699997,161.0,161.020004,158.998138,117467900,11676215804.399544,7612001400,23.283500131736442,100.0,2.757099662326084,75.40295062597382,74.3139805535686,150.9842323076923,151.3897112213162,-25.68601944643141
2021-11-23,161.119995,161.800003,159.059998,161.410004,159.383209,96041900,11744917429.50362,7708043300,25.00937514574613,64.0,3.1322700783874495,75.89258018592815,76.45448537571424,151.5557708076923,152.13195513084833,-23.545514624285754
2021-11-24,160.75,162.139999,159.639999,161.940002,159.906616,69463600,11803267020.21626,7777506900,26.669257762113606,64.0,3.4327906712744323,76.57501052748438,79.3633655673235,152.06269415384617,152.85847712115586,-20.63663443267651
2021-11-26,159.570007,160.449997,156.360001,156.809998,154.840988,76959800,11743242043.194376,7700547100,26.761506418678145,64.0,3.219890068308075,59.12775433860502,51.207472491357215,152.3530788846154,153.15118237144063,-48.792527508642785
2021-11-29,159.369995,161.190002,158.789993,160.240005,158.227936,88748200,11761731736.867607,7789295300,27.012747342654997,64.0,3.29001248970701,64.88818938871819,70.03297639775101,152.76692538461538,153.67628034392652,-29.967023602248982
2021-11-30,159.990005,165.520004,159.919998,165.300003,163.22438,174048100,11922104581.502487,7963343400,28.08562139664919,64.0,3.71110525302862,71.3116900217295,97.80464336966836,153.4057715769231,154.537296836969,-2.1953566303316476
2021-12-01,167.479996,170.300003,164.529999,164.770004,162.701065,152052500,11782701417.711786,7811290900,29.773163649251867,88.0,3.956450315425542,69.8698478239844,75.76688298123659,154.02615638461538,155.2952751453417,-24.233117018763416
2021-12-02,158.740005,164.199997,157.800003,163.759995,161.703735,136739200,11900638874.623152,7674551700,29.151037654568082,88.0,4.023013959008068,67.08613363811054,71.34090274380722,154.58154053846152,155.92229143087192,-28.659097256192776
2021-12-03,164.020004,164.960007,159.720001,161.839996,159.807831,118023100,11878115047.671505,7556528600,28.708550435645513,88.0,3.8761563355013777,62.02700094296667,59.63738466308721,155.08115553846153,156.360639917474,-40.36261533691279
2021-12-06,164.289993,167.880005,164.279999,165.320007,163.244125,107497000,11832727799.697474,7664025600,28.794381798688732,88.0,3.994531937192704,66.89940607137933,76.24048503418915,155.57154015384614,157.02429673840186,-23.75951496581085
2021-12-07,169.080002,171.580002,168.339996,171.179993,169.030548,120405400,11923402857.43971,7784431000,29.42309318246293,64.0,4.50921789364952,73.14757368901653,98.05726537988319,156.39384746153846,158.07286683185356,-1.9427346201168032
2021-12-08,172.130005,175.960007,170.699997,175.080002,172.881592,116998900,12001253688.521782,7901429900,30.55361635256101,68.0,5.1721866071852105,76.34754980005407,96.15886143014211,157.39846265384614,159.33265462208664,-3.8411385698578813
2021-12-09,174.910004,176.75,173.919998,174.559998,172.368103,108923700,11941595796.814497,7792506200,31.694388308539448,72.0,5.591182441354931,75.06310487953036,89.25943056691668,158.34230857692307,160.46060598341356,-10.740569433083316
2021-12-10,175.210007,179.630005,174.690002,179.449997,177.196716,115402700,12048588214.787704,7907908900,33.073422982494286,76.0,6.245823742298683,78.693252672771,99.22643760611292,159.4176928846154,161.86722754019772,-0.7735623938870618
2021-12-13,181.119995,182.130005,175.529999,175.740005,173.533295,153237000,11905102929.98978,7754671900,34.607963947635916,80.0,6.3915880921287,70.32834396967306,75.20372911079092,160.37076973076924,162.89484068536825,-24.796270889209076
2021-12-14,175.25,177.740005,172.210007,174.330002,172.140991,139380400,11872589024.732817,7615291500,34.99478591914451,80.0,6.320473447783229,67.39616392641108,69.73223985529842,161.2573083076923,163.74188967163727,-30.267760144701583
2021-12-15,175.110001,179.5,172.309998,179.300003,177.048584,131063300,11996361014.713682,7746354800,35.57224292711906,80.0,6.589195974888241,71.85111166319508,89.01823220516378,162.36730834615386,164.89434251077523,-10.981767794836227
2021-12-16,179.279999,181.139999,170.75,172.259995,170.096985,150185800,11889828694.770994,7596169000,36.306211888117055,80.0,6.163046935156984,59.45787705479028,59.432761246793135,163.19230823076924,165.43994639886594,-40.567238753206865
2021-12-17,169.929993,173.470001,169.690002,171.139999,168.991058,195432700,11844330864.43731,7400736300,36.64660025695286,80.0,5.66959091901245,57.75124257893935,54.82940774110903,164.08538519230768,165.86217251746848,-45.17059225889097
2021-12-20,168.279999,170.580002,167.460007,169.75,167.618515,107499100,11894634700.984514,7293237200,36.26670303909752,80.0,5.107486246317876,55.617579227622194,49.11630093577465,164.92692384615384,166.15015973839675,-50.88369906422534
2021-12-21,171.559998,173.199997,169.119995,172.990005,170.817841,91185900,11976434179.353937,7384423100,36.30815121615233,72.0,4.867347813337034,59.38438696110417,62.43321311687516,165.81153923076923,166.65681494295995,-37.56678688312484
2021-12-22,173.039993,175.860001,172.149994,175.639999,173.43454,92135300,12057642303.059875,7476558400,36.71099952534503,72.0,4.835132348029134,62.20945865476792,71.03969280862235,166.79769303846155,167.32223598422217,-28.960307191377645
2021-12-23,175.850006,176.850006,175.270004,176.279999,174.066483,68356600,12076677774.990164,7544915000,37.21510692842139,68.0,4.805845218821759,62.880969228206084,67.22686815903589,167.77000069230766,167.9857739853909,-32.77313184096412
2021-12-27,177.089996,180.419998,177.070007,180.330002,178.065659,74919600,12147572012.341967,7619834600,38.11924596674591,64.0,5.051209157832261,66.89040832796329,87.73003922699921,168.80230826923076,168.9001612457323,-12.269960773000795
2021-12-28,180.160004,181.330002,178.529999,179.289993,177.038696,79144300,12111391375.691042,7540690300,39.0624191066775,44.0,5.102918544147258,64.95026264714636,80.64067902395081,169.62615434615384,169.6697784127151,-19.359320976049197
2021-12-29,179.330002,180.630005,178.139999,179.380005,177.127594,62348900,12111141129.343603,7603039200,39.795759114439235,44.00000000000001,5.0924591226658436,65.04476241676689,81.25425783970798,170.35038519230767,170.38905445621768,-18.74574216029202
2021-12-30,179.470001,180.570007,178.089996,178.199997,175.962402,59773000,12056670597.57701,7543266200,40.457341507307625,44.0,4.932099004722687,62.65968006731085,73.2105757614963,171.01115415384615,170.96764279279415,-26.78942423850371
2021-12-31,178.089996,179.229996,177.259995,177.570007,175.340302,64062300,12012770806.882944,7479203900,40.7368049159815,44.0,4.699998866679238,61.36592600532448,68.9161648147464,171.63269273076924,171.4567068081427,-31.08383518525361
2022-01-03,177.830002,182.880005,177.710007,182.009995,179.724564,104487900,12082092148.644817,7583691800,41.511442237172616,100.0,4.818779865457941,66.60003111089637,94.35791107106493,172.40461553846154,172.2384318593914,-5.642088928935053
2022-01-04,182.630005,182.940002,179.119995,179.699997,177.443573,99310400,12012938882.189756,7484381400,42.23866686308144,88.0,4.672653686547136,61.901243686314906,79.06972838169524,173.2850001153846,172.79114038832537,-20.93027161830476
2022-01-05,179.610001,180.169998,174.639999,174.919998,172.723572,94537600,11927974677.578218,7389843800,41.22918702558584,88.0,4.123607287838695,53.49126124573153,48.19117189637336,173.84961523076922,172.94883354474572,-51.80882810362664
2022-01-06,172.699997,175.300003,171.639999,172.0,169.840256,96904000,11850133791.664433,7292939800,39.369209862170344,88.0,3.4135157414108335,49.10252973149028,29.328129627948904,174.10730742307695,172.87854957846827,-70.67187037205109
2022-01-07,172.889999,174.139999,171.029999,172.169998,170.008163,86709100,11826992722.076586,7379648900,37.46435541774293,88.0,2.831836840461307,49.36300711658484,30.426308277231367,174.3919225769231,172.8260642763595,-69.57369172276863
2022-01-10,169.080002,172.5,168.169998,172.190002,170.027878,106765600,11918470974.648663,7486414500,34.903889425780214,84.0,2.3454296235867105,49.39582555311964,27.217352141543092,174.7161536153846,172.77894855218472,-72.78264785845691
2022-01-11,172.320007,175.179993,170.820007,175.080002,172.881592,76138300,11991116995.198545,7562552800,33.16075593095779,80.0,2.168154116080018,54.03114187807722,46.78403607744463,175.22538461538463,172.94939695572657,-53.21596392255537
2022-01-12,176.119995,177.179993,174.820007,175.529999,173.325943,74805200,11961321463.52573,7637358000,31.974604769236095,40.0,2.0404519365111753,54.726539471244344,49.83073125775735,175.6180766153846,173.14055266270978,-50.16926874224265
2022-01-13,175.779999,176.619995,171.789993,172.190002,170.027878,84505800,11890812792.53404,7552852200,30.045625687221253,40.0,1.650708850677887,48.82296847677921,27.217352141543092,175.65692311538461,173.07014150250907,-72.78264785845691
2022-01-14,171.339996,173.779999,171.089996,173.070007,170.89682,80440800,11928790945.114243,7633293000,28.073482940423663,40.0,1.3967429133364249,50.3428928010772,33.17540740002516,175.57961561538463,173.07013153936026,-66.82459259997485
2022-01-18,171.509995,172.539993,169.410004,169.800003,167.667877,90956700,11860500792.532333,7542336300,26.323857968804965,40.0,0.9209944335009652,44.99526122529272,11.035914411397663,175.39653888461538,172.82789979570393,-88.96408558860233
2022-01-19,170.0,171.080002,165.940002,166.229996,164.142731,94815000,11776384540.045952,7447521300,25.49478126488751,-40.0,0.2529744742737421,39.99968745471081,1.7058470588235717,174.8880773076923,172.33916618120733,-98.29415294117643
2022-01-20,166.979996,169.679993,164.179993,164.509995,162.444305,91420500,11695934566.533588,7356100800,25.086474850700288,-43.99999999999999,-0.41049394363105307,37.8209953080826,1.7590716507652395,174.45615384615382,171.75922757519197,-98.24092834923476
2022-01-21,164.419998,166.330002,162.300003,162.410004,160.370651,122848900,11579792120.728191,7233251900,25.073550354877103,-48.0,-1.0931480380735081,35.29340735788574,0.5329506072165157,173.9976923846154,171.06669249554812,-99.46704939278348
2022-01-24,160.020004,162.300003,154.699997,161.619995,159.590591,162294600,11713044210.4047,7070957300,26.229128984185934,-52.0,-1.678554123028988,34.36301971685464,24.504237871062678,173.31769207692307,170.36693712550752,-75.49576212893733
2022-01-25,158.979996,162.759995,157.020004,159.779999,157.773682,115798400,11708605917.069675,6955158900,27.161018297837114,-52.0,-2.2648570998684363,32.23181748436758,19.945040441890868,172.83769223076922,169.58271948658106,-80.05495955810913
2022-01-26,163.5,164.389999,157.820007,159.690002,157.684799,108275300,11661966695.050745,6846883600,27.522157361763114,-52.0,-2.705580194544723,32.12686384300211,22.19753508852936,172.39730773076923,168.84992559868618,-77.80246491147065
2022-01-27,162.449997,163.839996,158.279999,159.220001,157.220734,121954600,11581248652.519823,6724929000,27.85750077826583,-52.0,-3.0575362009771823,31.549093777021795,20.10678293714999,171.99230776923076,168.13659785063535,-79.89321706285001
2022-01-28,165.710007,170.350006,162.800003,170.330002,168.191223,179935700,11760230860.516495,6904864700,26.373385739309576,-52.0,-2.4121736054359246,53.04543426731374,69.5285043645026,171.88999996153845,168.29907223206976,-30.471495635497394
2022-01-31,170.160004,175.0,169.509995,174.779999,172.585342,115541600,11866512262.195509,7020406300,24.95972071913974,-52.0,-1.5240729667020787,58.647150157010884,89.32386820709402,171.8569230384615,168.77914088154608,-10.676131792905979
2022-02-01,174.009995,174.839996,172.309998,174.610001,172.417465,86213900,11937051236.025211,6934192400,23.647031771839178,-52.0,-0.8244603640849277,58.360710859219694,88.56764921132554,171.79269234615384,169.211056445876,-11.432350788674452
2022-02-02,174.75,175.880005,173.330002,175.839996,173.632019,84914300,12019300961.72573,7019106700,22.641863820661218,-52.0,-0.16881601315600392,59.88726488928348,96.44161007678935,171.6199998076923,169.70208900544077,-3.5583899232106475
2022-02-03,174.479996,176.240005,172.119995,172.899994,170.728928,89418100,11963740074.976135,6929688600,21.40646648432986,-52.0,0.1122592135051832,54.72300842789627,84.49391940801506,171.37423061538462,169.9389708568896,-15.506080591984944
2022-02-04,171.679993,174.100006,170.679993,172.389999,170.44223,82465400,11963740050.863537,6847223200,19.904702264497633,-52.0,0.2905121778294131,53.8554357968769,82.12625547771381,171.10538423076923,170.12052849712,-17.87374452228619
2022-02-07,172.860001,173.949997,170.949997,171.660004,169.72049,77251200,11923054779.369137,6769972000,18.510206917510565,-52.0,0.3686251592477845,52.570687111252596,78.7372363092901,170.85384603846154,170.23456371955558,-21.26276369070991
2022-02-08,171.729996,175.350006,171.429993,174.830002,172.854645,74829200,11978031247.596666,6844801200,17.574341350805106,-52.00000000000001,0.6785012653818399,57.330895368226706,93.45402750082549,170.74846123076924,170.57496655514407,-6.545972499174508
2022-02-09,176.050003,176.649994,174.899994,176.279999,174.288254,71285000,12019173283.510954,6916086200,17.02985203822868,-52.0,1.02921875861648,59.341043874533284,98.31437334592808,170.52807676923078,170.9975615510593,-1.6856266540719291
2022-02-10,174.139999,175.479996,171.550003,172.119995,170.175278,90865900,11954665107.84929,6825220300,16.026345255153068,-48.0,0.9604162617647773,51.80114833468013,79.36218852330592,170.23653823076924,171.08070476949936,-20.637811476694072
2022-02-11,172.330002,173.080002,168.039993,168.639999,166.734589,98670700,11879487624.636879,6726549600,15.906471154532442,-28.0,0.6179597384563067,46.480653206094395,59.19511421045041,169.9949998076923,170.89991174953644,-40.804885789549594
2022-02-14,167.369995,169.580002,166.559998,168.880005,166.971893,86185500,11925719805.738295,6812735100,16.104213727811764,-28.0,0.36175684710687506,46.88583605143134,58.73608940887752,169.875,170.75028902734854,-41.26391059112248
2022-02-15,170.970001,172.949997,170.25,172.789993,170.837692,62527400,11980836357.422834,6875262500,15.353518296972586,-28.0,0.4688133755697663,53.11351138849251,78.987468423372,169.89884596153846,170.90137821050791,-21.012531576628003
2022-02-16,171.850006,173.339996,170.050003,172.550003,170.600433,61177400,12012633927.278393,6814085100,14.554239739807455,-28.0,0.5282024690883418,52.70503204427834,70.39715765880287,169.91269215384617,171.02349856528508,-29.60284234119713
2022-02-17,171.029999,171.910004,168.470001,168.880005,166.971893,69589300,11959632921.740461,6744495800,14.194165424240756,-28.000000000000004,0.27594961108621874,46.78009729137131,22.993140928896377,169.6742307307692,170.86472126415285,-77.00685907110362
2022-02-18,169.820007,170.539993,166.190002,167.300003,165.40976,82772700,11919102966.506002,6661723100,14.375727976665175,48.0,-0.05086916496773597,44.462683163990334,10.611872360896749,169.35769242307694,170.6006680594008,-89.38812763910325
2022-02-22,164.979996,166.690002,162.149994,164.320007,162.463409,91162800,11915087352.641535,6570560300,15.33048239081124,48.0,-0.5440645346400288,40.397843329918366,14.965606896551803,169.05500030769232,170.1354339068526,-85.0343931034482
2022-02-23,165.539993,166.149994,159.75,160.070007,158.261429,90009200,11834079277.975214,6480551100,16.61947448419349,48.0,-1.263302336695034,35.42388751463673,1.893533216639036,168.5550003076923,169.38984672856722,-98.10646678336096
2022-02-24,152.580002,162.850006,152.0,162.740005,160.901276,141147500,11972364776.58139,6621698600,18.83151585418585,-40.0,-1.5994198358926326,40.38950392700473,43.570010605276416,168.28346192307694,168.89726585978448,-56.429989394723584
2022-02-25,163.839996,165.119995,160.869995,164.850006,162.987442,91974200,12052653319.036074,6713672800,20.220945083684686,-39.99999999999999,-1.676213582148364,44.05093222892583,52.1298544737983,168.2303853846154,168.59746883313377,-47.8701455262017
2022-02-28,163.059998,165.419998,162.429993,165.119995,163.254364,95056600,12128634857.175106,6808729400,21.423289306913073,-40.0,-1.6957398895322342,44.52051088009214,53.22514480125226,168.2538469230769,168.33987817882758,-46.77485519874774
2022-03-01,164.699997,166.600006,161.970001,163.199997,161.356064,83474400,12089511674.118673,6725255000,22.184367709238384,-40.0,-1.844875841020638,41.83169920799847,45.43610436578605,168.2842312692308,167.95914623965515,-54.56389563421395
2022-03-02,164.389999,167.360001,162.949997,166.559998,164.678085,79724800,12140311294.379879,6804979800,22.659370921979455,-40.0,-1.6726617535426556,47.775912930288314,62.01022351111136,168.4742313846154,167.85550562931033,-37.98977648888864
2022-03-03,168.470001,168.910004,165.550003,166.229996,164.351837,76678400,12094669060.887686,6728301400,22.629426817638997,-40.0,-1.5449994598941714,47.265043461277955,66.68228054025873,168.7223081923077,167.73509750862067,-33.31771945974127
2022-03-04,164.490005,165.550003,162.100006,163.169998,161.326385,83737200,12062872853.359505,6644564200,23.208599586319274,-40.0,-1.6714747174642355,42.70500044977059,52.343018246113935,168.85615419230768,167.39694198946358,-47.65698175388606
2022-03-07,163.360001,165.020004,159.039993,159.300003,157.500153,96418800,11974838603.885582,6548145400,24.214011594564486,-40.0,-2.060234423908412,37.74519647312327,34.20808045137402,168.8592311923077,166.7971687309848,-65.79191954862597
2022-03-08,158.820007,162.880005,155.800003,157.440002,155.661133,131148300,11904448219.166311,6416997100,25.58343710337999,-40.0,-2.4897159326734197,35.60485781963574,25.49204788979337,168.36346196153846,166.10404526943034,-74.50795211020663
2022-03-09,161.479996,163.410004,159.410004,162.949997,161.108887,91454900,11974868172.074162,6508452000,26.682469708925673,-40.0,-2.3582877024161064,45.46953188901701,54.99746258212707,167.9084618846154,165.87041206428736,-45.00253741787293
2022-03-10,160.199997,160.389999,155.979996,158.520004,156.728958,105342000,11990872811.85468,6403110000,28.146129474870857,-40.0,-2.5818315481984087,40.14482482807199,35.16724089378025,167.28961584615385,165.3259373928587,-64.83275910621974
2022-03-11,158.929993,159.279999,154.5,154.729996,152.98175,96970100,11903234402.141476,6306139900,29.680933294803896,-40.00000000000001,-3.0298869766808423,36.235260244768426,16.144265844053034,166.47769276923074,164.54105284523953,-83.85573415594696
2022-03-14,151.449997,154.119995,150.100006,150.619995,148.918198,108732100,11822631481.573011,6197407800,31.572843461199344,-88.0,-3.6742622556721187,32.534970545878295,2.7644287894128525,165.62076973076924,163.50986337522178,-97.23557121058715
2022-03-15,150.899994,155.570007,150.380005,155.089996,153.337692,92964300,11898399685.460794,6290372100,32.838625964222075,-88.0,-3.7806614713414035,39.74219467666711,26.52839197537401,164.955385,162.88616949557573,-73.471608024626
2022-03-16,157.050003,160.0,154.460007,159.589996,157.78685,102300200,11985557811.743084,6392672300,32.66502168738619,-88.0,-3.461963860012844,45.99678032258791,50.45183949514517,164.49115392307692,162.64200849590344,-49.54816050485483
2022-03-17,158.610001,161.0,157.630005,160.619995,158.805222,75615400,12044120230.906612,6468287700,32.22591420611111,-88.0,-3.0906542572909075,47.34401105216344,55.92764550001544,163.9446151923077,162.49222971842912,-44.07235449998457
2022-03-18,160.509995,164.479996,159.759995,163.979996,162.127258,123511700,12141464203.399775,6591799400,30.90936227058723,-84.0,-2.4964867764427936,51.58699738401872,73.79049163109964,163.47153815384615,162.60243462817513,-26.20950836890037
2022-03-21,163.509995,166.350006,163.009995,165.380005,163.511444,95811400,12181624796.37465,6687610800,29.23983121145607,-68.0,-1.890839322485533,53.276411631452085,81.23338981747908,163.2123077692308,162.80818058164365,-18.766610182520907
2022-03-22,165.509995,169.419998,164.910004,168.820007,166.912582,81532000,12241463434.382593,6769142800,27.293664084297255,-68.0,-1.1203650685590674,57.22612250652575,96.89445523579933,163.21923115384612,163.25350105707747,-3.105544764200674
2022-03-23,167.990005,172.639999,167.649994,170.210007,168.286865,98062700,12244018584.1904,6867205500,26.123469562437542,-68.0,-0.3930662648438954,58.74373135991194,89.21919807162318,163.27038507692308,163.76879779359024,-10.780801928376821
2022-03-24,171.059998,174.139999,170.210007,174.070007,172.103256,90131400,12330939556.816095,6957336900,25.31465074062112,32.0,0.4891543507715994,62.7013301304739,99.70885182870069,163.3196163846154,164.5318503273984,-0.29114817129932197
2022-03-25,173.880005,175.279999,172.75,174.720001,172.745895,80546200,12375829054.25803,7037883100,24.773539564930328,36.0,1.2266298034530223,63.339082198913054,97.77602003304764,163.40307784615382,165.2865281549985,-2.2239799669523634
2022-03-28,172.169998,175.729996,172.0,175.600006,173.615982,90371900,12459902050.301565,7128255000,24.070438053986525,40.0,1.8606451033777205,64.23080159729068,99.4928207151076,163.66153942307693,166.0504894768505,-0.5071792848923948
2022-03-29,176.690002,179.009995,176.339996,178.960007,176.938004,100589400,12556724959.806849,7228844400,24.031356255497222,43.99999999999999,2.60421107222615,67.4829814166522,99.82709090619159,164.11000111538462,167.0067500341208,-0.17290909380841774
2022-03-30,178.550003,179.610001,176.699997,177.770004,175.761444,92633200,12532214121.447863,7136211200,24.10164905053389,48.0,3.0621703689338347,65.22121595798191,93.76483459248294,164.6273086923077,167.80402810566744,-6.235165407517049
2022-03-31,177.839996,178.029999,174.399994,174.610001,172.637146,103049300,12441088261.96384,7033161900,23.501284913046998,48.0,3.1339938479050033,59.51673030813502,83.05658811531482,165.18653923076926,168.30817424598837,-16.94341188468517
2022-04-01,174.029999,174.880005,171.940002,174.309998,172.34053,78751300,12489302999.750061,6954410600,22.29035802137995,48.0,3.1306189115102825,58.98922952291781,81.86793114853657,165.63153896153847,168.7527537833226,-18.13206885146342
2022-04-04,174.570007,178.490005,174.440002,178.440002,176.423889,76468400,12563883179.22025,7030879000,21.907401761503515,48.0,3.42175717032913,63.75217448306422,95.34791539115271,166.15423111538465,169.4703277252987,-4.652084608847292
2022-04-05,177.5,178.300003,174.419998,175.059998,173.082077,73401800,12514696374.819483,6957477200,21.546266802498813,48.0,3.341232613331613,57.83246042919853,79.29934564137316,166.53653892307693,169.88437737527656,-20.700654358626835
2022-04-06,172.360001,173.630005,170.130005,171.830002,169.888535,89058800,12512151685.004396,6868418400,20.103414194503507,48.0,2.982403349435174,52.788045921156176,60.806062224867844,166.86846219230767,170.02849771784867,-39.19393777513216
2022-04-07,171.160004,173.360001,169.850006,172.139999,170.195053,77594700,12535805744.525192,6946013100,18.69673030695717,48.0,2.6920109136253245,53.20987209037716,55.00000421686583,167.0830776153846,170.18490522023023,-44.99999578313417
2022-04-08,171.779999,171.779999,169.199997,170.089996,168.168198,76575500,12512061303.12476,6869437600,17.493922107281627,48.0,2.270284282564859,50.02666575596935,35.23804800776502,167.23153915384617,170.1778749076206,-64.76195199223497
2022-04-11,168.710007,169.029999,165.5,165.75,163.877243,72246700,12450047849.64976,6797190900,17.2293803096863,48.0,1.5677889872033859,44.02232821248247,1.7717929290012084,167.33077000000003,169.84988417372278,-98.22820707099879
2022-04-12,168.020004,169.869995,166.639999,167.660004,165.765671,79265200,12420845188.628756,6876456100,16.749092704823685,48.0,1.1518993855702604,47.035199063224574,15.30831925525721,167.6523085,169.6876708275211,-84.6916807447428
2022-04-13,167.389999,171.039993,166.770004,170.399994,168.474701,70618900,12470294935.555481,6947075000,15.975495382171854,48.0,1.0315075964210223,51.10116366048637,34.72709888539334,168.15076973076924,169.74043550696396,-65.27290111460667
2022-04-14,170.619995,171.270004,165.039993,165.289993,163.42244,75329400,12401011223.115263,6871745600,15.67377306696561,48.00000000000001,0.5177930653619853,44.274798276553334,1.7158535534091675,168.2407695769231,169.4107730990407,-98.28414644659084
2022-04-18,163.919998,166.600006,163.570007,165.070007,163.204956,69023900,12400327840.719395,6802721700,15.7320003941185,48.0,0.0918606542432201,44.0022818532671,9.3516244457448,168.49269276923076,169.08923486948214,-90.6483755542552
2022-04-19,165.020004,167.820007,163.910004,167.399994,165.508591,67723800,12453501842.977858,6870445500,15.405105903897976,48.0,-0.05702601149650377,47.67579711412549,23.877733370723124,168.98000038461538,168.96410591618718,-76.12226662927688
2022-04-20,168.759995,168.880005,166.100006,167.229996,165.340546,67929800,12440795080.613482,6802515700,14.775393869045192,44.0,-0.18658633352620768,47.43131243020158,24.53076066095986,169.6188465769231,168.83565332980294,-75.46923933904013
2022-04-21,168.910004,171.529999,165.910004,166.419998,164.539703,87227800,12369398488.51783,6715287900,14.007564129094737,40.0,-0.35058259342383735,46.215228316199294,19.10181891445287,170.05461588461543,168.65671589796568,-80.89818108554714
2022-04-22,166.460007,167.869995,161.5,161.789993,159.962006,84882400,12292244603.790825,6630405500,13.844783424215597,36.0,-0.8444195766094538,39.91549469143989,1.7068447007520584,170.13923115384614,168.14806975737562,-98.29315529924794
2022-04-25,161.119995,163.169998,158.460007,162.880005,161.039673,96046400,12376463896.828115,6726451900,14.330863849544512,-68.0,-1.1347533545855413,41.9226383821056,22.2782202173832,170.2261546153846,167.75784273831076,-77.72177978261679
2022-04-26,162.25,162.339996,156.720001,156.800003,155.028381,95623200,12283563135.992706,6630828700,15.114610612781137,-72.0,-1.8343055811527336,34.91616282634834,0.47310455988069183,169.95000103846152,166.9461509058433,-99.52689544011932
2022-04-27,155.910004,159.789993,155.380005,156.570007,154.80098,88063200,12243026316.62068,6542765500,16.089838082695763,-76.0,-2.3798313018973545,34.6800433128837,6.618477556947136,169.61115496153846,166.1775476535586,-93.38152244305286
2022-04-28,159.25,164.520004,158.929993,163.639999,161.791092,130216800,12332244472.759693,6672982300,15.616811472689829,-76.0,-2.2161289429149633,46.62819174939511,50.3658354996958,169.41192388461542,165.98958108662833,-49.6341645003042
2022-04-29,161.839996,166.199997,157.25,157.649994,155.868759,131747600,12212273021.849888,6541234700,15.177572477684318,-76.0,-2.540452234961066,39.95914378254964,14.055664664643109,168.92884646153846,165.3718338950262,-85.94433533535688
2022-05-02,156.710007,158.229996,153.270004,157.960007,156.175278,123055300,12321931696.455452,6664290000,15.594867472002951,-88.0,-2.740870275909316,40.43398804622188,25.68457986981918,168.30923107692308,164.8228096805798,-74.31542013018081
2022-05-03,158.149994,160.710007,156.320007,159.479996,157.678101,88966500,12361044085.461603,6753256500,15.300544732964097,-88.0,-2.7454052849039954,42.821693914351535,34.00872782276227,167.72307703846155,164.42704570424056,-65.99127217723773
2022-05-04,159.669998,166.479996,159.259995,166.020004,164.144226,108256500,12455506370.212048,6861513000,14.701969600575763,-88.0,-2.19596164482968,51.77836718891407,69.82477267929151,167.35461542307695,164.54504261503754,-30.17522732070848
2022-05-05,163.850006,164.080002,154.949997,156.770004,154.998734,130525300,12377019806.15515,6730987700,14.052480826338439,-88.0,-2.4783523924087376,41.80407286160079,19.167584657060416,166.50115376923077,163.96911382873847,-80.83241534293958
2022-05-06,156.009995,159.440002,154.179993,157.279999,155.731445,116124600,12397772141.821077,6847112300,13.598044908338847,-76.0,-2.6306720106839805,42.46217924955825,21.960548181968303,165.71307665384614,163.4736238414245,-78.0394518180317
2022-05-09,154.929993,155.830002,151.490005,152.059998,150.56282,131577900,12300755778.133062,6715534400,13.681131673624991,-96.0,-3.1364419109203254,37.75589999420579,2.844277298685871,164.84576884615385,162.6281700753931,-97.15572270131413
2022-05-10,155.520004,156.740005,152.929993,154.509995,152.988693,115366700,12281073614.944706,6830901100,13.535738864127172,-96.0,-3.3015160958813112,41.05792591130408,15.069814891162173,164.08423026923077,162.02682377351212,-84.93018510883782
2022-05-11,153.5,155.449997,145.809998,146.5,145.057587,142689800,12158810424.403814,6688211300,14.575645626189639,-100.0,-4.032197567336425,34.596030394032596,3.127842673777305,162.85576865384616,160.87668867917787,-96.8721573262227
2022-05-12,142.770004,146.199997,138.800003,142.559998,141.156372,182602000,12161771441.614368,6505609300,16.38796864949189,-100.0,-4.873019990073772,31.933705113331442,13.583800400527572,161.60576865384616,159.51989677701656,-86.41619959947242
2022-05-13,144.589996,148.100006,143.110001,147.110001,145.66156,113990900,12230531300.381144,6619600200,17.611912656747798,-96.0,-5.113287802872861,37.878997600644645,30.02167666733156,160.65499938461537,158.60064523797828,-69.97832333266845
2022-05-16,145.550003,147.520004,144.179993,145.539993,144.10701,86643800,12214447488.357231,6532956400,18.748432092056856,-92.0,-5.368503533095804,36.68818822442867,24.349681013286407,159.63192223076925,157.63318951664655,-75.65031898671359
2022-05-17,148.860001,149.770004,146.679993,149.240005,147.770599,78336300,12265911288.121017,6611292700,19.23808610686309,-60.0,-5.212121697423271,41.366364092626064,37.71677976941683,158.8299995,157.01147214504311,-62.283220230583176
2022-05-18,146.850006,147.360001,139.899994,140.820007,139.433502,109742900,12183236699.091154,6501549800,20.55049802649279,-60.0,-5.701883670073869,35.02400103598423,7.2977041576563995,157.87115361538463,155.81210435652142,-92.7022958423436
2022-05-19,139.880005,141.660004,136.600006,137.350006,135.997665,136095600,12087485660.492167,6365454200,22.11678095347974,-80.0,-6.297430780611194,32.792579483397105,2.5100410006830667,156.70538446153844,154.4445415152976,-97.48995899931694
2022-05-20,139.089996,140.699997,132.610001,137.589996,136.235306,137426100,12119251557.835428,6502880300,23.950030023786418,-84.0,-6.673117425270249,33.10999294205044,14.70326464470988,155.44346146153845,153.1960566623126,-85.29673535529012
2022-05-23,137.789993,143.259995,137.649994,143.110001,141.700958,117726300,12230682586.714373,6620606600,25.020096704902954,-84.0,-6.451069612108313,40.11570177519865,31.00089031604523,154.59038484615385,152.44894142806723,-68.99910968395477
2022-05-24,140.809998,141.970001,137.330002,140.360001,138.978043,104132700,12262550768.122883,6516473900,26.04861794162995,-84.0,-6.4229572842793345,37.98147495285656,24.626627752569824,153.64,151.5534643593215,-75.37337224743018
2022-05-25,138.429993,141.789993,138.339996,140.520004,139.136459,92482700,12286945286.196753,6608956600,27.003673375733587,-84.0,-6.314972089720698,38.18752959155823,29.48193330294693,152.60615423076922,150.73617099937178,-70.51806669705307
2022-05-26,137.389999,144.339996,137.139999,143.779999,142.364349,90601500,12363453289.159046,6699558100,27.20505946494867,-84.0,-5.898346229713553,42.38754457046718,46.290908198771945,151.70423126923077,150.22089899941832,-53.709091801228055
2022-05-27,145.389999,149.679993,145.259995,149.639999,148.166656,90978500,12452785365.731253,6790536600,26.146046636424337,-80.0,-5.037247949312359,49.0846731852503,70.57602642751318,151.0588466923077,150.17786936983177,-29.42397357248682
2022-05-31,149.070007,150.660004,146.839996,148.839996,147.374527,103718400,12457672392.735596,6686818200,24.955020151663593,-48.0,-4.369011667524404,48.259894730740264,71.0595352118276,150.56076988461538,150.07876763873313,-28.94046478817241
2022-06-01,149.899994,151.740005,147.679993,148.710007,147.245819,74286600,12421078409.413773,6612531600,23.616145661690695,-48.0,-3.8060449092287456,48.118412348491304,84.16101742581964,150.01576996153847,149.97737796178995,-15.838982574180374
2022-06-02,147.830002,151.270004,146.860001,151.210007,149.721191,72348100,12491457953.403402,6684879700,22.53219181551171,-48.0,-3.1221701566126967,51.08834396748932,97.22949352232229,149.8007701153846,150.06868381647217,-2.770506477677718
2022-06-03,146.899994,147.970001,144.460007,145.380005,143.948608,88570300,12449317646.650913,6596309400,21.98162447201094,-48.0,-3.0158619469378607,44.66690406105048,66.75379681049732,149.37038542307693,149.72137427451128,-33.24620318950268
2022-06-06,147.029999,148.570007,144.899994,146.139999,144.701126,71598400,12426101840.386684,6667907800,21.319266441970562,-48.0,-2.8375769399625597,45.6263602447151,70.72658217949137,148.6973085,149.45608721714007,-29.27341782050862
2022-06-07,144.350006,149.0,144.100006,148.710007,147.245819,67808200,12485883947.561836,6735716000,20.86492241861302,-48.00000000000001,-2.460543012104864,48.85592851470461,84.16101742581964,148.35346284615383,149.40082201587043,-15.838982574180374
2022-06-08,148.580002,149.869995,147.460007,147.960007,146.50322,53950200,12454319834.131561,6681765800,20.202431731985065,-48.0,-2.1969347437023146,47.96066126431126,80.24047459686884,147.96884746153847,149.2940949776578,-19.75952540313117
2022-06-09,147.080002,147.949997,142.529999,142.639999,141.235596,69473000,12387666772.441502,6612292800,20.545175349428945,-48.0,-2.3897558582735314,42.07143241908829,52.43071564438766,147.3211552692308,148.8011989793128,-47.56928435561234
2022-06-10,140.279999,140.759995,137.059998,137.130005,135.779846,91437900,12299689033.660713,6520854900,21.685422978318886,-44.0,-2.9531365279999875,37.003409871528085,0.4768866935826664,146.21000146153847,147.93666609195628,-99.52311330641734
2022-06-13,132.869995,135.199997,131.440002,131.880005,130.581512,122207100,12206083828.408606,6398647800,23.40241862076223,-100.0,-3.779681080885382,32.93268925534372,2.1675021427337646,145.2526938076923,146.7472837888484,-97.83249785726625
2022-06-14,133.130005,133.889999,131.479996,132.759995,131.452866,84784300,12211360677.05921,6483432100,24.996771717316765,-92.0,-4.313986800885232,34.23857117239535,6.502427610478731,144.30961673076922,145.71118832300778,-93.49757238952127
2022-06-15,134.289993,137.339996,132.160004,135.429993,134.096573,91533000,12235392296.903025,6574965100,25.50244147082745,-92.0,-4.470448857285277,38.1722111857914,19.655125174119444,143.67000115384616,144.94961829908127,-80.34487482588057
2022-06-16,132.080002,132.389999,129.039993,130.059998,128.779419,108123900,12193111215.464842,6466841200,26.377522245904608,-100.0,-4.970463472900292,33.79387599167217,4.493411721544456,142.72961665384616,143.84668346211228,-95.50658827845554
2022-06-17,130.070007,133.080002,129.809998,131.559998,130.264664,134520300,12202572711.817385,6601361500,26.99804350924136,-44.0,-5.185911237579859,36.00203289282357,11.10133774378621,142.1550011923077,142.93655861306692,-88.89866225621378
2022-06-21,133.419998,137.059998,133.320007,135.869995,134.532211,81000500,12232027185.101543,6682362000,26.531016982934357,-44.0,-4.951793215746676,41.98907045120893,30.08809863184206,141.8976933846154,142.41310945654342,-69.91190136815794
2022-06-22,134.789993,137.759995,133.910004,135.350006,134.01738,73409200,12213532084.8064,6608952800,25.924658201619785,-44.0,-4.753417327236406,41.48483079403253,28.385109660989375,141.4453858846154,141.88991660791058,-71.61489033901061
2022-06-23,136.820007,138.589996,135.630005,138.270004,136.908585,72433800,12270304866.560331,6681386600,25.150921538472698,-44.0,-4.310890311141634,45.44665502686614,44.31113832826324,141.16577092307693,141.62177493325055,-55.68886167173676
2022-06-24,139.899994,141.910004,139.770004,141.660004,140.265228,89116800,12338599984.31734,6770503400,23.63354101584375,-44.0,-3.644626804957511,49.70420942379289,60.58574070228121,140.87423242307693,141.62460671597273,-39.41425929771879
2022-06-27,142.699997,143.490005,140.970001,141.660004,140.265228,70207900,12306839373.784897,6840711300,22.018438887929843,-44.0,-3.081091273845061,49.70420942379289,60.58574070228121,140.90653999999998,141.6272287370118,-39.41425929771879
2022-06-28,142.130005,143.419998,137.320007,137.440002,136.086777,67083400,12242395214.591318,6773627900,21.134462599460647,-44.0,-2.9411010170037457,44.67098104752986,40.326491567307535,140.91000138461538,141.31706379352943,-59.67350843269246
2022-06-29,137.460007,140.669998,136.669998,139.229996,137.859161,66242400,12260943020.348919,6839870300,20.44170745244625,-44.0,-2.655113675979891,47.11717945055372,53.88683682985999,140.9730783076923,141.16246617919393,-46.11316317014001
2022-06-30,137.25,138.369995,133.770004,136.720001,135.373871,98964500,12288911367.872534,6740905800,20.349098754417184,-44.0,-2.601019335565411,44.16831057909822,53.1488001532455,140.72730907692306,140.83339468443882,-46.8511998467545
2022-07-01,136.039993,139.039993,135.660004,138.929993,137.562103,71051600,12355338292.466785,6811957400,20.08269482791309,-44.0,-2.352700825718557,47.2959908993501,68.44284973604171,140.67230876923077,140.69240196707298,-31.55715026395829
2022-07-05,137.770004,141.610001,136.929993,141.559998,140.166214,73353800,12427124612.214016,6885311200,19.1645961192713,-44.00000000000001,-1.921536912582468,50.82639328145342,86.64356126486267,140.71230853846154,140.75666833988237,-13.35643873513732
2022-07-06,141.350006,144.119995,141.080002,142.919998,141.512817,74064300,12442717107.96506,6959375500,17.877320905597884,-44.0,-1.4533425428880378,52.59476623953411,92.04246126757809,140.6792315769231,140.91691498137257,-7.957538732421905
2022-07-07,143.289993,146.550003,143.279999,146.350006,144.909058,66253700,12500866511.310438,7025629200,17.21352836808914,-44.0,-0.7963424122968092,56.81304515442063,98.85781333077483,140.5526933846154,141.31936616793757,-1.1421866692251819
2022-07-08,145.259995,147.550003,145.0,147.039993,145.592239,64547800,12539594715.429178,7090177000,16.80794893803175,-44.0,-0.21748189502679338,57.629815226976525,97.12508536497035,140.4834625,141.7431163036459,-2.8749146350296644
2022-07-11,145.669998,146.639999,143.779999,144.869995,143.443619,63141600,12524581850.69743,7027035400,16.107175244959787,-40.0,0.06541447485741969,54.160580741359716,81.16648802993328,140.33576973076921,141.97473694782028,-18.833511970066716
2022-07-12,145.759995,148.449997,145.050003,145.860001,144.423859,77588800,12483961805.83194,7104624200,15.861962957401184,-24.0,0.3652863034008078,55.4774116405179,82.35696706394897,140.13000026923078,142.26253428501877,-17.643032936051032
2022-07-13,142.990005,146.449997,142.119995,145.490005,144.05751,71185600,12523582706.08575,7033438600,14.860191430112362,-24.0,0.5665504619074113,54.843310622366495,79.83655714277248,140.13423103846154,142.50160618983222,-20.163442857227523
2022-07-14,144.080002,148.949997,143.25,148.470001,147.008194,78140700,12588562969.882996,7111579300,14.499328014612212,-24.000000000000004,0.9555001192911448,58.91631593436037,96.83796955637595,140.2238465,142.9437095091039,-3.162030443624052
2022-07-15,149.779999,150.860001,148.199997,150.169998,148.691422,76259900,12625259350.59528,7187839200,14.567694439067319,76.0,1.3849561628904894,61.07335030852886,95.96253293666454,140.28,143.47899013805917,-4.03746706333546
2022-07-18,150.740005,151.570007,146.699997,147.070007,145.621979,81420900,12556210723.838661,7106418300,14.21634580369834,80.0,1.458348867557902,55.36488878183847,74.71910538442044,140.2457692307692,143.74499138709183,-25.280894615579555
2022-07-19,147.919998,151.229996,146.910004,151.0,149.51326,82982400,12630357172.25801,7189400700,13.890093499427147,80.0,1.812734629134269,60.41616614327665,96.79771402285718,140.56730773076922,144.28239943249244,-3.202285977142834
2022-07-20,151.119995,153.720001,150.369995,153.039993,151.533173,64823400,12668863944.414837,7254224100,14.15694459414968,88.0,2.2324638311768865,62.771343117087525,96.5914380839256,141.17923034615384,144.93111006712263,-3.408561916074407
2022-07-21,154.5,155.570007,151.940002,155.350006,153.820435,65086600,12726061234.572784,7319310700,14.792966635601731,92.0,2.7201448546441327,65.2897930676694,98.89502276820353,142.0819226923077,145.70288013622468,-1.10497723179648
2022-07-22,155.389999,156.279999,153.410004,154.089996,152.572845,66675400,12690980829.40504,7252635300,15.529448757846792,96.0,2.970718706595477,62.794498595175675,88.68215854816795,142.90230734615386,146.32414797798583,-11.317841451832052
2022-07-25,154.009995,155.039993,152.279999,152.949997,151.444061,53623900,12663391700.315557,7199011400,15.824424558468126,96.0,3.042242816168823,60.54007946539669,78.09208778133306,143.57615365384615,146.81495160924612,-21.90791221866694
2022-07-26,152.259995,153.089996,150.800003,151.600006,150.107361,55138700,12646778118.441334,7143872700,15.604013156094242,92.0,2.9559192004081183,57.88959851190458,66.94921131378217,144.4046155,147.1694000826353,-33.05078868621782
2022-07-27,152.580002,157.330002,152.160004,156.789993,155.246246,78620700,12708974871.822283,7222493400,16.343117736676202,100.0,3.268617106004058,64.35128220638957,96.44964660437041,145.37499992307693,147.88203659503267,-3.550353395629582
2022-07-28,156.979996,157.639999,154.410004,157.350006,155.800751,81378700,12775741008.42878,7303872100,17.091743823437216,76.0,3.521032546502255,64.97579469147834,98.131488883637,146.20115419230768,148.58336766206727,-1.8685111163629937
2022-07-29,161.240005,163.630005,159.5,162.509995,160.909927,101786900,12822321028.113138,7405659000,18.816029208920487,80.0,4.09029125861332,70.16253479799983,94.79307541000675,147.24576915384617,149.61496968709935,-5.206924589993248
2022-08-01,161.009995,163.589996,160.889999,161.509995,159.919754,67829400,12785642741.749487,7337829600,20.41715135258352,80.0,4.409906588516719,68.05900954873809,90.14407710642624,148.13961496153846,150.49608267324015,-9.855922893573762
2022-08-02,160.100006,162.410004,159.630005,160.009995,158.43454,59907000,12742112769.892303,7277922600,21.441558688570094,80.0,4.490403994127462,64.91514081454798,82.23744302319845,148.84538384615385,151.2008169196668,-17.762556976801555
2022-08-03,160.839996,166.589996,160.75,166.130005,164.494293,82507500,12811622758.44452,7360430100,23.048477923469566,92.0,4.9905049928922836,70.83471605630315,97.68732517281674,149.78653773076923,152.30668270339518,-2.3126748271832587
2022-08-04,166.009995,167.190002,164.429993,165.809998,164.17746,55474100,12811622778.543768,7304956000,24.625860113748807,96.0,5.299922539014091,70.1680592734584,93.26498944241358,150.87769142307693,153.30692828092145,-6.735010557586421
2022-08-05,163.210007,165.850006,163.0,165.350006,163.949402,56697000,12848426136.214594,7248259000,25.553520860791885,96.0,5.445251197211917,69.16045621320974,90.92704052534924,151.88230719230768,154.1990081119643,-9.072959474650759
2022-08-08,166.369995,167.809998,164.199997,164.869995,163.473465,60276900,12810523414.197481,7187982100,26.73147566242866,100.0,5.458767061073928,68.06210562191143,83.1421875328805,152.96499926923076,154.98945158515212,-16.857812467119505
2022-08-09,164.020004,165.820007,163.25,164.919998,163.523026,63135500,12829439176.103771,7251117600,27.46252812453719,96.0,5.411137084771212,68.11890530580729,83.00998912698086,153.96461484615386,155.7250476158816,-16.990010873019152
2022-08-10,167.679993,169.339996,166.899994,169.240005,167.806442,70170500,12893858518.141195,7321288100,28.703514681824906,100.0,5.656770714907026,72.64523066190637,99.46067401427813,155.02923049999998,156.72615557026074,-0.539325985721877
2022-08-11,170.059998,170.990005,168.190002,168.490005,167.06279,57149200,12848955684.625517,7264138900,30.08948375578239,84.0,5.724925032364922,70.7667644882309,87.61763371791642,156.0126923076923,157.5975518243155,-12.382366282083582
2022-08-12,169.820007,172.169998,169.399994,172.100006,170.642227,68039400,12913556668.157671,7332178300,31.538322300356572,88.0,6.001058266471631,74.2219900295849,99.67247535621799,157.00307692307692,158.67180768918104,-0.3275246437820177
2022-08-15,171.520004,173.389999,171.350006,173.190002,171.722977,54091700,12957042275.171175,7386270000,33.04803873451464,92.0,6.235965087877503,75.17604364229976,99.05795079085041,158.0088465,159.74722948998246,-0.9420492091495838
2022-08-16,172.779999,173.710007,171.660004,173.029999,171.564331,56377100,12976017596.718365,7329892900,34.493622889024905,96.0,6.336179992535932,74.73876605192147,96.47664303471876,159.09192357692308,160.73113834257634,-3.5233569652812307
2022-08-17,172.770004,176.149994,172.570007,174.550003,173.071457,79542000,12984460744.05661,7409434900,36.156185622585674,100.0,6.4637426444189146,76.15759211370371,90.39044098154035,160.1953851923077,161.75475794682993,-9.609559018459642
2022-08-18,173.75,174.899994,173.119995,174.149994,172.674835,62290100,12994259157.263527,7347144800,37.69999387517782,96.0,6.458114458350934,74.96432155212793,87.89345440847448,161.29769246153847,162.67292358039808,-12.10654559152553
2022-08-19,173.029999,173.740005,171.309998,171.520004,170.067123,70346300,12936071789.380018,7276798500,38.27402029718002,88.0,6.170308392817873,67.47817898365835,71.97340748834641,162.18423103846155,163.32826287073897,-28.026592511653593
2022-08-22,169.690002,169.860001,167.139999,167.570007,166.150604,69026800,12888870029.372196,7207771700,37.15062176941397,88.0,5.559402929590362,58.09463566515703,44.285776994458615,162.85346215384612,163.64246613957312,-55.714223005541385
2022-08-23,167.080002,168.710007,166.649994,167.229996,165.813477,54147100,12865213442.09634,7153624600,35.934685358650235,84.0,4.9902948894025485,57.355272615013725,32.16728463906525,163.62884634615386,163.90820909219732,-67.83271536093474
2022-08-24,167.320007,168.110001,166.25,167.529999,166.110916,53841500,12885476274.468742,7207466100,34.6592480625343,80.0,4.511474927552769,57.86481918888755,34.44867731498589,164.26461553846156,164.17648982610865,-65.5513226850141
2022-08-25,168.779999,170.139999,168.350006,170.029999,168.589752,51218200,12930399475.549753,7258684300,33.973886213489045,64.0,4.284348462541686,61.94542389753683,52.558156228599856,164.9180773076923,164.61008309824874,-47.441843771400144
2022-08-26,170.570007,171.050003,163.559998,163.619995,162.234039,78961000,12852703474.20249,7179723300,31.74652073991436,64.0,3.546236543088071,48.875481142710896,2.8681796286105943,165.23615380769232,164.5367432391192,-97.1318203713894
2022-08-29,161.149994,162.899994,159.820007,161.380005,160.013031,73314000,12853655822.321493,7106409300,30.23587263023786,64.0,2.748842115674705,45.28010491165292,9.552965351411538,165.51653876923078,164.30291077696222,-90.44703464858847
2022-08-30,162.130005,162.559998,157.720001,158.910004,157.56395,77906200,12814058989.75234,7028503100,29.299358270258345,64.0,1.8957399390325804,41.64242068120809,6.456882539239111,165.7457698076923,163.90343620089095,-93.5431174607609
2022-08-31,160.309998,160.580002,157.139999,157.220001,155.888245,87991100,12730160597.800676,6940512000,28.55555483062105,60.0,1.0709361147228549,39.31512145832822,0.4208417729726254,165.96192346153845,163.4083669267509,-99.57915822702736
2022-09-01,156.639999,158.419998,154.669998,157.960007,156.622009,74229900,12786179785.304195,7014741900,28.379476900959936,56.00000000000001,0.4715497097540151,40.873352882762866,15.31661830849502,166.006924,163.00478470995452,-84.68338169150498
2022-09-02,159.75,160.360001,154.970001,155.809998,154.490189,76957800,12733208746.390133,6937784100,27.58663698730209,-44.0,-0.1749394988085271,37.833725811798985,5.307263558149708,165.94769292307694,162.4718375462542,-94.69273644185029
2022-09-06,156.470001,157.089996,153.690002,154.529999,153.221039,73714800,12695917664.111753,6864069300,27.129915521071617,-52.0,-0.781562707809826,36.1119181648402,3.739970165617205,165.64076999999997,161.8835532094946,-96.2600298343828
2022-09-07,154.820007,156.669998,153.610001,155.960007,154.638931,87449600,12742786551.808048,6951518900,26.72368217818104,-56.0,-1.1338558919811135,39.428475753944035,11.038077842486755,165.42730892307694,161.44477200879132,-88.96192215751324
2022-09-08,154.639999,156.360001,152.679993,154.460007,153.151642,84923800,12740017765.021715,6866595100,26.56089318368082,-60.0,-1.516605755454549,37.244407345796276,8.452103446094874,165.21384784615384,160.9273820081401,-91.54789655390512
2022-09-09,155.470001,157.820007,154.75,157.369995,156.036987,68028800,12788102782.257961,6934623900,25.870303561545576,-60.0,-1.5670619532704393,43.753713869344054,25.530753657727953,164.8769243846154,160.663871859389,-74.46924634227206
2022-09-12,159.589996,164.259995,159.300003,163.429993,162.045624,104956000,12857932237.734503,7039579900,24.684133919475613,-60.0,-1.105316262633096,54.36853471222329,58.5192931304882,164.78538573076924,160.86876972165646,-41.4807068695118
2022-09-13,159.899994,160.539993,153.369995,153.839996,152.53688,122656600,12751356179.083776,6916923300,23.67657691946496,-60.0,-1.4959675048672523,41.13764805882307,6.314656333883416,164.34269303846153,160.34811981634857,-93.6853436661166
2022-09-14,154.789993,157.100006,153.610001,155.309998,153.994431,87965400,12749087456.36865,7004888700,22.74098827659793,-60.0,-1.6677201133998096,43.41095371661146,14.31684032833956,163.97500084615382,159.97492560773017,-85.68315967166043
2022-09-15,154.649994,155.240005,151.380005,152.369995,151.079346,90481100,12705018472.528753,6914407600,22.340981220070567,-80.0,-2.017808919362352,40.07720983593008,5.032994919470647,163.49230842307693,159.41159741456497,-94.96700508052936
2022-09-16,151.210007,151.350006,148.369995,150.699997,149.423477,162278800,12796503788.538794,6752128800,22.540063951717435,-84.0,-2.4023192611351476,38.278976350141896,14.663322844556358,162.77923119230766,158.76629368015276,-85.33667715544364
2022-09-19,149.309998,154.559998,149.100006,154.479996,153.171463,81474200,12875590403.008118,6833603000,21.834075869508357,-84.0,-2.3746585629669994,44.36403343670231,38.45186280679676,162.24038469230769,158.4487901482896,-61.54813719320324
2022-09-20,153.399994,158.080002,153.080002,156.899994,155.570969,107689800,12932450272.800756,6941292800,20.331090874017434,-84.0,-2.1328771662487327,47.905105041271526,53.68155443675265,161.65576884615382,158.33406450767555,-46.31844556324735
2022-09-21,157.339996,158.740005,153.600006,153.720001,152.417908,101696800,12835501764.586805,6839596000,18.972185355891337,-84.0,-2.1728156598028363,43.94685928532377,33.669011957205804,160.90692265384615,157.9922820256255,-66.33098804279419
2022-09-22,152.380005,154.470001,150.910004,152.740005,151.446198,86652500,12837935947.329796,6752943500,18.129671234196092,-84.0,-2.257521389398761,42.77390080789006,27.501636249213366,160.12653826923076,157.6032244681718,-72.49836375078664
2022-09-23,151.190002,151.470001,148.559998,150.429993,149.155762,96029900,12865325461.571293,6656913600,17.83153975502556,-80.0,-2.482433999316953,40.0597285118751,12.96411579609821,159.19884557692305,157.07187398904796,-87.0358842039018
2022-09-26,149.660004,153.770004,149.639999,150.770004,149.492889,93339400,12823062991.839901,6750253000,16.97293873963958,-76.0,-2.6032343518247103,40.65661845303826,15.103895531781053,158.2996151923077,156.60506880467403,-84.89610446821895
2022-09-27,152.740005,154.720001,149.949997,151.759995,150.474503,84442700,12802704564.35397,6834695700,15.94278835858252,-56.0,-2.58923837328436,42.45349190703682,21.334172435494093,157.53961484615385,156.24617444877225,-78.6658275645059
2022-09-28,147.639999,150.639999,144.839996,149.839996,148.57077,146691400,12908929240.431862,6688004300,16.040445867159406,-88.0,-2.7019281864132836,39.92837615863121,25.74665426089879,156.85769134615384,155.77164271182613,-74.2533457391012
2022-09-29,146.100006,146.720001,140.679993,142.479996,141.273117,128138200,12857164828.153534,6559866100,16.823467663601726,-92.0,-3.346549228763166,32.056977037988844,7.633599861441925,155.90576826923078,154.7870762887279,-92.36640013855806
2022-09-30,141.279999,143.100006,138.0,138.199997,137.029343,124925300,12742037432.400743,6434940800,17.942699757221316,-96.0,-4.154881313467342,28.5341901353151,0.8872984122044586,154.7776912692308,153.55840374882212,-99.11270158779554
2022-10-03,138.210007,143.070007,137.690002,142.449997,141.243347,114311700,12830001797.364065,6549252500,19.026742147567234,-100.0,-4.401809513010875,36.04935762387741,22.61279962762952,153.71692196153847,152.73555880446492,-77.38720037237049
2022-10-04,145.029999,146.220001,144.259995,146.100006,144.862442,87830100,12907077672.275469,6637082600,19.15663418632878,-60.0,-4.253939897120375,41.71782657269017,39.95250737018904,153.04307623076923,152.24403637450456,-60.04749262981096
2022-10-05,144.070007,147.380005,143.009995,146.399994,145.159897,79471000,12950904610.050896,6716553600,19.491585282647062,-60.0,-4.0656790197461135,42.17151459022098,41.37762830722636,152.46692196153847,151.81114434676348,-58.62237169277364
2022-10-06,145.809998,147.539993,145.220001,145.429993,144.19812,68402200,12894885137.907198,6648151400,19.75662794470826,-60.0,-3.9492276540569264,41.058557949478676,36.76954820386487,151.94846,151.33846646922547,-63.230451796135135
2022-10-07,142.539993,143.100006,139.449997,140.089996,138.903351,85925600,12839092229.675575,6562225800,20.92419685352226,-60.0,-4.238968052402356,35.50355380314065,11.401395049682513,151.28961365384615,150.50524643446803,-88.59860495031748
2022-10-10,140.419998,141.889999,138.570007,140.419998,139.230545,74899000,12847664801.841412,6637124800,22.13090761353244,-60.0,-4.391340363899133,36.0791047681271,12.969100289439385,150.61499792307694,149.7581909948778,-87.03089971056062
2022-10-11,139.899994,141.350006,138.220001,138.979996,137.80278,77033700,12808040132.709732,6560091100,23.301922665091375,-60.0,-4.575548569614284,34.62701244056038,7.574833093061291,149.96769015384615,148.9598061804424,-92.42516690693871
2022-10-12,139.130005,140.360001,138.160004,138.339996,137.168182,70433700,12749131450.72603,6489657400,24.398490562054565,-60.0,-4.718782365321431,33.972574455092825,3.816758885305987,149.34499773076922,148.1731535744837,-96.18324111469401
2022-10-13,134.990005,143.589996,134.369995,142.990005,141.778809,113224000,12847619361.004564,6602881400,25.963208039092258,-92.0,-4.406286389133953,42.47885157591913,42.358759009702524,148.8461515,147.78921664304048,-57.64124099029748
2022-10-14,144.309998,144.520004,138.190002,138.380005,137.207825,88598000,12764340122.608116,6514283400,27.082740744009676,-92.0,-4.478988557202058,37.34254548473551,19.705203035321077,148.2276898846154,147.09223800281526,-80.29479696467892
2022-10-17,141.070007,142.899994,140.270004,142.410004,141.20372,85250900,12817825055.063753,6599534300,28.122306827147277,-92.0,-4.1634249389396984,43.74607818489465,49.416146425040814,147.65230561538462,146.74540585445857,-50.583853574959186
2022-10-18,145.490005,146.699997,140.610001,143.75,142.532349,99136600,12820918021.34373,6698670900,27.758916189124808,-88.0,-3.7618477800282903,45.73205205819566,71.22252410364828,146.8953828076923,146.5235239393135,-28.77747589635172
2022-10-19,141.690002,144.949997,141.5,143.860001,142.641418,61758300,12843652345.4001,6760429200,27.421482025246796,-64.0,-3.3955767321059227,45.9008972130732,72.05776341044249,146.51153684615383,146.3262259438088,-27.942236589557513
2022-10-20,143.020004,145.889999,142.649994,143.389999,142.175385,64522000,12808603511.404474,6695907200,26.789046952382844,-64.0,-3.107409241772359,45.2530379113496,68.48903090190284,146.05307534615383,146.1087276516748,-31.51096909809716
2022-10-21,142.869995,147.850006,142.649994,147.270004,146.022537,86548600,12875845093.998669,6782455800,25.56331445744064,-64.0,-2.5367088520036702,51.35681656418379,95.6973180511499,145.85692184615385,146.19474812192112,-4.302681948850091
2022-10-24,147.190002,150.229996,146.0,149.449997,148.184067,75981900,12923805309.80885,6858437700,23.752292174309492,-64.0,-1.886767978515337,54.430906952474686,95.0819738283749,145.80884492307692,146.4358776684455,-4.918026171625104
2022-10-25,150.089996,152.490005,149.360001,152.339996,151.049576,74732300,12991374348.93717,6933170000,22.669764981233754,-64.0,-1.1255121832920736,58.20208103120514,99.17213621846797,145.72653723076922,146.87321976707915,-0.827863781532035
2022-10-26,150.960007,151.990005,148.039993,149.350006,148.084946,88194300,12961678949.459953,6844975700,21.275042825393637,-64.0,-0.7547780738346432,53.28851766301806,82.67109675988044,145.4361530769231,147.05668541396219,-17.328903240119555
2022-10-27,148.070007,149.050003,144.130005,144.800003,143.573456,109180200,12882234743.515072,6735795500,20.548056860259784,-48.0,-0.8186786197146319,46.81199579860294,57.56071878547535,145.0930762307692,146.8895237536687,-42.439281214524655
2022-10-28,148.199997,157.5,147.820007,155.740005,154.420792,164762400,12987083670.398304,6900557900,20.217522694445382,43.99999999999999,0.013293233168184315,59.54366029384745,92.3908576759927,145.20846084615386,147.54511495710065,-7.6091423240072915
2022-10-31,153.160004,154.240005,151.919998,153.339996,152.041107,97943200,13009035925.984087,6802614700,19.910598111903436,44.0,0.47351783319695073,56.356557297699,82.01468611874496,145.32038403846153,147.97436540472282,-17.98531388125504
2022-11-01,155.080002,155.449997,149.130005,150.649994,149.373901,80379300,12967319855.883017,6722235400,18.920212247784864,44.0,0.6141093935249557,52.93644949297118,70.3847621304016,145.31576826923077,148.1725601154841,-29.615237869598403
2022-11-02,148.949997,152.169998,145.0,145.029999,143.801514,93604600,12874498532.083485,6628630800,18.042667101218846,44.0,0.2689423892973082,46.576802355217,35.42204924102016,145.05692226923077,147.93977781063342,-64.57795075897984
2022-11-03,142.059998,142.800003,138.75,138.880005,137.703613,97918500,12782866395.12692,6530712300,18.315415146425984,44.0,-0.49515028226903723,40.80029932095103,0.69336000000006,144.63538415384616,147.26868352836428,-99.30663999999994
2022-11-04,142.089996,142.669998,134.380005,138.380005,137.435455,140814800,12777940539.78586,6389897500,19.179113683949698,44.0,-1.1280416883991506,40.36202275033513,17.30104180385853,144.4776921923077,146.6102628966336,-82.69895819614148
2022-11-07,137.110001,139.149994,135.669998,138.919998,137.971756,83374600,12850294538.324478,6473272100,19.981119468793146,44.0,-1.5679652380634934,41.09792195150739,19.636652170556193,144.50538453846156,146.0406136450311,-80.36334782944381
2022-11-08,140.410004,141.429993,137.490005,139.5,138.547806,89908500,12852120142.823019,6563180600,20.14765656142937,44.0,-1.8484981702727623,41.926812401130356,22.145311882636616,144.3919231153846,145.5561237453992,-77.85468811736338
2022-11-09,138.5,138.550003,134.589996,134.869995,133.949402,74917800,12787796722.621943,6488262800,20.73713254413172,44.0,-2.4165685511173365,37.402023988419266,2.119334368368063,143.95999961538462,144.7645586531474,-97.88066563163193
2022-11-10,141.240005,146.869995,139.5,146.869995,145.867493,118854000,12906650722.621943,6607116800,19.496828843546087,44.0,-1.8768337378062085,51.893039411789594,54.02245977994365,143.9780765769231,144.9205169010624,-45.97754022005634
2022-11-11,145.820007,150.009995,144.369995,149.699997,148.678177,93979700,12990299387.501162,6701096500,18.40529131669607,44.0,-1.2068210181145105,54.56435619857333,66.2629555066945,144.1423075,145.27455246394666,-33.737044493305504
2022-11-14,148.970001,150.279999,147.429993,148.279999,147.267868,73374100,12960692511.32076,6627722400,17.437914418190203,44.00000000000001,-0.7814055252721062,52.97481212859168,60.12109431684566,144.45730761538462,145.49717813328394,-39.87890568315434
2022-11-15,152.220001,153.589996,148.559998,150.039993,149.015854,89868300,12923708778.932318,6717590700,17.0957960899738,44.0,-0.29879950067740424,54.734903158549685,67.73352675898073,144.82730742307692,145.83368293822588,-32.26647324101927
2022-11-16,149.130005,149.869995,147.289993,148.789993,147.774399,64218300,12934162862.907215,6653372400,16.514912746301157,44.0,-0.01699934464818398,53.21157246593493,62.32695119527494,145.204615,146.05266886872766,-37.67304880472506
2022-11-17,146.429993,151.479996,146.149994,150.720001,149.691223,80389400,12991627115.016838,6733761800,16.25350005774058,44.0,0.3579387302424948,55.28102494948875,77.55103086892485,145.68076903846153,146.39839717474783,-22.44896913107515
2022-11-18,152.309998,152.699997,149.970001,151.289993,150.257324,74829600,12989159872.590403,6808591400,16.22058815461647,-20.0,0.6930840056668899,55.901374394670086,80.25626208116269,145.99999934615386,146.760737606248,-19.74373791883732
2022-11-21,150.160004,150.369995,147.720001,148.009995,146.999725,58724100,12943288357.656935,6749867300,15.671028265553506,-20.000000000000007,0.6861115575729855,51.47610478397783,70.95261002464807,146.37038357692307,146.85327519097038,-29.047389975351937
2022-11-22,148.130005,150.419998,146.929993,150.179993,149.154892,51804100,12987967400.23123,6801671400,14.981054428202714,-20.0,0.8459351317721087,54.06678908384529,82.24880480162632,146.66922930769232,147.09969873237998,-17.751195198373686
2022-11-23,149.449997,151.830002,149.339996,151.070007,150.038849,58301400,13010679510.492168,6859972800,14.626686286518138,-19.999999999999996,1.0325110131899748,55.12503154017868,86.88188349489592,146.95076803846155,147.39379564109257,-13.118116505104085
2022-11-25,148.309998,148.880005,147.119995,148.110001,147.099045,35195900,13015079012.990337,6824776900,13.767666726255088,-20.0,0.9307963560308679,50.9230582245813,71.15792105263156,147.1142295769231,147.4468478899005,-28.842078947368435
2022-11-28,145.139999,146.639999,143.380005,144.220001,143.235611,69246000,12981517963.95405,6755530900,13.397427245151139,-20.0,0.5301846291280583,45.964363390404245,50.68423684210517,147.14615273076924,147.20782219435233,-49.31576315789483
2022-11-29,144.289993,144.809998,140.350006,141.169998,140.206406,83763800,12928554957.269194,6671767100,13.62074348431808,-20.0,-0.033032030173302473,42.47221147866066,34.6315894736841,146.91153711538462,146.76057595773364,-65.3684105263159
2022-11-30,141.399994,148.720001,140.550003,148.029999,147.019592,111380900,13021122378.0586,6783148000,12.931727216246918,-20.0,0.07331433681477506,51.413430100914255,60.539399727295844,146.85692180769232,146.85460729419782,-39.460600272704156
2022-12-01,148.210007,149.130005,146.610001,148.309998,147.297653,71250400,13046003147.889124,6854398400,12.202688243023477,-20.000000000000004,0.1781347515568541,51.743112171732314,60.12083090697195,146.7019218846154,146.96241401314612,-39.87916909302805
2022-12-02,145.960007,148.0,145.649994,147.809998,146.801086,65447400,13100867479.680107,6788951000,11.730053404857113,-20.0,0.21834294257635634,51.076613343257,56.34439300936025,146.6426908076923,147.02519801217232,-43.65560699063975
2022-12-05,147.770004,150.919998,145.770004,146.630005,145.629135,68826400,13055027814.354517,6720124600,11.155864630012088,-20.0,0.15322635214911884,49.45751493905661,47.432052441127226,146.7130755,146.99592445571514,-52.567947558872774
2022-12-06,147.070007,147.300003,141.919998,142.910004,141.93454,64727200,13014122271.160858,6655397400,10.916888030981156,-12.0,-0.19628930533255584,44.65199555771038,20.728743850906298,146.2196139230769,146.6932636812177,-79.2712561490937
2022-12-07,142.190002,143.369995,140.0,140.940002,139.977982,69721100,12983296168.596878,6585676300,11.065204857578399,-12.0,-0.6250406004497506,42.30758037988006,7.4015922995886765,145.74269107692308,146.26709614927566,-92.59840770041133
2022-12-08,142.360001,143.520004,141.100006,142.649994,141.6763,62128300,13000753157.064388,6647804600,11.16492744333401,28.0,-0.8174242692686278,45.006660874395834,20.866099417188785,145.43499876923076,145.9991626567367,-79.13390058281121
2022-12-09,142.339996,145.570007,140.899994,142.160004,141.189651,76097000,12965719417.903276,6571707600,10.736977961354585,28.0,-0.9979243600040206,44.36614979597647,18.25869513800577,145.32461434615385,145.71478053401546,-81.74130486199424
2022-12-12,142.699997,144.5,141.059998,144.490005,143.503738,70462700,13035772656.1143,6642170300,10.339596299516547,28.000000000000004,-0.9421004269904074,48.14527890663046,37.954389187761706,145.5403835769231,145.6240564203847,-62.045610812238294
2022-12-13,149.5,149.970001,144.240005,145.470001,144.477066,93886200,12982193517.569561,6736056500,10.4863618715588,16.0,-0.8094512210453502,49.69314248409093,46.23837764355402,145.8130757307692,145.6126449077636,-53.76162235644598
2022-12-14,145.350006,146.660004,141.160004,143.210007,142.232498,82291200,12961246756.432688,6653765300,9.884268622881494,16.0,-0.8765836868030021,46.263487647544046,29.395673881991485,145.9780760769231,145.43467172941075,-70.60432611800852
2022-12-15,141.110001,141.800003,136.029999,136.5,135.568283,98931900,12878432034.837381,6554833400,10.063630799199556,16.0,-1.4544620039999927,37.89990354915927,3.156487787541132,145.86269146153847,144.77284419389886,-96.84351221245886
2022-12-16,136.690002,137.649994,133.729996,134.509995,133.591858,160156900,12782010994.826647,6394676500,10.630649459525642,-88.0,-2.0493874433537655,35.83105124945931,4.537515469748078,145.8488453076923,144.01263314249897,-95.46248453025191
2022-12-19,135.110001,135.199997,131.320007,132.369995,131.466446,79592600,12745496482.59945,6315083900,11.55165417430715,-92.0,-2.6628545261140744,33.7005921422207,5.35708409253854,145.291153,143.15021550231387,-94.64291590746146
2022-12-20,131.389999,133.25,129.889999,132.300003,131.396957,77432800,12779143029.142025,6237651100,12.632274856757801,-96.0,-3.118728616298199,33.63016145623932,11.459838871128879,144.62192246153847,142.34649605769803,-88.54016112887113
2022-12-21,132.979996,136.809998,132.75,135.449997,134.525467,85928000,12807503431.360943,6323579100,12.734399324703274,-96.0,-3.1890722867695445,39.734506964594836,26.438413049853242,144.12846084615384,141.83564427564633,-73.56158695014676
2022-12-22,134.350006,134.559998,130.300003,132.229996,131.327423,77852100,12800193201.966566,6245727000,13.251233928618564,-84.0,-3.4647083216200656,36.08124493526121,11.126947747358479,143.44346096153848,141.12411477374658,-88.87305225264151
2022-12-23,130.919998,132.419998,129.639999,131.860001,130.959961,63814900,12838298630.448555,6181912100,13.842934229707096,-96.0,-3.6706938951170116,35.67535726634432,10.919831685210958,142.79230742307692,140.43788412383944,-89.08016831478905
2022-12-27,131.380005,131.410004,128.720001,130.029999,129.142456,69007800,12836502710.869804,6112904300,14.55219977839148,-100.0,-3.93623039976427,33.658568657957616,6.16469647058827,141.99653811538462,139.6669296702217,-93.83530352941173
2022-12-28,129.669998,131.029999,125.870003,126.040001,125.17968,85438400,12756693911.018023,6027465900,15.683808620083113,-92.0,-4.417704933037584,29.714325169542064,0.7053859506544637,141.02538457692307,138.65752754650157,-99.29461404934553
2022-12-29,127.989998,130.479996,127.730003,129.610001,128.725327,75703700,12784497968.74148,6103169600,16.734588258796773,-92.0,-4.459798029670111,36.84537477424814,15.51866518827103,140.3176925,137.98734039490887,-84.48133481172897
2022-12-30,128.410004,129.949997,127.43,129.929993,129.043121,77034200,12860309157.653133,6180203800,17.762487624808898,-92.0,-4.416426615012739,37.45788702074157,16.846432933313935,139.53884634615383,137.39049984713785,-83.15356706668607
2023-01-03,130.279999,130.899994,124.169998,125.07,124.216293,112117500,12778178592.039127,6068086300,19.25505627842474,-76.0,-4.719808263187019,32.32940811019469,3.488379439335673,138.53884607692308,136.47787022883134,-96.51162056066433
2023-01-04,126.889999,128.660004,125.080002,126.360001,125.497498,89113600,12752788598.275326,6157199900,20.641012885353735,-76.0,-4.800807386250227,34.87806674296533,9.737671924142626,137.70230761538463,135.7283984341031,-90.26232807585738
2023-01-05,127.129997,127.769997,124.760002,125.019997,124.166649,80962700,12685812564.157827,6076237200,21.98185871649651,-76.0,-4.9164530879521635,33.46799215921715,4.821320243527991,136.96384592307692,134.93518351305843,-95.17867975647201
2023-01-06,126.010002,130.289993,124.889999,129.619995,128.735245,87754700,12751791138.669317,6163991900,22.286400271607636,-76.0,-4.584079331873028,42.11891736891734,40.43025680423042,136.51961503846152,134.54146584542448,-59.56974319576958
2023-01-09,130.470001,133.410004,129.889999,130.149994,129.261627,70790800,12691457854.522846,6234782700,21.56060073395305,-76.0,-4.229153200108755,43.03792646136508,47.310094936708744,135.83192253846153,134.21617163465228,-52.689905063291256
2023-01-10,130.259995,131.259995,128.119995,130.729996,129.837677,63896200,12733784040.443993,6298678900,21.288119220092945,-76.0,-3.856613727072812,44.084227404444974,51.89871835443033,135.1557686153846,133.9579364024558,-48.10128164556968
2023-01-11,131.25,133.509995,130.460007,133.490005,132.578827,69458900,12802332455.936512,6368137800,20.35795984053496,-76.0,-3.300616399456942,48.89484896340588,73.73423259493661,134.60499965384614,133.9232748170887,-26.265767405063375
2023-01-12,133.880005,134.259995,131.440002,133.410004,132.499374,71379600,12830682149.420006,6296758200,19.277013067081942,-52.0,-2.8337739416444094,48.76389012685817,88.93172281039442,134.09653807692305,133.8852547565636,-11.06827718960559
2023-01-13,132.029999,134.919998,131.660004,134.759995,133.840149,57809700,12882817160.798431,6354567900,18.078382148130274,-52.0,-2.3280288713737036,51.14197707347013,98.5116000000001,133.7830761923077,133.95005033015147,-1.4883999999998998
2023-01-17,134.830002,137.289993,134.130005,135.940002,135.0121,63646600,12892082328.22299,6418214500,17.275998845292722,-52.0,-1.8111280001203056,53.18726290215772,89.71043052988955,133.5907685,134.09745415754765,-10.289569470110443
2023-01-18,136.820007,138.610001,135.029999,135.210007,134.287094,69672800,12829416039.047508,6348541700,16.875811955317054,-52.0,-1.4437422690799622,51.74415306079101,76.45434007181287,133.30461515384616,134.17986547921078,-23.54565992818713
2023-01-19,134.080002,136.25,133.770004,135.270004,134.346695,58280400,12841636236.629118,6406822100,16.10070521362496,-52.00000000000001,-1.1346654567938685,51.85976276926707,76.86983167524266,133.03961515384614,134.2606164807507,-23.130168324757342
2023-01-20,135.279999,138.020004,134.220001,137.869995,136.928925,80223600,12915526019.51771,6487045700,15.85814008095006,-52.0,-0.6721739091988752,56.700928397142775,94.87530577382829,132.7849993846154,134.52797785254697,-5.124694226171713
2023-01-23,138.119995,143.320007,137.899994,141.110001,140.146805,81760300,12930610924.620392,6568806000,16.7957046136894,-48.0,-0.04370086297259945,61.849644622371834,88.45950411824874,132.61730707692308,135.01553512272866,-11.540495881751246
2023-01-24,140.309998,143.160004,140.300003,142.529999,141.557114,66435100,12967777192.07418,6635241100,17.66630025123307,52.0,0.5624667585775853,63.877003982022025,95.74349252599878,132.59115292307692,135.57216207660062,-4.25650747400122
2023-01-25,140.889999,142.429993,138.809998,141.860001,140.891678,65799300,13012855427.760225,6569441800,17.946632344174887,52.0,0.9775273992955249,62.19752072369157,92.13359048125261,132.7973068076923,136.03792792277835,-7.866409518747395
2023-01-26,143.169998,144.25,141.899994,143.960007,142.977371,54105100,13053607285.03293,6623546900,18.59961201590993,64.0,1.459099292743531,65.27897280373597,98.50210235009797,133.1607688076923,136.62474859516513,-1.4978976499020313
2023-01-27,143.160004,147.229996,143.080002,145.929993,144.933899,70555800,13079959285.380497,6694102700,19.778963312218114,68.0,1.9769211774364521,67.92069627819741,93.19726356895532,133.6823071923077,137.31402595848624,-6.802736431044682
2023-01-30,144.960007,145.550003,142.850006,143.0,142.023911,64015300,13023056519.881979,6630087400,20.786618656784764,68.0,2.126361432652459,60.54260505151433,77.86501424044928,134.09384553846152,137.7352092208206,-22.134985759550705
2023-01-31,142.699997,144.339996,142.279999,144.289993,143.305099,65874500,13085733032.095104,6695961900,21.496456807826622,68.0,2.322117639073525,62.47530534521321,82.46866470812839,134.43384538461538,138.22074876001906,-17.53133529187162
2023-02-01,143.970001,146.610001,141.320007,145.429993,144.437317,77663600,13128748702.69904,6773625500,22.610666711129717,68.0,2.539965178131922,64.14665738613743,88.60035665624697,134.94153757692308,138.7547668518695,-11.39964334375303
2023-02-02,148.899994,151.179993,148.169998,150.820007,149.790543,118339000,13218781753.184837,6891964500,24.392249998373508,84.0,3.111670604139107,70.77462760074363,98.15580838698223,135.67076857692308,139.64848834432362,-1.8441916130177736
2023-02-03,148.029999,157.380005,147.830002,154.5,153.445419,154357300,13280039648.758158,7046321800,26.778671417164805,88.0,3.8176880221887473,74.27169395422193,87.8017582464312,136.61192246153846,140.74860031881818,-12.198241753568794
2023-02-06,152.570007,153.100006,150.779999,151.729996,150.694336,69858300,13267392534.263287,6976463500,28.994634163185292,88.0,4.106360175678503,67.70450553809576,76.06942498647074,137.5999991923077,141.56203703594275,-23.93057501352926
2023-02-07,150.639999,155.229996,150.639999,154.649994,153.594391,83322600,13329657484.489136,7059786100,31.270047879773767,88.0,4.518666003333664,70.65057255489944,88.43705682181032,138.56307584615385,142.53151532957662,-11.56294317818969
2023-02-08,153.880005,154.580002,151.169998,151.919998,150.883026,64120100,13293742673.984398,6995666000,33.382932045177355,88.0,4.572425406729195,64.70739456282624,76.42484431349833,139.40884526923077,143.22695849034875,-23.575155686501674
2023-02-09,153.779999,154.330002,150.419998,150.869995,149.840195,56007100,13250627134.698248,6939658900,35.015676796272366,80.0,4.478676262304305,62.52870332564889,66.58107636592189,140.40115276923078,143.7931093429155,-33.41892363407811
2023-02-10,149.460007,151.339996,149.220001,151.009995,150.208237,57450700,13290192143.03322,6997109600,36.00670867394927,80.0,4.365355123369653,62.708991847065946,65.69732041565732,141.34922946153844,144.3276934656625,-34.30267958434268
2023-02-13,150.949997,154.259995,150.919998,153.850006,153.033157,62199000,13337121125.837996,7059308600,37.32766595416655,76.0,4.453376702570466,66.25585515493015,80.99085800021506,142.45807596153847,145.0330499496875,-19.009141999784937
2023-02-14,152.119995,153.770004,150.860001,153.199997,152.386597,61707600,13374654342.544783,6997601000,38.52753071889905,68.0,4.419736176843799,64.73815944659822,73.97254968524895,143.36499911538462,145.6380089904514,-26.027450314751054
2023-02-15,153.110001,155.5,152.880005,155.330002,154.50531,65573800,13431718649.318727,7063174800,39.87097369808185,68.0,4.512927204529831,67.37541027571014,87.23534710278294,144.33346096153844,146.3559343985661,-12.764652897217067
2023-02-16,153.509995,156.330002,153.350006,153.710007,152.893906,68167900,13380020913.820894,6995006900,41.224787914919446,64.0,4.405280377736517,63.48635101580426,77.14820387897919,145.21730753846154,146.9006805171908,-22.851796121020808
2023-02-17,152.350006,153.0,150.850006,152.550003,151.740051,59144100,13414407114.433548,6935862800,41.32846216278271,60.0,4.1782031387646725,60.780893526361915,69.92526400065552,145.95038438461538,147.31914884925075,-30.07473599934449
2023-02-21,150.199997,151.300003,148.410004,148.479996,147.691666,58867200,13358391287.781706,6876995600,40.44079065747964,56.00000000000001,3.6280058473905683,52.351274284567054,44.582751504701264,146.52999946153844,147.40513752708404,-55.417248495298736
2023-02-22,148.869995,149.949997,147.160004,148.910004,148.1194,51011300,13371372818.58809,6928006900,39.15089511504304,44.0,3.1898974299619454,53.0914904659148,17.123285995764537,147.07423057692307,147.5166091176704,-82.87671400423547
2023-02-23,150.089996,150.339996,147.240005,149.399994,148.606796,48394200,13390418130.29235,6976401100,38.04576786264962,44.0,2.849385508273315,53.96900240872677,21.91770822723012,147.59192257692308,147.65611910895407,-78.08229177276988
2023-02-24,147.110001,147.190002,145.720001,146.710007,145.931061,55469600,13409663087.381224,6920931500,36.44064258751974,44.0,2.3355451763716815,48.594523335868466,9.330875652132294,148.03423026923076,147.58603673051303,-90.66912434786771
2023-02-27,147.710007,149.169998,147.449997,147.919998,147.134644,44998500,13389256828.895618,6965930000,35.45788272862593,40.0,2.002871318883251,50.9602100418582,20.735125284154016,148.5207685,147.6107746023269,-79.26487471584599
2023-02-28,147.050003,149.080002,146.830002,147.410004,146.627365,50547000,13364769705.423618,6915383000,34.30339884140321,36.0,1.6787213813195763,49.91748890076466,15.928396236720321,148.88769192307691,147.59590270585824,-84.07160376327968
2023-03-01,146.830002,147.229996,145.009995,145.309998,144.538498,55479000,13324285172.936922,6859904000,32.54739443269926,28.0,1.2381051808771417,45.764981519415855,2.650201541394839,149.04923026923078,147.42657643135024,-97.34979845860515
2023-03-02,144.380005,146.710007,143.899994,145.910004,145.13533,52238100,13346779185.123592,6912142100,30.52432958631391,28.000000000000004,0.9266473237684067,47.11855166026323,16.17062515164907,149.17923046153845,147.3142377327317,-83.82937484835092
2023-03-03,148.039993,151.110001,147.330002,151.029999,150.228119,70732300,13414517449.694164,6982874400,29.85071993728293,8.0,1.0805002012613159,56.98423646059204,57.361226155284875,149.5319226923077,147.58947930808492,-42.638773844715125
2023-03-06,153.789993,156.300003,153.460007,153.830002,153.013275,87558000,13349773581.974634,7070432400,30.255699178048058,8.0,1.4120888750662175,61.24268338473582,79.88738221246521,149.91153788461537,148.05174024822676,-20.112617787534788
2023-03-07,153.699997,154.029999,151.130005,151.600006,150.79512,56182000,13311802375.639725,7014250400,29.845579359047544,8.0,1.4778969713513561,56.449602463951244,61.946959326172646,150.12961530769232,148.3145747483581,-38.053040673827354
2023-03-08,152.809998,153.470001,151.830002,152.869995,152.058365,47204800,13324466711.616514,7061455200,29.464753812832782,8.0,1.6139235542374024,58.44427659554843,72.1640806667219,150.5092305,148.65201328551674,-27.8359193332781
2023-03-09,153.559998,154.539993,150.229996,150.589996,149.790466,53833600,13279626201.866926,7007621600,28.57081598948948,8.0,1.5202245345129484,53.68991782005497,53.95158987384618,150.7515383076923,148.79556756066364,-46.04841012615382
2023-03-10,150.210007,150.940002,147.610001,148.5,147.711563,68572400,13247708065.59093,6939049200,26.932396646924037,-72.0,1.2627657978682691,49.69882722226367,37.09679565555157,150.8696155,148.77367366728114,-62.90320434444843
2023-03-13,147.809998,153.139999,147.699997,150.470001,149.671097,84457100,13249260678.391918,7023506300,25.953367812204657,-72.0,1.203813695962964,53.22813255557776,52.98388896330638,150.85615373076922,148.89932754377884,-47.01611103669362
2023-03-14,151.279999,153.399994,150.100006,152.589996,151.779846,73695900,13286778548.891085,7097202200,25.107098607731768,-36.0,1.3130238873937117,56.745333363741096,70.0806104253635,150.78269203846153,149.1727103923878,-29.919389574636494
2023-03-15,151.190002,153.25,149.919998,152.990005,152.177734,77167900,13351896445.221117,7174370100,24.26013812926436,-36.0,1.4155337423620438,57.39633048895418,73.30648711625932,150.83115392307693,149.45547295591464,-26.693512883740684
2023-03-16,152.160004,156.460007,151.639999,155.850006,155.022552,76161100,13408780254.743135,7250531200,24.253924807064017,40.0,1.7078645205581608,61.820734488244774,95.14330916695721,150.87730823076922,149.92914207029133,-4.856690833042791
2023-03-17,156.080002,156.740005,154.279999,155.0,154.177048,98944600,13367754384.164608,7151586600,24.3114711279701,43.99999999999999,1.8496290160616127,59.831977956370416,86.44857079951103,150.99576984615385,150.30476117619565,-13.551429200488972
2023-03-20,155.070007,157.820007,154.149994,157.399994,156.564301,73641400,13424540069.84523,7225228000,24.6128014692545,48.0,2.131072184720267,63.41104859388981,96.98266804779557,151.24692365384615,150.83033397795896,-3.0173319522044353
2023-03-21,157.320007,159.399994,156.539993,159.279999,158.434326,73938300,13492274017.952696,7299166300,25.239747266898778,52.0,2.4772622777181255,65.96903164186307,99.22583870967749,151.56500073076924,151.45623509070276,-0.774161290322508
2023-03-22,159.300003,162.139999,157.809998,157.830002,156.992035,75701800,13417271681.443443,7223464500,26.35805280301571,56.0,2.6045936465601187,62.34854614224648,70.89805622512964,151.7180775,151.92836597287294,-29.101943774870357
2023-03-23,158.830002,161.550003,157.679993,158.929993,158.086182,67622100,13393332995.698187,7291086600,27.33886391408456,56.0,2.7624212814470184,63.96426858026131,77.90773267828392,151.93846196153845,152.4470050119194,-22.092267321716065
2023-03-24,158.860001,160.339996,157.850006,160.25,159.39917,59196500,13448250403.642395,7350283100,28.24961708864849,56.0,2.959894530643936,65.85769994215663,86.99243454816724,152.12769265384617,153.0250046406661,-13.007565451832765
2023-03-27,159.940002,160.770004,157.869995,158.279999,157.439636,52390300,13410674011.158682,7297892800,29.187275703915418,56.0,2.9237279705487254,60.72921823124306,73.43427025936279,152.3034615769231,153.41426348209825,-26.565729740637206
2023-03-28,157.970001,158.490005,155.979996,157.649994,156.812973,45992200,13425882294.515993,7251900600,29.12562782996202,56.0,2.8118167001544805,59.14305371702705,69.09837840308028,152.49961507692308,153.7280212982391,-30.90162159691972
2023-03-29,159.369995,161.050003,159.350006,160.770004,159.916443,51305700,13460287323.874456,7303206300,29.676036997502955,56.0,2.94098312135381,64.13851383227446,90.57126504766214,152.9723076923077,154.2496496465177,-9.428734952337852
2023-03-30,161.529999,162.470001,161.270004,162.360001,161.497986,49501700,13500713689.519455,7352708000,30.485854540154545,80.0,3.1355037747566428,66.39356810685223,99.25524732423915,153.48961526923077,154.85041641344233,-0.7447526757608544
2023-03-31,162.440002,165.0,161.910004,164.899994,164.02449,68749800,13565013391.526577,7421457800,31.712727134396637,84.0,3.454794283550825,69.67422983864564,99.33683032668029,154.0857691153846,155.59482956800215,-0.663169673319722
2023-04-03,164.270004,166.289993,164.220001,166.169998,165.28775,56976200,13615383905.012812,7478434000,33.06985576112479,88.0,3.7668906504573556,71.18869481241758,99.26698206077633,154.8342303076923,156.37817537777977,-0.7330179392236653
2023-04-04,166.600006,166.839996,165.110001,165.630005,164.750626,46278300,13596926380.348232,7432155700,34.4218058443546,92.0,3.925406702586912,69.5971940554267,92.0395313235917,155.51538442307694,157.06349609053683,-7.9604686764082935
2023-04-05,164.740005,165.050003,161.800003,163.759995,162.890533,51511700,13607545461.829094,7380644000,34.108234462798116,92.0,3.8556916243113335,64.2410877603042,75.72891635478068,156.14423023076924,157.55953304679335,-24.27108364521932
2023-04-06,162.429993,164.960007,162.0,164.660004,163.785767,45390100,13643734795.634758,7426034100,33.817061037067084,92.0,3.8289276327927553,65.61273580516303,82.82118474055383,156.88846123076922,158.08549385814197,-17.178815259446164
2023-04-10,161.419998,162.029999,160.080002,162.029999,161.169724,47716900,13691451695.634758,7378317200,32.723734932158486,88.0,3.5545232219700154,58.54554745580511,55.7090515653775,157.50846103846155,158.37767942420552,-44.2909484346225
2023-04-11,162.350006,162.360001,160.509995,160.800003,159.946259,47644200,13658744959.787415,7330673000,31.802424313917943,68.0,3.200907285035129,55.53295021571124,44.383121546961306,157.8842304230769,158.55711080019032,-55.616878453038694
2023-04-12,161.220001,162.059998,159.779999,160.100006,159.249985,50133100,13622684622.91731,7280539900,30.63009895071435,68.0,2.831539969373523,53.835135945316345,37.93747697974219,158.12538442307692,158.67139933350956,-62.06252302025781
2023-04-13,161.630005,165.800003,161.419998,165.559998,164.680984,68445600,13683629187.540411,7348985500,30.566489268133516,68.0,2.945436277964859,63.26836196723008,88.21364640883974,158.6623071923077,159.18166590139774,-11.786353591160264
2023-04-14,164.589996,166.320007,163.820007,165.210007,164.332855,49386500,13689160475.540411,7299599000,30.63171173359183,68.0,2.9731855422120645,62.388323714906605,84.99089318600349,159.13692303846153,159.62820968647938,-15.009106813996512
2023-04-17,165.089996,165.389999,164.029999,165.229996,164.352722,41516200,13720907974.733646,7341115200,30.692275451517407,68.0,2.9626385265400472,62.42047402245132,85.17495395948424,159.69999996153845,160.04315682081423,-14.82504604051576
2023-04-18,166.100006,167.410004,165.649994,166.470001,165.586166,49923000,13717504266.62517,7391038200,31.239779520589106,100.0,3.0195307105401525,64.4505503877326,88.33742886784844,160.39115384615386,160.51921935260577,-11.662571132151553
2023-04-19,165.800003,168.160004,165.539993,167.630005,166.740005,47720200,13745917938.309221,7438758400,31.918071911581567,96.0,3.1222296842092874,66.28539738830492,93.67543336788013,161.05115400000003,161.04594421537573,-6.324566632119866
2023-04-20,166.089996,167.869995,165.559998,166.649994,165.765182,52456400,13742965729.1583,7386302000,32.54791484607456,96.0,3.0889333623351547,63.31228641627926,81.98079834081248,161.59192315384615,161.46105901423678,-18.01920165918752
2023-04-21,165.050003,166.449997,164.490005,165.020004,164.143875,58337300,13716178262.690989,7327964700,32.529491508444195,92.0,2.897617288361573,58.604036989932496,62.5298552924492,162.0546154230769,161.72468456873776,-37.4701447075508
2023-04-24,165.0,165.600006,163.889999,165.330002,164.452209,41949600,13744880478.559345,7369914300,32.18190968508802,84.0,2.739433682959344,59.22508216827684,66.2291132284529,162.41923065384617,161.99174511920162,-33.77088677154709
2023-04-25,165.190002,166.309998,163.729996,163.770004,162.900497,48714100,13697677194.219799,7321200200,32.079607727787256,84.0,2.45983775641389,54.77187740826923,47.613396412054705,162.7565385,162.12346799926078,-52.386603587945295
2023-04-26,163.059998,165.279999,162.800003,163.759995,162.890533,45498800,13687403034.912445,7275701400,31.454429482746377,60.0,2.2119503409561503,54.74343604713986,47.49395734250765,163.0011539230769,162.24469222153778,-52.50604265749235
2023-04-27,165.190002,168.559998,165.190002,168.410004,167.515854,64902300,13746527906.342085,7340603700,31.84532837019838,84.0,2.3634700315126054,64.0764136542744,98.2916398965419,163.3523079615385,162.70138198290533,-1.708360103458107
2023-04-28,168.490005,169.850006,167.880005,169.679993,168.779099,55209200,13792207891.159351,7395812900,32.52311902671018,88.0,2.5565575721877565,66.13076572232218,98.31168935632307,163.80807684615382,163.21831613231973,-1.6883106436769255
2023-05-01,169.279999,170.449997,168.639999,169.589996,168.689575,52472900,13794816927.803812,7343340000,33.29420244744556,92.0,2.671523177307165,65.84340973111733,91.94000786129497,164.2180769615385,163.69029241881458,-8.059992138705024
2023-05-02,170.089996,170.350006,167.539993,168.539993,167.645157,48425700,13780857758.74157,7294914300,33.36948229617414,92.0,2.6473903132006456,62.43470071180256,78.84823686027002,164.53692284615383,164.0495294989024,-21.15176313972998
2023-05-03,169.5,170.919998,167.160004,167.449997,166.560944,65136000,13725769106.714998,7229778300,33.59764343678902,100.0,2.511361860545094,59.01893531102375,57.26597122288867,164.8896150769231,164.30141598046515,-42.73402877711133
2023-05-04,164.889999,167.039993,164.309998,165.789993,164.90976,81235400,13732612978.525387,7148542900,32.30947318018191,96.0,2.243745382133511,54.15929714454164,36.822559619802846,165.20269196153848,164.41168094487514,-63.177440380197154
2023-05-05,170.979996,174.300003,170.759995,173.570007,172.648468,113316400,13799194727.793299,7261859300,32.90275054603114,68.0,2.6291325015303357,67.61732038647858,93.65220869565216,165.69499976923078,165.090075467477,-6.347791304347825
2023-05-08,172.479996,173.850006,172.110001,173.5,172.578812,55962800,13832643436.423676,7205896500,33.45365095717686,68.0,2.8955277489035893,67.425497713135,93.04345217391301,166.12346126923077,165.71303284025646,-6.9565478260869895
2023-05-09,173.050003,173.539993,171.600006,171.770004,170.858017,45326900,13795260385.888851,7160569600,33.728149927473304,68.0,2.933239127912202,62.69240279970458,78.00000869565214,166.3876924230769,166.16169737060784,-21.99999130434786
2023-05-10,173.020004,174.029999,171.899994,173.559998,172.638504,53724500,13825275487.343307,7214294100,34.0898101588907,68.0,3.0721493977575562,65.39886841708741,93.56517391304351,166.67192319230767,166.7097196394517,-6.434826086956491
2023-05-11,173.850006,174.589996,172.169998,173.75,172.827515,49514700,13840416481.29793,7263808800,34.5502537361967,84.0,3.1611288354112332,65.68344567487212,92.87534776314105,166.98423069230768,167.2312218883812,-7.124652236858943
2023-05-12,173.619995,174.059998,171.0,172.570007,171.891205,45497800,13841606204.93984,7218311000,34.37283218637877,84.0,3.1006873140810853,62.258793040833105,82.86691942904454,167.32307730769233,167.62668745220483,-17.133080570955453
2023-05-15,173.160004,173.210007,171.470001,172.070007,171.393173,37266700,13830040845.740046,7181044300,34.20808360440498,84.0,2.978111337949713,60.8119390447661,78.6260348076542,167.60807742307694,167.955822233523,-21.37396519234581
2023-05-16,171.990005,173.139999,171.800003,172.070007,171.393173,42110300,13804900670.18997,7223154600,34.05510277828647,84.0,2.848137438268992,60.8119390447661,75.48648355768155,167.99423157692308,168.26057666066947,-24.51351644231845
2023-05-17,171.710007,172.929993,170.419998,172.690002,172.010727,57951600,13851770286.014225,7281106200,33.14382790525395,84.0,2.7633069192796142,62.0792649365352,81.51756449758045,168.45153923076924,168.58868224136063,-18.48243550241955
2023-05-18,173.0,175.240005,172.580002,175.050003,174.361435,65496700,13907910226.647112,7346602900,33.018096583480556,100.0,2.8536157728431704,66.51795834639876,98.26164795685865,169.02653911538462,169.06729859385243,-1.7383520431413526
2023-05-19,176.389999,176.389999,174.940002,175.160004,174.471024,55772400,13869062054.13834,7402375300,33.216447431127314,68.0,2.9006257433235305,66.71353419225102,89.81792302831761,169.39577011538464,169.5186101054189,-10.182076971682406
2023-05-22,173.979996,174.710007,173.449997,174.199997,173.514771,43570900,13877360861.521614,7358804400,32.60213367943157,68.0,2.8278195977645737,63.2416219862362,81.87084587161876,169.74153896153848,169.8653795050175,-18.12915412838125
2023-05-23,173.130005,173.380005,171.279999,171.559998,170.885162,50747300,13840146087.859825,7308057100,31.013854189784468,68.0,2.5279536706427166,54.79623504732838,60.01655132313326,169.98500057692308,169.99090680094213,-39.98344867686674
2023-05-24,171.089996,172.419998,170.520004,171.839996,171.164063,45143500,13857728111.047794,7353200600,29.21308004839929,68.0,2.2865434124060187,55.47536482326327,23.785557154848412,170.19153884615386,170.1278763712427,-76.21444284515158
2023-05-25,172.410004,173.899994,171.690002,172.990005,172.309555,56058300,13867621143.156599,7409258900,28.077795827683733,68.0,2.163085456096269,58.24975888008676,43.048686256501554,170.3976926923077,170.3398858992988,-56.951313743498446
2023-05-26,173.320007,175.770004,173.110001,175.429993,174.739929,54835000,13908437735.519464,7464093900,27.62999570727054,68.0,2.2363515079208867,63.45317506401351,83.91950018098835,170.73538496153847,170.7169308697211,-16.080499819011646
2023-05-30,176.960007,178.990005,176.570007,177.300003,176.602585,55964400,13886236824.697886,7520058300,28.07262059708288,92.0,2.4174427849011693,66.86194372441756,80.28003944454197,171.20769261538464,171.20456584233435,-19.719960555458027
2023-05-31,177.330002,179.350006,176.759995,177.25,176.55278,99625300,13824307808.710964,7420433000,28.569511371525472,96.0,2.527785366183167,66.68284240107914,76.48371647595384,171.66615407692308,171.6523757799392,-23.51628352404616
2023-06-01,177.699997,180.119995,176.929993,180.089996,179.381607,68901800,13891913694.101381,7489334800,29.21733227465864,100.0,2.811981823128491,71.3731350089912,99.6907318631132,172.29384607692307,172.2773846851289,-0.3092681368867975
2023-06-02,181.029999,181.779999,179.259995,180.949997,180.23822,61945900,13913053928.005772,7551280700,30.198873681252532,80.0,3.0712015563690898,72.62967927302176,92.69364500936217,172.95500000000004,172.91980041215638,-7.306354990637823
2023-06-05,182.630005,184.949997,178.039993,179.580002,178.873611,121946500,13845463028.239433,7429334200,31.71841948960259,84.0,3.130007141598952,67.54349336623815,63.04201397398591,173.38461530769231,173.41314867792258,-36.95798602601409
2023-06-06,179.970001,180.119995,177.429993,179.210007,178.505081,64848400,13866436913.782417,7364485800,32.80481943774503,84.0,3.1108950258491745,66.19525549218145,60.495592601210745,173.7511543076923,173.84254559066903,-39.504407398789255
2023-06-07,178.440002,181.210007,177.320007,177.820007,177.120544,61944600,13820416375.479076,7302541200,34.020537493708964,84.0,2.9495861599386615,61.24890421088622,50.58909591986639,174.06769319230767,174.1371723617306,-49.41090408013361
2023-06-08,177.899994,180.839996,177.460007,180.570007,179.859741,50214900,13862609077.397306,7352756100,35.14941854567547,84.0,3.0089642717188667,66.57101446738758,69.64662422220168,174.53038603846156,174.61367863123203,-30.353375777798323
2023-06-09,181.5,182.229996,180.630005,180.960007,180.248184,48870700,13833897776.720676,7401626800,36.46537173568594,84.0,3.052306504347598,67.25780494897705,72.34932823598731,175.0500018076923,175.08377702891855,-27.650671764012685
2023-06-12,181.270004,183.889999,180.970001,183.789993,183.067047,54274900,13884454992.222673,7455901700,37.977987858411566,48.0,3.277233843252162,71.78730265098912,91.96116034151932,175.74230950000003,175.72868191566533,-8.038839658480684
2023-06-13,182.800003,184.149994,182.440002,183.309998,182.588943,54929100,13885418665.152138,7400972600,39.42663723860567,48.0,3.3778213726702404,70.01805191291375,88.63479005152678,176.11692453846155,176.29026088487532,-11.36520994847322
2023-06-14,183.369995,184.389999,182.020004,183.949997,183.22644,57462900,13921544987.711426,7458435500,40.492399598712446,48.0,3.4691896265144067,71.04281929079968,92.45851902659089,176.5188475,176.85764874525492,-7.541480973409113
2023-06-15,183.960007,186.520004,183.779999,186.009995,185.27832,65433200,13962619457.782976,7523868700,41.86988843350541,80.0,3.665569841047386,74.1101914381197,96.19680174568195,177.06653946153847,177.5356003196805,-3.803198254318042
2023-06-16,186.729996,186.990005,184.270004,184.919998,184.192612,101235600,13909768055.131727,7422633100,43.22795667149787,84.0,3.6907047801709894,69.89150017938805,80.1342860142583,177.50346253846158,178.0825927404449,-19.8657139857417
2023-06-20,184.410004,186.100006,184.410004,185.009995,184.282242,49799100,13895328690.57358,7472432200,44.48902003534801,84.0,3.675517330422565,70.04312966478003,80.64508245837497,177.93653926923076,178.5957336485601,-19.354917541625024
2023-06-21,184.899994,185.410004,182.589996,183.960007,183.236404,49515700,13893924239.671242,7422916500,44.397306496918475,84.0,3.5379723674524257,65.87486516420041,69.88077151399018,178.3746161923077,178.99308723014826,-30.119228486009817
2023-06-22,183.740005,187.050003,183.669998,187.0,186.264435,51245300,13943653317.810091,7474161800,44.703033165416585,96.0,3.6323970105106014,71.21579525281685,99.4860943416626,178.9488466923077,179.58619187976691,-0.5139056583374114
2023-06-23,185.550003,187.559998,185.009995,186.679993,185.945679,53079300,13960097328.050432,7421082500,45.10151734392965,100.0,3.6394539700517896,69.97427866766944,91.40619361872476,179.51076923076923,180.1116586294138,-8.593806381275247
2023-06-26,186.830002,188.050003,185.229996,185.270004,184.541245,48088700,13913373115.94681,7372993800,45.582805769358266,84.0,3.4910299130535236,64.62815632002973,74.09133237328324,179.99461546153847,180.49375828649426,-25.908667626716763
2023-06-27,185.889999,188.389999,185.669998,188.059998,187.320251,50730800,13951794203.758615,7423724600,46.10841207966786,88.0,3.5575230659688373,69.58063716522717,97.0189590019579,180.49499988461537,181.0542204874947,-2.9810409980421126
2023-06-28,187.929993,189.899994,187.600006,189.25,188.5056,51216800,13974062493.854042,7474941400,46.927982068600876,92.0,3.6640062021164965,71.41876297971866,94.7749623854109,181.0369228076923,181.66131526619878,-5.225037614589085
2023-06-29,189.080002,190.070007,188.940002,189.589996,188.844238,46347300,13981034368.399643,7521288700,47.72481501342585,96.0,3.7328002922365613,71.94045777320467,94.91513878916561,181.62884584615387,182.24862495018405,-5.084861210834392
2023-06-30,191.630005,194.479996,191.259995,193.970001,193.207031,85069600,14039156727.916178,7606358300,49.20778412737853,100.0,4.093561869484631,77.61028190940779,96.2250541173405,182.49076903846156,183.1168750279482,-3.7749458826594933
2023-07-03,193.779999,193.880005,191.759995,192.460007,191.702972,31458200,14028473069.072493,7574900100,50.58482687604887,96.0,4.209104189328713,72.19429988007606,83.78819986401268,183.28384638461537,183.80895887772982,-16.211800135987325
2023-07-05,191.570007,192.979996,190.619995,191.330002,190.577393,46920300,14009784741.38276,7527979800,51.03007826761329,92.0,4.161518950581723,68.35025943933162,74.71913304599238,183.9892308846154,184.3660731830832,-25.280866954007614
2023-07-06,189.839996,192.020004,189.199997,191.809998,191.055511,45094300,14048162693.82348,7573074100,50.4914091902157,88.0,4.115102630189284,69.10282738189238,77.54417157275024,184.61923107692309,184.91747502137332,-22.455828427249752
2023-07-07,191.410004,192.669998,190.240005,190.679993,189.929947,46778000,14018324461.686186,7526296100,50.153550023305186,84.0,3.9416979617315064,65.17387697523307,68.04034482758614,185.13384607692308,185.3443282049753,-31.95965517241386
2023-07-10,189.259995,189.990005,187.039993,188.610001,187.868103,59922200,14022183923.169327,7466373900,48.01002668149223,80.0,3.5957924014101366,58.60095592912818,50.630824222035365,185.5707691923077,185.58622989349564,-49.369175777964635
2023-07-11,189.160004,189.300003,186.600006,188.080002,187.340195,46638100,14026674918.088766,7419735800,45.80195193790284,64.0,3.241526957837408,57.01544782778646,46.17330529857023,185.8780771153846,185.7709537532367,-53.82669470142977
2023-07-12,189.679993,191.699997,188.470001,189.770004,189.023544,60750200,14014825981.279556,7480486000,44.51946201178968,64.0,3.061843058082843,60.66961809987134,56.429298136780446,186.21730815384615,186.06717969744142,-43.570701863219554
2023-07-13,190.5,191.190002,189.779999,190.539993,189.790497,41342300,14018050820.422098,7521828300,43.3285785089703,64.0,2.947595899493564,62.24446725614224,58.39490407656777,186.63884626923075,186.39849920133466,-41.60509592343223
2023-07-14,190.229996,191.179993,189.630005,190.690002,189.939926,41573900,14033339566.16942,7563402200,42.137727410162306,64.0,2.836461710861016,62.559007076645166,59.027091891891814,187.08038453846154,186.7163882975321,-40.972908108108186
2023-07-17,191.899994,194.320007,191.809998,193.990005,193.226944,50520200,14070575537.275898,7613922400,41.94086836782065,60.0,2.9803145179339765,68.730588246856,94.43823937303955,187.70230753846153,187.25517471993712,-5.5617606269604485
2023-07-18,193.350006,194.330002,192.419998,193.729996,192.967957,48353800,14088549746.31923,7565568600,41.76064434937035,56.00000000000001,3.0383145517611183,67.78255029708258,90.48222142413886,188.20846096153844,187.73479111105289,-9.517778575861147
2023-07-19,193.100006,198.229996,192.649994,195.100006,194.332581,80507300,14078739141.79984,7646075900,42.458119961532766,100.0,3.1584200534574904,70.12116842211813,73.0869072114422,188.7523070769231,188.28036258430822,-26.913092788557808
2023-07-20,195.089996,196.470001,192.5,193.130005,192.370331,59581200,14038067989.382196,7586494700,43.01692063275455,92.0,3.0593753376531083,63.03550115110239,56.14793305927183,189.1115383076923,188.63959535584095,-43.85206694072817
2023-07-21,194.100006,194.970001,191.229996,191.940002,191.184998,71917800,13993456072.399359,7514576900,42.788210023330016,92.0,2.8519825108815553,59.14743353752639,45.915740254290746,189.44346153846152,188.88406992207496,-54.084259745709254
2023-07-24,193.410004,194.910004,192.25,192.75,191.991821,45377800,13965137570.05455,7559954700,42.57583588600723,76.0,2.7216092533154495,60.91462441908967,52.88047539163831,189.7819231923077,189.17043511303237,-47.11952460836169
2023-07-25,193.330002,194.440002,192.919998,193.619995,192.858383,37283200,13962193921.990465,7597237900,42.378631329921795,76.0,2.6578507836745757,62.77710501717213,60.36109231392276,190.0746155,189.50003214169664,-39.63890768607724
2023-07-26,193.669998,195.639999,193.320007,194.5,193.73494,47471900,13963012283.074728,7644709800,42.522007796132755,76.0,2.647808497959659,64.61391025352702,67.92777981752347,190.4430771153846,189.8704001312006,-32.07222018247653
2023-07-27,196.020004,197.199997,192.550003,193.220001,192.459976,47460200,13929228762.691776,7597249600,43.03692723510586,76.0,2.507657972137906,59.97781078224868,56.921760035907106,190.7588465769231,190.1185187140746,-43.078239964092894
2023-07-28,194.669998,196.630005,194.139999,195.830002,195.059708,48291400,13946489502.625736,7645541000,43.515066714152304,72.0,2.5774813382645902,65.4253486465634,79.3637483781156,191.21538484615382,190.54159155006909,-20.636251621884405
2023-07-31,196.059998,196.490005,195.259995,196.449997,195.677261,38824100,13982787973.414917,7684365100,43.95905337326686,68.0,2.6522715386400364,66.58873646832055,81.76229598478275,191.57884626923075,190.9792512130269,-18.23770401521725
2023-08-01,196.240005,196.729996,195.279999,195.610001,194.840561,35175100,13963623738.748018,7649190000,44.436431418374596,64.0,2.613634304875603,63.47252997960608,69.53490997839425,191.9223081153846,191.32226971576566,-30.465090021605747
2023-08-02,195.039993,195.179993,191.850006,192.580002,191.822479,50389300,13935327009.945925,7598800700,42.53199841694204,60.0,2.3118686396199735,53.70870311654628,34.30232659545807,192.2034618846154,191.4154350701534,-65.69767340454193
2023-08-03,191.570007,192.369995,190.690002,191.169998,190.41803,61235200,13909083207.004364,7537565500,40.14431078684839,24.000000000000007,1.9366175156775967,49.864648371134756,6.365999760742508,192.32307726923077,191.39725454643832,-93.63400023925749
2023-08-04,185.520004,187.380005,181.919998,181.990005,181.274155,115799700,13796253023.196524,7421765800,39.54706005262181,-48.0,0.8882404981651746,33.202720334395764,0.4292275204448455,192.0438466923077,190.70042124670215,-99.57077247955516
2023-08-07,182.130005,183.130005,177.350006,178.850006,178.146484,97576100,13749321966.560719,7324189700,39.83914566130077,-52.0,-0.1937441565601432,29.563859353387713,7.183911486547649,191.63077015384613,189.8226127099094,-92.81608851345236
2023-08-08,179.690002,180.270004,177.580002,179.800003,179.092758,67823000,13793444703.272438,7392012700,40.110368012216945,-52.0,-0.9634617845464959,31.992298910521328,12.342559752294083,191.08577023076924,189.08019717584204,-87.65744024770592
2023-08-09,180.869995,180.929993,177.009995,178.190002,177.48909,60378500,13769416758.88471,7331634200,40.07206979645918,-60.0,-1.6839704129170627,30.09837145639665,5.844511555768987,190.5369238846154,188.2735160517056,-94.15548844423101
2023-08-10,179.479996,180.75,177.600006,177.970001,177.269958,54686900,13727576791.015692,7276947300,40.03650716754125,-60.0,-2.246830866336552,29.838429107818783,4.754858369999137,190.02307769230768,187.51029271454223,-95.24514163000087
2023-08-11,177.320007,178.619995,176.550003,177.789993,177.329803,51988100,13737873689.33356,7224959200,40.21753231476462,-68.0,-2.6765731034448663,29.61307298975528,6.004795933596912,189.48384673076922,186.79027051346503,-93.99520406640308
2023-08-14,177.970001,179.690002,177.309998,179.460007,178.995483,43675600,13773107984.510544,7268634800,39.85999266306811,-68.0,-2.8495429917383035,34.55168445032575,14.09203315022749,189.05230880769233,186.24728803098614,-85.90796684977252
2023-08-15,178.880005,179.479996,177.050003,177.449997,176.990677,43622600,13743846560.254177,7225012200,39.58966302358086,-68.0,-3.1129299641421255,31.67135424747198,4.35832572154739,188.62307788461538,185.5956368435057,-95.64167427845261
2023-08-16,177.130005,178.539993,176.5,176.570007,176.112961,46964900,13700105074.9956,7178047300,39.47318327276496,-80.0,-3.3540109258358086,30.473617782147286,0.34605543174602665,188.18038576923075,184.92707166991266,-99.65394456825398
2023-08-17,177.139999,177.509995,173.479996,174.0,173.549622,66062900,13651090800.690842,7111984400,40.02258415556131,-84.0,-3.709684477865494,27.234309647487635,2.2365763440860222,187.57384715384615,184.11765895362282,-97.76342365591398
2023-08-18,172.300003,175.100006,171.960007,174.490005,174.038345,61114200,13688459946.559168,7173098600,40.813674754281905,-88.0,-3.906981768169487,28.788587765733425,10.213964971885959,186.95653992307692,183.4044994015026,-89.78603502811404
2023-08-21,175.070007,176.130005,173.740005,175.839996,175.384842,46311900,13723532626.63691,7219410500,40.99216996092381,-88.0,-3.9093438187704237,33.03263615760039,16.709695690600427,186.38538584615387,182.84416581620613,-83.29030430939957
2023-08-22,177.059998,177.679993,176.25,177.229996,176.77124,42084200,13739130314.119156,7261494700,40.369023854925054,-88.0,-3.755760310622776,37.183810085030174,25.82063742516659,185.7407701153846,182.42830138537605,-74.1793625748334
2023-08-23,178.520004,181.550003,178.330002,181.119995,180.651184,52722800,13777771611.79515,7314217500,38.16868803903706,-88.0,-3.282317353405972,47.071919118888204,59.40330212753585,185.25577007692306,182.33138980127413,-40.59669787246415
2023-08-24,180.669998,181.100006,176.009995,176.380005,175.923447,54945800,13730814201.391165,7259271700,36.769947421607476,-64.0,-3.2520997960035345,39.01320261514231,39.57026670908994,184.53577003846152,181.89054648266122,-60.42973329091006
2023-08-25,177.380005,179.149994,175.820007,178.610001,178.147675,51449600,13765577595.79769,7310721300,35.521833383395254,-64.0,-3.0134726864033325,43.88092518140148,69.34303205131692,183.97730834615382,181.6475431135752,-30.65696794868307
2023-08-28,180.089996,180.589996,178.550003,180.190002,179.723587,43820700,13792213906.365175,7354542000,33.79658466150949,-64.0,-2.6661325898629684,47.10246417629697,85.81854465841269,183.52538526923078,181.53957710516224,-14.181455341587307
2023-08-29,179.699997,184.899994,179.5,184.119995,183.643417,53003900,13829905571.204876,7407545900,31.97389974593785,-64.0,-2.0501130431163688,54.1524482759236,93.97218096123278,183.193462,181.7307191714465,-6.027819038767222
2023-08-30,184.940002,187.850006,184.740005,187.649994,187.164276,60813900,13882897280.943972,7468359800,31.035318979923563,-64.0,-1.2625181726668586,59.38812929898831,98.74127116055818,182.9638465769231,182.1691839735616,-1.2587288394418084
2023-08-31,187.839996,189.119995,187.479996,187.869995,187.383713,60794500,13851017181.752142,7529154300,30.457419739007474,-64.0,-0.6135190556746295,59.697037019168135,92.71561262164053,182.7088463846154,182.5914662718163,-7.284387378359472
2023-09-01,189.490005,189.919998,188.279999,189.460007,188.969604,45732600,13871095394.881662,7574886900,30.103628890825238,-52.0,0.028786270238697398,61.949690504884224,97.43880161187163,182.56423123076922,183.10024706649656,-2.5611983881283806
2023-09-05,188.279999,189.979996,187.610001,189.699997,189.208969,45280000,13905676338.790827,7620166900,29.514343474467285,-52.00000000000001,0.5508333914501407,62.292273022710546,98.44617552208271,182.3284618076923,183.58911743194125,-1.5538244779172923
2023-09-06,188.399994,188.850006,181.470001,182.910004,182.436554,81755800,13855825286.082298,7538411100,27.786555409135712,-52.0,0.4119155018984202,48.88250364630761,60.76583620556034,181.80769284615386,183.53881273327892,-39.23416379443966
2023-09-07,175.179993,178.210007,173.539993,177.559998,177.100403,112488800,13936999947.666782,7425922300,27.78336863043197,-48.0,-0.12839859962389255,41.33248134094054,31.076550601668036,181.11346196153846,183.09593756785085,-68.92344939833195
2023-09-08,178.350006,180.240005,177.789993,178.179993,177.718781,65551300,13892317938.919233,7491473600,27.22131259540702,-44.0,-0.5008000911342378,42.44196109895123,28.223839131902768,180.55961546153847,182.73179352578782,-71.77616086809724
2023-09-11,180.070007,180.300003,177.339996,179.360001,178.895737,58953100,13913827862.665798,7550426700,26.781873974258392,44.0,-0.6927288256094641,44.58975774484962,35.401502055687004,180.10538480769233,182.48203111647018,-64.59849794431301
2023-09-12,179.490005,180.130005,174.820007,176.300003,175.843658,90370200,13873833400.855982,7460056500,26.824804643248548,44.0,-1.079308400191394,40.381603885973654,16.788378931560995,179.88653857692304,182.02410310784276,-83.211621068439
2023-09-13,176.509995,177.300003,173.979996,174.210007,173.759064,84267900,13801241707.530787,7375788600,27.009454707384236,44.0,-1.5366076520696481,37.760392798441366,4.075510205198752,179.70807707692308,181.4452811739285,-95.92448979480125
2023-09-14,174.0,176.100006,173.580002,175.740005,175.285126,60895800,13844738686.817963,7436684400,27.252071514182045,44.0,-1.75532822089653,40.790380021805206,13.38206568453782,179.5519233076923,181.02266812400788,-86.6179343154622
2023-09-15,176.479996,176.5,173.820007,175.009995,174.556976,109205100,13832513510.675077,7327479300,27.337914542006708,44.0,-1.9649211654657677,39.79491911355471,8.941616373184328,179.42961534615387,180.57728492963693,-91.05838362681568
2023-09-18,176.479996,179.380005,176.169998,177.970001,177.509338,67257600,13840684956.015352,7394736900,26.463339788456132,44.0,-1.8706140631714163,45.592824264019484,26.94651576401774,179.42961534615384,180.38415278670087,-73.05348423598227
2023-09-19,177.520004,179.630005,177.130005,179.070007,178.606491,51826900,13869293487.738392,7446563800,25.57207336593901,44.0,-1.6876594267508267,47.61192303761827,33.637548606286735,179.47884665384618,180.28680865435265,-66.36245139371326
2023-09-20,179.259995,179.699997,175.399994,175.490005,175.035751,58436200,13813303751.519093,7388127600,25.15583428707378,44.00000000000001,-1.8106705187090313,42.13186715292952,11.861384696827537,179.32615426923076,179.93148986514134,-88.13861530317247
2023-09-21,174.550003,176.300003,173.860001,173.929993,173.479797,63047900,13753872937.58443,7325079700,25.11508069652117,44.0,-2.0108577102009804,39.97281397092817,2.3722623408279584,179.1907695,179.48693454179755,-97.62773765917204
2023-09-22,174.669998,177.080002,174.050003,174.789993,174.337555,56725400,13724854628.409214,7381805100,24.793797064110727,44.0,-2.0761797809117297,41.74512564980989,7.603404938551415,179.1223074230769,179.13901294610883,-92.39659506144858
2023-09-25,174.199997,176.970001,174.149994,176.080002,175.624222,46172700,13741882963.287212,7427977800,24.495462262586745,44.0,-2.000791172141959,44.39709539919355,16.590508446988242,179.2023075,178.91241954269336,-83.40949155301175
2023-09-26,174.820007,175.199997,171.660004,171.960007,171.514893,64588900,13688241465.593771,7363388900,24.816551207694452,-60.0,-2.2475855536227414,38.386668131426134,3.472257346326119,179.1049998846154,178.39742602101236,-96.52774265367388
2023-09-27,172.619995,173.039993,169.050003,170.429993,169.988831,66921800,13667611217.59365,7296467100,25.654391918190054,-64.0,-2.53738186328863,36.415083185084015,12.266577777777709,178.8969228461538,177.8072457972337,-87.73342222222229
2023-09-28,169.339996,172.029999,167.619995,170.690002,170.248184,56294400,13689695069.432333,7352761500,26.70013194600923,-68.0,-2.714772762732963,37.00719493988895,24.211396396595337,178.64538461538464,177.28004255299416,-75.78860360340467
2023-09-29,172.020004,173.070007,170.339996,171.210007,170.76683,51814200,13670905589.080862,7404575700,27.228030799448693,-68.0,-2.781334774973004,38.24576378629947,28.69711535002766,178.26423123076924,176.8304102898094,-71.30288464997234
2023-10-02,171.220001,174.300003,170.929993,173.75,173.300262,52164500,13706043058.60113,7456740200,27.207531110384195,-68.0,-2.59916785265429,44.034204252223546,50.74506610181031,178.1630771923077,176.60223174982355,-49.25493389818969
2023-10-03,172.259995,173.630005,170.820007,172.399994,171.953751,49594600,13712219902.758883,7407145600,27.215153686401674,-68.0,-2.534517120323045,41.791996756236735,39.56952159445007,177.9242307692308,176.29095487946626,-60.43047840554993
2023-10-04,171.089996,174.210007,170.970001,173.660004,173.210495,53020300,13747239418.772125,7460165900,26.965849552329956,-68.0,-2.3544678329373028,44.62608801280294,50.00006622515455,177.67307699999998,176.0960696291354,-49.99993377484545
2023-10-05,173.789993,175.449997,172.679993,174.910004,174.45726,48527900,13776846966.09054,7508693800,26.195675830465238,-68.0,-2.0868569344677326,47.364091257373836,60.34774663116772,177.31884657692308,176.00821291586612,-39.65225336883228
2023-10-06,173.800003,177.990005,173.179993,177.490005,177.030594,57224100,13822174193.483986,7565917900,24.496895383528596,-68.0,-1.6475963851315214,52.57626681789461,81.70536726732331,176.92807776923075,176.11797529246863,-18.294632732676686
2023-10-09,176.809998,179.050003,175.800003,178.990005,178.526703,42390800,13862999846.888048,7608308700,22.944736077935584,-68.0,-1.1650122352512255,55.3448917461483,94.12258375453911,176.5865396923077,176.33071823376724,-5.87741624546088
2023-10-10,178.100006,179.720001,177.949997,178.389999,177.928253,43698000,13841027455.865202,7564610700,21.734581374320467,-68.0,-0.8215064741171147,53.987178561929724,89.0082533843371,176.16077015384616,176.4832575497845,-10.99174661566289
2023-10-11,178.199997,179.850006,177.600006,179.800003,179.334595,47551100,13886465046.840046,7612161800,20.471716874913998,-64.0,-0.43053718007618613,56.67685421566151,99.59114509381878,175.78000115384614,176.7289423979486,-0.4088549061812268
2023-10-12,180.070007,182.339996,179.039993,180.710007,180.242249,56743100,13887153271.237871,7668904900,20.144927043893116,40.0,-0.04672288782103351,58.36828035442218,88.92670591530516,175.6953858846154,177.02383607217462,-11.073294084694835
2023-10-13,181.419998,181.929993,178.139999,178.850006,178.387054,51427100,13854994592.765558,7617477800,19.461992002938427,39.99999999999999,0.10614262192666502,53.7491598375893,76.2908304150251,175.74500157692307,177.1591079186802,-23.70916958497489
2023-10-16,176.75,179.080002,176.509995,178.720001,178.257401,52517000,13892798658.118298,7564960800,18.179561592013318,40.0,0.21432867518285548,53.43088207213257,75.40764433371974,175.76577111538458,177.27472962840758,-24.592355666280262
2023-10-17,176.649994,178.419998,174.800003,177.149994,176.691452,57549400,13909967909.41776,7507411400,17.388555586641885,40.0,0.17140461234728832,49.6102742166309,64.74183663438602,175.68077084615382,177.26548995222925,-35.25816336561399
2023-10-18,175.580002,177.580002,175.110001,175.839996,175.384842,54764400,13887574134.513054,7452647000,16.654050010225554,40.0,0.03132005471431398,46.615110502222805,45.833333333333336,175.66307826923077,177.15989780761967,-54.166666666666664
2023-10-19,176.039993,177.839996,175.190002,175.460007,175.005844,59302900,13840355850.187279,7393344100,15.85922477973058,40.0,-0.10910224035097826,45.75223853206607,40.277816237497994,175.71115519230767,177.0339799700182,-59.722183762502006
2023-10-20,175.309998,175.419998,172.639999,172.880005,172.43251,64189300,13787249875.854519,7329154800,16.030371614857355,40.0,-0.4236885029764892,40.297970022979385,17.88194415810645,175.6011551923077,176.72627812038724,-82.11805584189355
2023-10-23,170.910004,174.009995,169.929993,173.0,172.5522,55980100,13815514488.901571,7385134900,16.96937670612512,40.0,-0.6557586118372001,40.65233889418388,24.738164849758697,175.5238476923077,176.45025751887707,-75.26183515024131
2023-10-24,173.050003,173.669998,171.449997,173.440002,172.991058,43816600,13850252135.573532,7428951500,17.841310005159478,40.0,-0.7950070149407509,42.01154155045299,28.28370790885378,175.34961696153843,176.22727562858987,-71.71629209114622
2023-10-25,171.880005,173.059998,170.649994,171.100006,170.657135,57157000,13814440607.10304,7371794500,18.87223396854888,40.0,-1.081711205236246,37.139987676899224,9.427983216442493,175.04307846153844,175.84747787832396,-90.57201678355752
2023-10-26,170.369995,171.380005,165.669998,166.889999,166.458023,70625300,13773994932.67103,7301169200,20.926378627068573,-40.0,-1.6298508163767167,30.32644754609305,7.318543169591231,174.712309,175.18396092437402,-92.68145683040878
2023-10-27,166.910004,168.960007,166.830002,168.220001,167.784576,58499100,13791846536.543463,7359668300,22.833798667122576,-39.99999999999999,-1.9346341035508772,34.41961209066977,15.296960443546547,174.49269392307693,174.66811204108706,-84.70303955645345
2023-10-30,169.020004,171.169998,168.869995,170.289993,169.849197,51131000,13803851034.834553,7410799300,23.50300904025902,-40.0,-1.9862497490172473,40.29828272876287,27.71443043964379,174.319617,174.34380692693247,-72.28556956035621
2023-10-31,169.350006,170.899994,167.899994,170.770004,170.327972,44846000,13844810680.474552,7455645300,24.352364615924444,-40.0,-1.9657625567299988,41.605489756924136,30.593920887093095,174.11538630769232,174.07908078419672,-69.40607911290691
2023-11-01,171.0,174.229996,170.119995,173.970001,173.519684,56934900,13894542278.419151,7512580200,23.707545009838352,-40.0,-1.6720390692487683,49.537912132367495,51.04554460195099,174.19269376923074,174.07100080018213,-48.95445539804901
2023-11-02,175.520004,177.779999,175.460007,177.570007,177.110382,77334800,13957877297.970253,7589915000,22.11747120001475,-40.0,-1.1356792876694612,56.66921250337504,88.73978710222606,174.46730969230768,174.33018644461308,-11.260212897773945
2023-11-03,174.240005,176.820007,173.350006,176.649994,176.192749,79763700,14029824939.16906,7510151300,21.05140696550311,-40.0,-0.7759035238945557,54.54765399256914,86.11761568627452,174.69654015384614,174.5020240413084,-13.882384313725492
2023-11-06,176.380005,179.429993,176.210007,179.229996,178.766068,63841300,14085735727.374226,7573992600,19.81406167811551,-40.0,-0.27937359473878587,59.16460588723628,98.5465329020832,175.00500126923077,174.85224418639666,-1.4534670979167954
2023-11-07,179.179993,182.440002,178.970001,181.820007,181.349365,70530000,14131062133.859411,7644522600,19.43749712521603,32.0,0.3194398892976551,63.205254614196456,96.30295258128747,175.31538615384613,175.3683747651821,-3.6970474187125344
2023-11-08,182.350006,183.449997,181.589996,182.889999,182.416595,49340300,14150692267.768747,7693862900,19.325926564525464,36.0,0.8703108994196782,64.75676167879088,96.8504047722387,175.71884788461537,175.92553211590933,-3.149595227761302
2023-11-09,182.960007,184.119995,181.809998,182.410004,181.937836,53763500,14124858174.240704,7640099400,19.381354379451587,40.0,1.2536967233110659,63.463948091927776,90.73175459052919,176.05538634615385,176.4058633665827,-9.268245409470813
2023-11-10,183.970001,186.570007,183.529999,186.399994,186.162445,66133400,14183594529.407795,7706232800,19.98333383448593,43.99999999999999,1.8580728904816795,69.00359288820054,99.18654102014975,176.49730903846154,177.14616933942844,-0.8134589798502547
2023-11-13,185.820007,186.029999,184.210007,184.800003,184.564499,43627500,14168252923.510626,7662605300,20.542314757017824,44.0,2.1827777520486222,64.76308159430332,91.53108498661412,176.7784628076923,177.71311998095226,-8.468915013385875
2023-11-14,187.699997,188.110001,186.300003,187.440002,187.201126,60108400,14183861199.320875,7722713700,21.50864043741009,52.0,2.6228993985520788,68.23209516686082,97.01426510504469,177.1034626923077,178.43362976014097,-2.9857348949553075
2023-11-15,187.850006,189.5,187.779999,188.009995,187.770386,53790500,14144456272.164146,7776504200,22.682639461772002,56.0,2.983302986000041,68.94301049263595,93.42741450616803,177.47346253846155,179.1429901482787,-6.5725854938319666
2023-11-16,189.570007,190.960007,188.649994,189.710007,189.468246,54412900,14139981083.655554,7830917100,24.04902058622834,60.0,3.3672862070945655,71.02563233350419,94.57936125187787,177.85461653846156,179.9257321372951,-5.420638748122129
2023-11-17,190.25,190.380005,188.570007,189.690002,189.448257,50922700,14152078529.961239,7779994400,25.280694507634134,60.0,3.628158289637696,70.9653252240828,94.49260934935293,178.20000096153848,180.64901138638436,-5.507390650647065
2023-11-20,189.889999,191.910004,189.880005,191.449997,191.206009,46505100,14177507095.898218,7826499500,26.71864082669575,68.0,3.9315971772183502,73.12716936738386,97.88890862780282,178.684616,181.4490843948003,-2.111091372197186
2023-11-21,191.410004,191.520004,189.740005,190.639999,190.397049,38134500,14177935338.004253,7788365000,27.982550307998824,68.0,4.059914446095263,70.52458307480379,93.1572999091918,179.14307746153847,182.12989288407437,-6.8427000908081945
2023-11-22,191.490005,192.929993,190.830002,191.309998,191.066193,39617700,14156428513.269148,7827982700,29.431409256304367,76.0,4.167628301242786,71.43032923612543,91.72627131979205,179.687693,182.80990067043922,-8.273728680207958
2023-11-24,190.869995,190.899994,189.25,189.970001,189.727905,24048300,14153367926.010284,7803934400,29.959249013934084,76.0,4.097630811102022,66.99617391666794,82.29668374124238,180.23115473076925,183.3402784726289,-17.703316258757624
2023-11-27,189.919998,190.669998,188.899994,189.789993,189.548126,40552600,14153596898.760855,7763381800,30.272663879985647,76.0,3.9817332127170744,66.39986934576007,77.5071504338972,180.7823080384615,183.81803510428603,-22.492849566102805
2023-11-28,189.779999,191.080002,189.399994,190.399994,190.157349,38415400,14160913900.035133,7801797200,30.668282687375786,76.0,3.8942154223845193,67.45693040847667,77.68959727238017,181.45615376923075,184.30558761507965,-22.310402727619834
2023-11-29,190.899994,192.089996,188.970001,189.369995,189.128662,43014200,14128928834.322079,7758783000,31.291765740464722,76.0,3.699103667310453,63.806731368195756,67.98561510144555,182.08576896153846,184.6807289028515,-32.01438489855446
2023-11-30,189.839996,190.320007,188.190002,189.949997,189.707916,48794400,14160770770.882792,7807577400,31.428654850914107,76.0,3.5503512704027003,64.95666499370574,68.2978946582306,182.72076876923074,185.07104505819586,-31.702105341769393
2023-12-01,190.330002,191.559998,189.229996,191.240005,190.996292,45679300,14193903252.257828,7853256700,31.892776702937308,76.0,3.4962541472368116,67.43491321411787,80.61937255403852,183.49538411538464,185.52800505388507,-19.38062744596148
2023-12-04,189.979996,190.050003,187.449997,189.429993,189.188583,43389500,14216599012.401073,7809867200,31.353812091835454,72.0,3.2696385875229623,60.92454704756661,47.209573468436545,184.36230696153845,185.81704119804172,-52.790426531563455
2023-12-05,190.210007,194.399994,190.179993,193.419998,193.173508,66628400,14252281654.100826,7876495600,31.9653610275618,96.0,3.37312094287509,68.21042652262226,85.89933204287713,185.3315376153846,186.38022318337195,-14.100667957122864
2023-12-06,194.449997,194.759995,192.110001,192.320007,192.074921,41089700,14217704484.724066,7835405900,32.61052369706657,100.0,3.3280081678047964,64.63251659294221,66.62122205778994,186.17884584615382,186.82020716978886,-33.37877794221007
2023-12-07,193.630005,195.0,193.589996,194.270004,194.02243,47477700,14216021287.181646,7882883600,33.26340357519258,100.0,3.410292698244831,67.85183762051929,90.3311826498612,187.08269199999998,187.37204397202672,-9.668817350138795
2023-12-08,194.199997,195.990005,193.669998,195.710007,195.460587,53377300,14256514542.223679,7936260900,34.092929969382055,96.0,3.550768934934382,70.02192865957232,96.72133796595968,187.9188460769231,187.9896708629877,-3.2786620340403214
2023-12-11,193.110001,193.490005,191.419998,193.179993,192.933807,60943700,14299203928.760584,7875317200,33.66178538065251,96.0,3.4185395826548586,62.09147570829928,67.09590904364492,188.51923015384617,188.37413916943308,-32.90409095635508
2023-12-12,193.080002,194.720001,191.720001,194.710007,194.461868,52696900,14351549726.881517,7928014100,33.590195913788925,92.0,3.39803577009792,64.69553418590056,85.01174706159519,189.21384603846153,188.84346271243803,-14.988252938404813
2023-12-13,195.089996,198.0,194.850006,197.960007,197.707718,70404200,14420166193.209263,7998418300,34.270285898358516,100.0,3.602506734389806,69.48989004854057,99.6209195390749,189.93423107692308,189.51876228929444,-0.37908046092507935
2023-12-14,198.020004,199.619995,196.160004,198.110001,197.857529,66831600,14428665089.447664,8065249900,35.211676516165944,100.0,3.7336159088704335,69.6944394217368,87.59248768980916,190.56076930769234,190.1551503419393,-12.407512310190835
2023-12-15,197.529999,198.399994,197.0,197.570007,197.318222,128256700,14404847718.183218,7936993200,36.08582494698713,96.0,3.750711998177252,67.92877607879822,83.15539575273566,191.125385,190.70439898327714,-16.844604247264346
2023-12-18,196.089996,196.630005,194.389999,195.889999,195.64035,55751900,14423763341.395208,7881241300,35.58396246665737,92.0,3.5873454812731893,62.61396223829863,69.35089060819894,191.64384634615382,191.08851750303438,-30.64910939180107
2023-12-19,196.160004,196.949997,195.889999,196.940002,196.689026,40714100,14463709633.47576,7921955400,35.20003767345036,88.0,3.5022312645389775,64.4842937721247,77.9786898896779,192.04923126923075,191.5219607991059,-22.0213101103221
2023-12-20,196.899994,197.679993,194.830002,194.830002,194.581711,52242800,14411466833.47576,7869712600,34.335388438763786,84.0,3.2273157811769693,58.184935466762475,60.64097134609238,192.43500046153846,191.767000888061,-39.35902865390762
2023-12-21,196.100006,197.080002,193.5,194.679993,194.431885,46482500,14395626229.55431,7823230100,32.92801208794111,32.0,2.963181100124956,57.75298263456277,59.40835816078199,192.71346165384617,191.98277808153796,-40.59164183921801
2023-12-22,195.179993,195.410004,192.970001,193.600006,193.353287,37122800,14377673528.618942,7786107300,31.38650591744089,32.0,2.6363167192423305,54.60971353903746,36.228943595562946,192.92846207692307,192.10257274216477,-63.771056404437054
2023-12-26,193.610001,193.889999,192.830002,193.050003,192.803986,28919300,14360758554.894016,7757188000,29.890792190679804,32.0,2.306308013773105,53.0268828697271,19.878117028579545,193.05692346153847,192.17275276126367,-80.12188297142045
2023-12-27,192.490005,193.5,191.089996,193.149994,192.903839,48087700,14394878656.893183,7805275700,27.78004261222381,32.0,2.029447962322564,53.29193844204126,24.15003800117661,193.19000007692304,192.24514100117008,-75.84996199882339
2023-12-28,194.139999,194.660004,193.169998,193.580002,193.333298,34049900,14379567735.393404,7839325600,26.241070400831028,32.0,1.8237098369716307,54.481470333951385,29.191164031789466,193.27192334615387,192.344019593676,-70.80883596821053
2023-12-29,193.899994,194.399994,191.729996,192.529999,192.284637,42628800,14362484398.638245,7796696800,24.532558752203354,31.999999999999996,1.5579750568593909,51.061838275135564,16.881631521879363,193.34461565384615,192.3577958459963,-83.11836847812064
2024-01-02,187.149994,188.440002,183.889999,185.639999,185.403412,82488700,14343448502.955076,7714208100,25.18403954917134,-43.99999999999999,0.782393960681901,35.37237351947665,11.125241227016206,193.12653876923076,191.8601812648114,-88.8747587729838
2024-01-03,184.220001,185.880005,183.429993,184.25,184.015198,58414500,14324136096.25217,7655793600,25.88312979581291,-48.0,0.054945672101979426,33.15881679014598,5.064897459555621,192.9065387307692,191.29646413408463,-94.93510254044439
2024-01-04,182.149994,183.089996,180.880005,181.910004,181.678177,71983600,14319250539.652708,7583810000,27.024737711235023,-52.0,-0.7022849548150418,29.780196933026446,5.496262271217735,192.60346223076925,190.60117079081908,-94.50373772878227
2024-01-05,181.990005,182.759995,180.169998,181.179993,180.949097,62303300,14305538818.31747,7521506700,28.212743287382743,-56.0,-1.345788061888868,28.79448811874012,5.540291945209442,192.2488468076923,189.90330576927693,-94.45970805479057
2024-01-08,182.089996,185.600006,181.5,185.559998,185.323517,59144500,14363529050.174448,7580651200,28.11356708816271,-56.0,-1.4852184385206328,41.34011024704037,30.78241884135326,192.10230846153843,189.581579267849,-69.21758115864675
2024-01-09,183.919998,185.149994,182.729996,185.139999,184.904053,42841800,14406016962.4514,7537809400,28.021474903172685,-56.0,-1.6110373895738235,40.60139363725893,28.383794512791095,191.91730853846153,189.25257332208244,-71.6162054872089
2024-01-10,184.350006,186.399994,183.919998,186.190002,185.952713,46792900,14444885547.527666,7584602300,27.424716291761154,-56.0,-1.6074931672984007,43.32787598589612,34.38038674482773,191.72307765384613,189.02571618711337,-65.61961325517227
2024-01-11,186.539993,187.050003,183.619995,185.589996,185.353485,49128400,14452190250.382471,7535473900,26.60871621205001,-56.0,-1.6342610710165104,42.13760454141049,32.05202080377992,191.57538546153845,188.77121839547533,-67.94797919622009
2024-01-12,186.059998,186.740005,185.190002,185.919998,185.68306,40444700,14449841565.965925,7575918600,25.85100185231823,-56.0,-1.6102840716957587,43.06403109127883,37.729643938460406,191.28692392307693,188.5600168846994,-62.270356061539594
2024-01-16,182.160004,184.259995,180.929993,183.630005,183.395981,65603000,14490622218.129498,7510315600,26.28066912543709,-56.0,-1.7558253620092046,38.46200790349061,23.87857534358523,190.95269307692308,188.1948308191661,-76.12142465641477
2024-01-17,181.270004,182.929993,180.300003,182.679993,182.447189,47317400,14528943880.503119,7462998200,26.8217647925655,-56.0,-1.9256284656791536,36.70937587998679,17.322249556004355,190.5069234230769,187.78632431404267,-82.67775044399565
2024-01-18,186.089996,189.139999,185.830002,188.630005,188.389618,78005800,14582911900.429482,7541004000,25.06165180347241,-56.0,-1.5620757695153884,51.58858900692381,58.385117300848755,190.2346156538461,187.84881917966914,-41.614882699151245
2024-01-19,189.330002,191.949997,188.820007,191.559998,191.315872,68741000,14634522544.575949,7609745000,23.87042859742578,-56.0,-1.025707967455304,56.95514054954548,80.04218694088188,190.17230815384616,188.12372131450846,-19.957813059118113
2024-01-22,192.300003,195.330002,192.259995,193.889999,193.642899,60133900,14638244197.697227,7669878900,23.537223170895338,-56.0,-0.4079187781779581,60.687256475338366,90.50130197854818,190.1407693846154,188.55085299491523,-9.498698021451823
2024-01-23,195.020004,195.75,193.830002,195.179993,194.931259,42355600,14655450825.157465,7712234500,23.31761413174575,-56.00000000000001,0.18365824223226923,62.61964106163609,96.34141895488843,190.03384576923074,189.04190040269927,-3.658581045111571
2024-01-24,195.419998,196.380005,194.339996,194.5,194.252121,53631300,14610232451.301613,7658603200,23.25298999904769,-52.0,0.5908070845225097,60.9197550690326,88.40219501447466,189.89499957692308,189.44620407657342,-11.597804985525356
2024-01-25,195.220001,196.270004,193.110001,194.169998,193.922546,54822100,14592189595.836317,7603781100,22.76431888206567,-40.0,0.8767405525901211,60.06754643970287,86.3664031730522,189.76423000000003,189.796114737568,-13.6335968269478
2024-01-26,194.270004,194.759995,191.940002,192.419998,192.174774,44594000,14562776443.181683,7559187100,21.91292999468407,-40.0,0.9511700155765652,55.623749556569415,75.37309385906784,189.63076842307692,189.99047646071108,-24.626906140932178
2024-01-29,192.009995,192.199997,189.580002,191.729996,191.485657,47145600,14593007141.324541,7512041500,20.377310977963365,-40.0,0.943601258479589,53.92965013460076,71.08203717885104,189.43038357692305,190.11932975991766,-28.91796282114896
2024-01-30,190.940002,191.800003,187.470001,188.039993,187.800354,55859400,14551854159.99354,7456182100,19.488065826955744,-36.0,0.6325588162129634,45.88179600550524,48.134260182305965,189.1692293846154,189.96530481473857,-51.865739817694035
2024-01-31,187.039993,187.100006,184.350006,184.399994,184.164993,55467800,14498402886.820011,7400714300,19.430723872772774,48.0,0.09128565698736679,39.60345629186624,25.497453296336573,188.7738448076923,189.5530595692024,-74.50254670366343
2024-02-01,183.990005,186.949997,183.820007,186.860001,186.621872,64885400,14559557011.98629,7465599700,19.499023962719928,48.0,-0.13758917325475295,45.07367517485852,40.79600238855694,188.51461384615385,189.35357374926147,-59.20399761144306
2024-02-02,179.860001,187.330002,179.25,185.850006,185.613159,102518000,14624519023.775396,7363081700,20.487699249550666,-28.0,-0.3959084941196238,43.33815140950756,38.52892045273777,188.23769088461538,189.09405021227914,-61.47107954726222
2024-02-05,188.149994,189.25,185.839996,187.679993,187.440811,69668800,14630035110.944796,7432750500,20.752687429393312,-28.0,-0.44780177976451796,47.297741981074545,49.211853703486895,188.02730623076923,188.9893052335918,-50.788146296513105
2024-02-06,186.860001,189.309998,186.770004,189.300003,189.058762,43490800,14673183634.115795,7476241300,20.978324451588538,-28.0,-0.3541241912553801,50.58953739861511,58.669002139812555,187.86269088461538,189.01231988295538,-41.330997860187445
2024-02-07,190.639999,191.050003,188.610001,189.410004,189.168625,53439000,14654786704.013277,7529680300,20.59413921077765,-28.0,-0.26791945733788225,50.814187739792494,59.311156067963665,187.7426910769231,189.04177796569942,-40.688843932036335
2024-02-08,189.389999,189.539993,187.350006,188.320007,188.080017,40962000,14650110929.42192,7488718300,20.537078590856936,-27.999999999999993,-0.28427825033884346,48.46287348769336,52.9480697758115,187.8457683076923,188.9883134497217,-47.0519302241885
2024-02-09,188.649994,189.990005,188.0,188.850006,188.850006,45155200,14643530698.7624,7533873500,20.32355773392235,-28.0,-0.2515762078143666,49.68209514616927,56.04205019204607,188.02269161538464,188.978068453446,-43.95794980795393
2024-02-12,188.419998,188.669998,186.789993,187.149994,187.149994,41781900,14617750379.377237,7492091600,20.42875327577798,-28.0,-0.3587014769725272,45.928828202256405,46.11787328725232,188.2242296923077,188.84265553096853,-53.88212671274768
2024-02-13,185.770004,186.210007,183.509995,185.039993,185.039993,56529500,14625287277.55695,7435562100,21.256812669161466,-28.0,-0.6068629331280704,41.716406866985416,34.0187522870148,188.37269123076925,188.56097682497085,-65.98124771298521
2024-02-14,185.320007,185.529999,182.440002,184.149994,184.149994,54630500,14631121378.62679,7380931600,22.23896992432267,-28.0,-0.8653726787413518,40.047937881896935,31.592492454059407,188.31846030769233,188.23423735645449,-68.40750754594059
2024-02-15,183.550003,184.490005,181.350006,183.860001,183.860001,65434500,14670298547.501524,7315497100,23.364359679367393,-28.0,-1.0811803520424519,39.49366785705175,35.598471567213586,188.26922961538463,187.91021984856897,-64.4015284327864
2024-02-16,183.419998,184.850006,181.669998,182.309998,182.309998,49701400,14640602692.141665,7265795700,24.250808413556946,-28.0,-1.3615862573120694,36.57953640544759,24.382448354793272,188.1199986923077,187.49538860052684,-75.61755164520673
2024-02-20,181.789993,182.429993,180.0,181.559998,181.559998,53665600,14655841182.539291,7212130100,25.415176085093577,-28.000000000000004,-1.6255899009584596,35.22513395721569,19.576249260275667,187.96499876923073,187.05573003752482,-80.42375073972433
2024-02-21,181.940002,182.889999,180.660004,182.320007,182.320007,41529700,14676140703.312523,7253659800,26.279634327042945,-28.0,-1.7532776228927673,37.7408124523124,26.0170018600843,187.82653757692307,186.7049357384489,-73.98299813991571
2024-02-22,183.479996,184.960007,182.460007,184.369995,184.369995,52292200,14703750482.907402,7305952000,26.152008152317958,-28.0,-1.6698056828367953,44.05251402883786,43.38977710429385,187.85499873076924,186.53197716523047,-56.61022289570615
2024-02-23,185.009995,185.039993,182.229996,182.520004,182.520004,45119700,14667944012.749,7260832300,26.093939876838952,-28.0,-1.7329559442421214,40.101516282181116,22.805459871820844,187.84884530769233,186.234793967806,-77.19454012817916
2024-02-26,182.240005,182.759995,180.649994,181.160004,181.160004,40867400,14646832795.493937,7219964900,26.448288544048776,-28.0,-1.871173887574031,37.44287783500507,10.497770905582433,187.56153757692312,185.8588835998204,-89.50222909441757
2024-02-27,181.100006,183.919998,179.559998,182.630005,182.630005,54318900,14669009034.591322,7274283800,26.24304584684875,-28.0,-1.8408753430326215,41.92468786948369,26.71893528331802,187.21807630769231,185.6197074072411,-73.28106471668198
2024-02-28,182.509995,183.119995,180.130005,181.419998,181.419998,48953900,14662296204.50975,7225329900,26.052463342305867,-28.0,-1.8926833056508485,39.42111344805093,17.83316156930659,186.73846088461536,185.30861782151953,-82.16683843069342
2024-02-29,181.270004,182.570007,179.529999,180.75,180.75,136682600,14635319176.78627,7088647300,26.056210403890606,-28.000000000000004,-1.9651516831362983,38.06563066924633,11.663482793413285,186.18346115384614,184.9709424273329,-88.33651720658672
2024-03-01,179.550003,180.529999,177.380005,179.660004,179.660004,73488000,14668213961.332525,7015159300,26.657593680955213,-100.0,-2.086485258851269,35.90276712292439,20.19486637414194,185.61269207692308,184.57753958086377,-79.80513362585806
2024-03-04,176.149994,176.899994,173.789993,175.100006,175.100006,81510100,14655372193.356405,6933649200,28.008056747976354,-100.0,-2.521530091575528,28.58526649786343,10.547596806251587,184.87923084615383,183.87550005635535,-89.45240319374842
2024-03-05,170.759995,172.039993,169.619995,170.119995,170.119995,95132400,14599550734.935696,6838516800,29.94135773127847,-100.0,-3.2309076318401253,23.058036860153862,3.142676771168628,184.02153842307692,182.85657375588457,-96.85732322883138
2024-03-06,171.059998,171.240005,168.679993,169.119995,169.119995,68587700,14554540053.461702,6769929100,31.867125561606514,-100.0,-3.8296403755592223,22.132589188156786,2.6894987775060653,183.151923,181.83904940359682,-97.31050122249394
2024-03-07,169.149994,170.729996,168.490005,169.0,169.0,71765100,14515453515.272442,6698164000,33.68236090843427,-80.0,-4.264662606386906,22.018390022242144,3.0815430198499425,182.41961557692306,180.8880087070341,-96.91845698015005
2024-03-08,169.0,173.699997,168.940002,170.729996,170.729996,76114600,14496584638.140806,6774278600,33.92150113559161,-80.0,-4.4188864669341115,27.802289875066393,13.534698635431045,181.8938464230769,180.13556332132788,-86.46530136456896
2024-03-11,172.940002,174.380005,172.050003,172.75,172.75,60139500,14472580274.146269,6834418100,33.84239094553123,-80.0,-4.32821952614421,33.961403497892334,25.740169720968982,181.35115407692305,179.5884845567851,-74.25983027903101
2024-03-12,173.149994,174.029999,171.009995,173.229996,173.229996,59825400,14500710021.109915,6894243500,34.00040954819404,-80.0,-4.169569455426824,35.372263147102856,28.640449769510404,180.86576907692307,179.11748540443062,-71.35955023048959
2024-03-13,172.770004,173.190002,170.759995,171.130005,171.130005,52488700,14464205920.23823,6841754800,34.20347093822439,-80.0,-4.1652751555151895,32.13736411529784,15.951673197587894,180.22923107692307,178.52582018928763,-84.0483268024121
2024-03-14,172.910004,174.309998,172.050003,173.0,173.0,72913500,14452591322.456596,6914668300,33.843102938260635,-80.0,-3.965269762074257,37.60911971639399,29.22875596897552,179.60230788461539,178.1165001752663,-70.77124403102448
2024-03-15,171.169998,172.619995,170.289993,172.619995,172.619995,121664700,14574256022.456596,6793003600,33.947645110718845,-72.0,-3.793695909525667,36.95700163068032,26.76598751535398,178.95653830769228,177.7093516437651,-73.23401248464602
2024-03-18,175.570007,177.710007,173.520004,173.720001,173.720001,75604200,14505869293.750721,6868607800,31.98815791256658,-72.0,-3.52828918277649,40.18994222853489,35.748459158208604,178.39499961538465,177.4138441886714,-64.2515408417914
2024-03-19,174.339996,176.610001,173.029999,176.080002,176.080002,55215200,14544735899.093622,6923823000,30.31276430237469,-68.0,-3.0918788278274008,46.52582031416662,53.9062210360482,177.9038456153846,177.31504106358463,-46.0937789639518
2024-03-20,175.720001,178.669998,175.089996,178.669998,178.669998,53423100,14598158999.093622,6977246100,28.228222492515943,-64.0,-2.5081174291883315,52.47584275889231,84.55147901236488,177.57769192307694,177.41540824405985,-15.448520987635126
2024-03-21,177.050003,177.490005,170.839996,171.369995,171.369995,106181300,14508902783.80214,6871064800,27.324081000582943,-60.0,-2.604508396873541,39.227222314549785,28.290687429745713,177.05192276923077,176.96759985561098,-71.70931257025428
2024-03-22,171.759995,173.050003,170.059998,172.279999,172.279999,71106600,14543385788.573101,6942171400,26.675125859036374,-36.00000000000001,-2.5777544667480186,41.21949817028407,37.22982913642483,176.59538449999997,176.62037016260277,-62.77017086357517
2024-03-25,170.570007,171.940002,169.449997,170.850006,170.850006,54288300,14550144842.770945,6887883100,26.223950010872862,-36.0,-2.6414908067721967,39.05294444794967,23.182736962589384,176.09500007692307,176.19293578018775,-76.81726303741061
2024-03-26,170.0,171.419998,169.580002,169.710007,169.710007,57388400,14500866002.728683,6830494700,25.80500100900674,-36.0,-2.752264317540181,37.36675120412592,11.984310794712671,175.61038503846154,175.71271883350718,-88.01568920528733
2024-03-27,170.410004,173.600006,170.110001,173.309998,173.309998,60273300,14551122274.56603,6890768000,24.58173068211271,-36.0,-2.5205090759191933,45.38608835567214,44.912618669113684,175.29307734615384,175.53473951250666,-55.087381330886316
2024-03-28,171.75,172.229996,170.509995,171.479996,171.479996,65672700,14559522304.375723,6825095300,23.44583680713968,-36.0,-2.4561937717896853,42.41325880909727,22.0173403451909,174.87615384615384,175.23438814120988,-77.9826596548091
2024-04-01,171.190002,171.25,169.479996,170.029999,170.029999,46240500,14542018930.078829,6778854800,22.720410873452465,-36.0,-2.4934827526365098,40.1681895908678,6.290693460879318,174.32461553846153,174.8488778344536,-93.70930653912069
2024-04-02,169.080002,169.339996,168.229996,168.839996,168.839996,49258300,14546900383.231983,6729596500,22.43019165318555,-96.0,-2.589211022500706,38.37296382453693,5.842910758063208,173.79846138461536,174.4037754763459,-94.15708924193679
