Date,Open,High,Low,Close,Adj_Close,Volume,Accumulation_Distribution_Line,On_Balance_Volume,Average_Directional_Index,Aroon_Oscillator,MACD,RSI,Stochastic_Oscillator,Simple_Moving_Average,Exponential_Moving_Average,Williams_%R
2014-03-27,28.322241,28.322241,27.570307,27.846546,27.846546,262719,-69688.13867174543,262719,0.0,0.0,0.0,100.0,36.737133844193714,27.846546,27.846546,-63.262866155806286
2014-03-28,27.983171,28.243956,27.857019,27.922838,27.922838,824257,-613528.5774072601,1086976,0.0,0.0,0.006085971509971699,100.0,46.88323709261691,27.884692,27.85219725925926,-53.11676290738309
2014-03-31,28.266893,28.272379,27.770258,27.772251,27.772251,216593,-828402.1916456588,870383,0.0,0.0,-0.0012278111703665218,31.993274869081148,26.856612415451416,27.847211666666666,27.846275314128945,-73.14338758454859
2014-04-01,27.859013,28.344681,27.859013,28.280355,28.280355,158434,-711936.8841845957,1028817,0.0,12.0,0.03358852218459063,80.40809568381752,91.69316118568017,27.9554975,27.87842936493421,-8.306838814319836
2014-04-02,29.917362,30.158699,28.032537,28.272379,28.272379,2942055,-2990234.037595296,-1913238,0.0,16.0,0.05984723894777133,79.45189741085835,27.12386686406083,28.0188738,27.907610819383525,-72.87613313593917
2014-04-03,28.414488,29.283602,28.129271,28.409002,28.409002,101983228,-55545922.87999111,100069990,0.0,16.0,0.09063698867450398,83.148551202402,32.40216319630109,28.083895166666668,27.944750906836596,-67.59783680369891
2014-04-04,28.653831,28.809404,27.075665,27.082645,27.082645,127386783,-181906992.3840845,-27316793,0.0,-8.0,0.00792085539858789,28.86232439784007,0.2264003575698049,27.94085942857143,27.880891210033884,-99.7735996424302
2014-04-07,26.962973,27.348913,26.285334,26.833828,26.833828,88033033,-179141710.63303712,-115349826,0.0,-12.000000000000004,-0.07682414765688961,25.499043372321395,14.160658755371664,27.8024805,27.803330972253594,-85.83934124462834
2014-04-08,27.055719,27.674021,27.006353,27.669035,27.669035,63024560,-117058458.15761498,-52325266,0.0,-12.000000000000004,-0.07571811702905151,47.58034861722469,35.72348590953866,27.78765322222222,27.79338312245703,-64.27651409046133
2014-04-09,27.904388,28.191101,27.571802,28.12977,28.12977,66616395,-63636497.90317392,14291129,0.0,-12.000000000000004,-0.037234895118018585,55.428416000203846,47.61844029674461,27.8218649,27.818300668941692,-52.38155970325539
2014-04-10,28.172651,28.172651,26.921087,26.973444,26.973444,80737057,-137618566.59518638,-66445928,0.0,-12.000000000000004,-0.09890242330603627,39.460586151184806,17.76517317629508,27.744735727272726,27.75571869346453,-82.23482682370492
2014-04-11,26.554594,26.926073,26.254417,26.457361,26.457361,78496923,-168679065.17163646,-144942851,0.0,-28.0,-0.18725935937008487,34.661245868309635,5.197985186520819,27.6374545,27.659544049504195,-94.80201481347918
2014-04-14,26.838814,27.130512,26.405504,26.553099,26.553099,51501009,-199211225.76346728,-93441842,0.0,-28.0,-0.24671364991177214,36.21117588248736,7.650113388325934,27.55404253846154,27.577585156948327,-92.34988661167407
2014-04-15,26.767509,26.848787,25.852022,26.748562,26.748562,77101101,-137615199.3752868,-16340741,0.0,-36.0,-0.27489060518048447,39.373238751074666,20.8174423110904,27.496508214285715,27.516176034211416,-79.1825576889096
2014-04-16,27.075665,27.773746,26.926073,27.750811,27.750811,97865955,-45045049.899174035,81525214,0.0,-36.0,-0.21388242363681798,52.40217046993487,44.08942207646402,27.513461733333333,27.533556402047605,-55.910577923535975
2014-04-17,27.365368,27.399775,26.484785,26.731607,26.731607,136190888,-107759927.54291634,-54665674,0.0,-36.0,-0.24495060705831406,42.41887811913913,20.42375130524066,27.4645958125,27.474152742636672,-79.57624869475934
2014-04-21,26.731607,26.761526,26.208046,26.358631,26.358631,51334553,-131161353.19050986,-106000227,0.0,-36.0,-0.29625338772121523,39.45645538518406,11.763338648336008,27.39953905882353,27.391521502441364,-88.23666135166398
2014-04-22,26.359631,26.787954,26.303284,26.667286,26.667286,47307527,-107410079.59194157,-58692700,0.0,-36.0,-0.30844971573093716,43.00385757392613,18.930233216932677,27.358858333333334,27.33787442818645,-81.06976678306732
2014-04-23,26.616425,26.620415,26.240458,26.274862,26.274862,41046384,-141023202.48536405,-99739084,0.0,-36.0,-0.34579462553079665,39.81009432279096,12.322020760116262,27.301805894736844,27.259132766839304,-87.67797923988374
2014-04-24,26.430935,26.509718,26.034521,26.186106,26.186106,37663121,-154657702.94783995,-137402205,0.0,-36.0,-0.3781930292140956,39.10275227438499,11.296613017865033,27.2460209,27.179649302628984,-88.70338698213497
2014-04-25,26.053968,26.16317,25.700439,25.738335,25.738335,42007014,-189784271.0622434,-179409219,0.0,-64.0,-0.4349861257840395,35.66032704603222,1.5215231934321045,27.174226333333337,27.07288528021202,-98.47847680656788
2014-04-28,25.788198,25.859003,25.071167,25.786703,25.786703,66710653,-135317740.4732531,-112698566,0.0,-68.0,-0.470666618814235,36.31255270686579,22.934331303162182,27.111157090909092,26.97761251871483,-77.06566869683782
2014-04-29,25.774237,26.400517,25.745316,26.312757,26.312757,53981801,-95796976.1803398,-58716765,0.0,-68.0,-0.4512932772417173,43.07186997198518,39.795393107674776,27.076444043478258,26.92836396177299,-60.204606892325224
2014-04-30,26.307772,26.327717,26.054466,26.2609,26.2609,35023895,-77901593.73630503,-93740660,0.0,-68.0,-0.435108530684996,42.59198339877362,38.36012051005263,27.042463041666664,26.87892218682684,-61.63987948994737
2014-05-01,26.283339,26.573542,26.12228,26.494759,26.494759,38110345,-53098140.564710945,-55630315,0.0,-68.0,-0.39881425311850904,45.53886664529802,52.6753149491652,27.02055488,26.8504656544693,-47.3246850508348
2014-05-02,26.614929,26.626896,26.208544,26.324226,26.324226,33770463,-68192298.91806889,-89400778,0.0,-68.0,-0.37943744587275674,43.774258761376466,46.36530514001627,26.993772999999997,26.811484939323424,-53.63469485998373
2014-05-05,26.169153,26.372595,25.994633,26.318243,26.318243,20482080,-53600980.48753899,-109882858,0.0,-68.0,-0.3604093895306697,43.71026396219484,46.143924007401814,26.934992115384617,26.77494849937354,-53.856075992598186
2014-05-06,26.189596,26.268379,25.682489,25.686478,25.686478,33780490,-86921485.25273375,-143663348,11.825477125785357,-68.0,-0.3917913466469152,37.47950477798786,22.76754907072104,26.84897826923077,26.6943210549755,-77.23245092927895
2014-05-07,25.718889,25.763268,25.0961,25.428186,25.428186,64486563,-87211070.09905128,-208149911,12.899571684586975,-68.0,-0.4325179814628157,35.26612779010702,15.331863499567152,26.75882192307692,26.600533273125464,-84.66813650043285
2014-05-08,25.353392,25.790691,25.253166,25.480045,25.480045,40426688,-93511097.7697567,-167723223,13.84706918948422,-68.0,-0.45536043345290267,36.08229767772722,23.816466457399862,26.65111769230769,26.517534141782836,-76.18353354260013
2014-05-09,25.467579,25.923826,25.140976,25.865486,25.865486,48789585,-51993364.05391046,-118933638,14.474810035652213,-64.0,-0.43732021853399416,41.941435696024776,46.267766473068676,26.558544884615383,26.46923427942855,-53.732233526931324
2014-05-12,26.103832,26.436916,25.879448,26.423454,26.423454,38250730,-15590027.365311362,-80682908,14.14654295872805,-60.0,-0.37369217301594304,49.20090122766552,86.92304379490265,26.482177653846154,26.46584314761903,-13.076956205097359
2014-05-13,26.471823,26.730112,26.403011,26.58152,26.58152,33068541,-12565543.976091653,-47614367,13.369550941955472,-48.00000000000001,-0.3069732863791117,51.06749436281606,91.04298213623736,26.462903615384615,26.474411803350954,-8.957017863762648
2014-05-14,26.577032,26.577032,26.192589,26.260403,26.260403,23835261,-27991941.298230566,-71449628,12.955054216877658,-48.0,-0.27681855426901336,47.26763884850267,71.68628254704053,26.440848807692305,26.45855929939903,-28.313717452959462
2014-05-15,26.213032,26.22151,25.800165,25.927814,25.927814,34087331,-41425348.7210239,-105536959,13.111069603333153,-48.0,-0.2765697407437884,43.645298382639304,51.63805912793991,26.373878769230767,26.41924483277688,-48.36194087206009
2014-05-16,25.998121,26.018566,25.701437,25.960226,25.960226,29705333,-22649379.65317787,-75831626,13.387564686798655,-44.0,-0.2706374368052913,44.09493240766386,52.88369975251098,26.290434769230767,26.38524343775637,-47.11630024748902
2014-05-19,25.913855,26.416473,25.808292,26.3706,26.3706,25555972,-948605.706244342,-50275654,12.92460331904685,-28.0,-0.2301690455508556,49.580097522833256,77.99820319557023,26.26724846153846,26.384158738663306,-22.001796804429777
2014-05-20,26.414478,26.738091,26.24295,26.415976,26.415976,35695734,-11696738.634695021,-14579920,12.040703983177405,-28.0,-0.19222029404893703,50.16237093115887,80.3826573958079,26.26565673076923,26.386515572836394,-19.617342604192103
2014-05-21,26.572046,26.885336,26.522682,26.87322,26.87322,23925508,10630102.564839663,9345588,11.456090765049224,-28.0,-0.12382251672921285,55.71260820111225,99.32283946891305,26.27796907692308,26.422567752626293,-0.6771605310869506
2014-05-22,26.98242,27.305035,26.964968,27.178383,27.178383,32316482,18875168.765811913,41662070,11.549134727083933,-28.000000000000004,-0.04447994456442217,58.994783893625396,94.26637723608889,26.294500653846153,26.478554067246566,-5.733622763911114
2014-05-23,27.28808,27.606207,27.110567,27.559336,27.559336,38643806,50210146.45887095,80305876,12.05166790149769,76.0,0.04857934638593164,62.71011069393108,98.13270908371622,26.28713623076923,26.558611988191267,-1.8672909162837668
2014-05-27,27.723885,28.222515,27.641609,28.220022,28.220022,42083223,91932163.08489977,122389099,13.264343002150408,80.0,0.17363973278423472,68.10719308935313,99.92026010622385,26.34438296153846,26.681679396473395,-0.07973989377613616
2014-05-28,28.151211,28.314262,27.9732,28.007107,28.007107,33040464,65461196.78823869,89348635,14.492556250339755,84.0,0.2526580442611497,64.84978384126518,90.32060142073553,26.407785884615386,26.779859218956847,-9.67939857926446
2014-05-29,28.090378,28.122789,27.859013,27.927326,27.927326,27082150,52406577.06354801,62266485,15.387963770809785,84.0,0.3053233875064656,63.621881710469886,87.80645677698138,26.456248961538464,26.864856758293378,-12.193543223018615
2014-05-30,27.963226,27.990652,27.719397,27.917852,27.917852,35422988,68815769.73148018,26843497,15.915713915911194,84.0,0.34235017908035914,63.468197244938324,84.82829887191069,26.519440884615385,26.942856405827204,-15.171701128089303
2014-06-02,27.958241,27.968212,27.21179,27.620667,27.620667,28700582,71142862.40623581,-1857085,15.38962886299662,84.0,0.343751281549018,58.67979895853418,73.45421143781162,26.574616307692306,26.993064597988152,-26.545788562188367
2014-06-03,27.47407,27.541386,27.053225,27.172398,27.172398,37332215,52038207.81435943,-39189300,14.610232201218684,84.0,0.3051722674541004,52.27343447849171,56.29772372814873,26.629772576923074,27.006348553692735,-43.70227627185127
2014-06-04,27.00087,27.355396,26.863747,27.158438,27.158438,36329469,59260002.21194199,-75518769,13.59048193609791,56.0,0.2703551792890906,52.08273556947137,55.76343612756313,26.682531615384615,27.017614438604387,-44.236563872436875
2014-06-05,27.245197,27.671528,27.147964,27.619171,27.619171,33782496,86285921.58302207,-41736273,13.143626259159532,56.0,0.2767494927861449,57.58268764719444,73.39695540267726,26.732778307692307,27.06217418389295,-26.603044597322732
2014-06-06,27.826603,27.826603,27.371351,27.740339,27.740339,34735104,107857375.51028869,-7001169,12.985554837240821,56.0,0.2882712655512343,58.91817541926238,77.09777052398867,26.78967980769231,27.112408614715694,-22.902229476011332
2014-06-09,27.781227,28.06794,27.72588,28.029045,28.029045,29350361,130532987.68788908,22349192,13.227298056752574,56.0,0.31704383093070376,61.9890236120398,86.23012853688873,26.848690807692307,27.180307606218236,-13.769871463111281
2014-06-10,27.948767,28.102844,27.818624,27.950762,27.950762,27034019,128635983.69472897,-4684827,13.508056772245686,56.0,0.32972860630287215,60.664858482772644,79.71064646848042,26.911249884615383,27.237378302053923,-20.289353531519577
2014-06-11,27.82361,27.917353,27.675018,27.865496,27.865496,22002242,141221754.58330077,-26687069,13.433405793114854,56.0,0.3291073835169307,59.18196537288513,69.06160915261137,26.970759615384615,27.283905538938818,-30.93839084738864
2014-06-12,27.788706,27.823112,27.347916,27.492022,27.492022,29169867,129743757.27034336,-55856936,12.645106351480061,56.00000000000001,0.2950773612941333,53.06356049762647,43.313926433025436,27.040203615384616,27.2993215730915,-56.686073566974564
2014-06-13,27.537395,27.539391,27.203314,27.512465,27.512465,24410836,150243071.9812579,-31446100,11.869571369740003,48.0,0.2666837386261953,53.34786861382149,44.72328793566417,27.120368192307694,27.315109975084724,-55.27671206433583
2014-06-16,27.387808,27.405758,27.001865,27.139488,27.139488,34051232,139397157.73391044,-65497332,11.554715506357836,48.0,0.21164574093905486,47.673958678307734,19.009868908629013,27.184192923076925,27.30210093989326,-80.99013109137098
2014-06-17,27.135498,27.191345,26.892666,27.076162,27.076162,28891103,146005047.53948465,-94388435,11.477998602787896,28.0,0.16106123858087784,46.764534145214675,16.871160771443673,27.230757384615384,27.28536472212339,-83.12883922855633
2014-06-18,27.168409,27.602219,27.125526,27.592745,27.592745,34835379,179455760.17918134,-59553056,10.830955401503589,28.0,0.16080295053865257,54.40538525942687,58.83300500283675,27.275730115384615,27.30813363159573,-41.16699499716325
2014-06-19,27.636126,27.674021,27.350409,27.669035,27.669035,49136535,227078168.61088386,-10416521,10.37999926424306,28.0,0.16485388782136567,55.42295490515641,64.98990797330639,27.31755761538462,27.334867066292343,-35.01009202669361
2014-06-20,27.766268,27.802668,27.444252,27.741835,27.741835,90166875,286637473.03995407,79750354,10.232940216830116,28.0,0.17195642970587244,56.422407667253324,70.86515422117861,27.374535769230764,27.365012839159576,-29.134845778821393
2014-06-23,27.681499,28.172651,27.636623,28.170158,28.170158,30736155,317087727.92124784,110486509,10.815591768120479,28.000000000000004,0.20972969836517308,61.84303465649633,99.80953530587439,27.46077976923077,27.424653221444053,-0.19046469412559205
2014-06-24,28.182125,28.553905,27.973698,28.153704,28.153704,44142862,300335021.562845,66343647,11.989909664293029,100.0,0.23562148778924197,61.526418764969335,75.90948683482638,27.545144307692308,27.478656982818567,-24.090513165173626
2014-06-25,28.185616,28.918604,28.183622,28.853283,28.853283,39387843,332721731.76611555,105731490,13.603328623423229,100.0,0.3090288044287277,68.83262732723044,96.77576510238727,27.64063211538462,27.580481132239417,-3.2242348976127255
2014-06-26,28.970463,29.042763,28.514214,28.721146,28.721146,34839390,325162252.0543955,70892100,15.267808251014733,100.0,0.3524791202639008,66.27264982326791,85.04174462826563,27.729292500000003,27.664974826147606,-14.958255371734367
2014-06-27,28.779985,28.914116,28.611446,28.782976,28.782976,44738493,331132410.0887897,115630593,16.813396476635415,64.0,0.38743684212605345,66.8931180821628,87.91742884158253,27.802744653846155,27.74778972791445,-12.082571158417458
2014-06-30,28.853783,28.899157,28.658817,28.685246,28.685246,26275943,310635337.83479124,89354650,18.24858554328319,64.0,0.4026140106263085,64.861973486584,83.37205251670036,27.860700923076926,27.81723093325412,-16.62794748329964
2014-07-01,28.836828,29.139996,28.753557,29.053734,29.053734,28959290,326665879.5770841,118313940,19.938988436588637,76.0,0.4393118148857482,68.71874336574275,96.16157840637551,27.91817776923077,27.908823753013074,-3.8384215936244934
2014-07-02,29.087641,29.191854,28.940044,29.037029,29.037029,21127848,321812876.40675735,97186092,21.583635391106014,80.0,0.4617246607883203,68.35246744297496,93.26610090170969,27.949601115384617,27.992394512049145,-6.733899098290301
2014-07-03,29.087641,29.170412,28.966473,29.15645,29.15645,14283107,334140293.3236051,111469199,23.110807563157863,80.0,0.4835492248340607,69.5999276094265,98.46015201888667,27.993806615384617,28.078620844489947,-1.5398479811133214
2014-07-07,29.108084,29.241219,28.900154,29.032789,29.032789,21292298,329408498.1323366,90176901,24.64225091568363,88.0,0.4852730146153803,66.66937224020796,91.12517367076666,28.036324423076923,28.14929996712032,-8.874826329233347
2014-07-08,28.803919,28.897062,28.229246,28.476318,28.476318,38190565,319476672.8920309,51986336,23.78108770916265,88.0,0.4367025363572594,55.37095469439509,63.846314186415434,28.05780388461538,28.17352352511141,-36.153685813584566
2014-07-09,28.500751,28.757048,28.390854,28.725136,28.725136,22335153,337919029.16387016,74321489,22.98143616025032,88.0,0.41352080511391875,58.73811835412281,72.70571871314404,28.10028346153846,28.214383708436493,-27.29428128685597
2014-07-10,28.218027,28.750565,28.173151,28.476816,28.476816,27134293,339324865.37391686,47187196,21.621078554798036,88.0,0.370836989409149,54.33236832075925,57.461489276096856,28.150453384615385,28.2338231374412,-42.538510723903144
2014-07-11,28.517206,28.962982,28.492773,28.879711,28.879711,32434806,360271678.8836583,79622002,20.870435349732304,52.0,0.3653089629805244,59.623982426467826,77.47046608616746,28.216656192307692,28.281666682815924,-22.52953391383254
2014-07-14,29.050243,29.180386,28.822369,29.163431,29.163431,37081529,393840987.37907344,116703531,20.65637891508099,52.0,0.37944775751102355,62.885405590937964,93.86298136283331,28.276050807692307,28.346982558162892,-6.137018637166691
2014-07-15,29.206814,29.210054,28.749069,29.158943,29.158943,32460877,419103765.1595893,84242654,20.23131351952844,52.0,0.38584295257041035,62.79899162817194,92.29674515105778,28.330612499999997,28.407127776076752,-7.703254848942223
2014-07-16,29.319504,29.339449,29.030296,29.053234,29.053234,27942506,395307718.69663405,56300148,20.13278068650668,80.0,0.37802373556485236,60.68379574475986,75.45953092605842,28.37000438461538,28.454987496367362,-24.540469073941576
2014-07-17,28.897163,28.969963,28.352657,28.607958,28.607958,60331186,384879213.4319128,-4031038,19.174859898986323,80.0,0.33206901300419744,52.64072657042411,37.28095220946963,28.395281153846156,28.466318644784597,-62.71904779053037
2014-07-18,29.568819,29.758299,29.020325,29.672535,29.672535,80283816,446502585.58043814,76252778,18.943737590683433,88.0,0.3772038598526457,64.69038059017836,94.5895272870419,28.464782653846157,28.55566800443018,-5.410472712958099
2014-07-21,29.506491,29.638626,29.181532,29.392801,29.392801,41242922,443384648.3232611,35009856,18.72912401868789,88.0,0.38595233690082864,60.34559844942054,76.94234229232839,28.53788953846154,28.617677855953872,-23.057657707671602
2014-07-22,29.455132,29.900408,29.449146,29.655581,29.655581,33983045,440493474.0971135,68992901,18.98373207776515,96.0,0.40937074670324236,62.86851210136124,85.82567620220978,28.620317076923076,28.69455957032766,-14.174323797790226
2014-07-23,29.580288,29.810656,29.543886,29.717411,29.717411,24663528,447915553.1458816,93656429,19.22015384690832,96.0,0.42798561766862875,63.45762613025375,89.40534037494128,28.71946796153846,28.77032634289598,-10.594659625058721
2014-07-24,29.740847,29.892929,29.507486,29.586271,29.586271,20702684,435676174.7912818,72953745,19.588520911235374,92.0,0.4272312787649426,61.23840045975961,81.81295545480498,28.816010615384617,28.83076668786665,-18.18704454519502
2014-07-25,29.439175,29.511974,29.271135,29.370363,29.370363,18649061,432394301.2061774,54304684,19.250032414290168,88.0,0.40454810978040356,57.66293468103174,69.31290479644903,28.884380538461535,28.870736785061712,-30.687095203550964
2014-07-28,29.322994,29.543886,29.157598,29.449146,29.449146,19736037,442449518.9967791,74040721,18.62301931396984,84.0,0.388450845079916,58.61250341956292,73.87406737966612,28.952846346153844,28.91358191209418,-26.125932620333877
2014-07-29,29.356901,29.40427,29.095867,29.200331,29.200331,26997920,433741373.8360639,47042801,17.868519945674176,80.0,0.3515637477210767,54.45820484611204,59.46885726906876,29.008942346153848,28.93482258527239,-40.53114273093124
2014-07-30,29.247202,29.394299,29.12005,29.290583,29.290583,20329662,438694416.6032356,67372463,17.167913389399633,76.0,0.3258567654858524,55.68514045792888,60.59928244271863,29.052035615384618,28.961175208585544,-39.40071755728137
2014-07-31,28.950516,29.102598,28.421967,28.501747,28.501747,42055146,406498238.37837404,25317317,17.084028694767042,32.0,0.23907541170627766,44.42065920427159,9.632686394646248,29.065421884615382,28.92714348943106,-90.36731360535376
2014-08-01,28.441914,28.719152,28.065447,28.226006,28.226006,39105069,386602662.2645263,-13787752,17.660624984474726,-32.0,0.14636338339798982,41.27737765412943,8.749995231506436,29.041295846153844,28.875207379102832,-91.25000476849357
2014-08-04,28.3741,28.688734,28.127775,28.579037,28.579037,28546159,403984269.11785245,14758407,18.196035824917576,-32.0,0.10021981269037994,46.49736703144826,27.989150723094426,29.035830115384613,28.85326883250262,-72.01084927690557
2014-08-05,28.424461,28.520697,28.053478,28.176142,28.176142,31024946,389249944.7584279,-16266539,18.830512612654385,-40.0,0.030785564270573218,41.91778139577097,6.641507799429339,29.012490346153847,28.803111289354277,-93.35849220057067
2014-08-06,28.012093,28.456873,27.923336,28.241163,28.241163,26687069,394357750.6370698,10420530,19.660373465318518,-43.99999999999999,-0.018778460152592658,42.89528029641497,16.075641150145326,28.99541023076923,28.76148549014285,-83.92435884985467
2014-08-07,28.322241,28.416483,27.978186,28.090876,28.090876,22218835,383564230.0524093,-11798305,20.430958542792357,-44.0,-0.06938538002655292,41.17058426153557,8.474147628412242,28.958377230769234,28.711810713095232,-91.52585237158776
2014-08-08,28.100849,28.434433,27.940788,28.360636,28.360636,29895854,404521578.2936637,18097549,21.221854270596427,-44.0,-0.0867246434032829,45.41318017603318,22.118567255011477,28.932362115384613,28.685797771384475,-77.88143274498852
2014-08-11,28.421469,28.4464,28.222515,28.316257,28.316257,24294518,400571582.7615019,-6196969,21.907416277261326,-44.0,-0.10286142646592822,44.8402654941338,19.94934994184084,28.900046999999997,28.65842438091155,-80.05065005815916
2014-08-12,28.148718,28.217529,27.967216,28.059464,28.059464,30840441,392462434.19431967,-37037410,23.07132523536353,-44.0,-0.13481690691141068,41.57212573219651,6.911478665896933,28.862611423076924,28.614056945288475,-93.08852133410308
2014-08-13,28.287836,28.671284,28.210049,28.660313,28.660313,28784812,419877887.09341866,-8252598,22.47776589866902,-44.0,-0.11038590262326764,50.637688671225156,45.47696769615247,28.869688153846155,28.61748331971155,-54.52303230384753
2014-08-14,28.730122,28.815886,28.465847,28.653831,28.653831,19709966,421337895.00229174,-27962564,21.475694589309793,-44.0,-0.09050392601434254,50.54657264478739,45.076980037641576,28.866945653846155,28.62017574047366,-54.923019962358424
2014-08-15,28.81389,28.889683,28.447895,28.595491,28.595491,30383189,411256014.1575335,-58345753,20.317883092031725,-44.0,-0.07854939817527651,49.680118463570516,45.387235352824604,28.871510076923077,28.618347241179315,-54.612764647175396
2014-08-18,28.726631,29.145481,28.721146,29.028303,29.028303,25682318,422754243.3663474,-32663435,19.232767114692738,-44.0,-0.033761851883411964,55.741457153932274,75.11861277272108,28.877225153846155,28.64871433442529,-24.88138722727892
2014-08-19,29.169914,29.286594,29.12005,29.262659,29.262659,19573592,436701767.4861472,-13089843,18.60061054846415,-44.0,0.02040792201344388,58.646188381721906,98.24427951275536,28.881041615384618,28.694191717060452,-1.755720487244642
2014-08-20,29.213795,29.254681,29.048746,29.144484,29.144484,20734771,435245948.64093333,-33824614,17.782859148554273,-44.0,0.05318899361908791,56.62794354376582,89.575707606337,28.880485500000002,28.7275467009819,-10.42429239366299
2014-08-21,29.111076,29.144981,28.977442,29.088636,29.088636,18296094,441235732.86911905,-52120708,16.78966294826981,-44.00000000000001,0.07381091588995758,55.65319883039727,85.47905092066215,28.881847115384616,28.754294056464722,-14.52094907933785
2014-08-22,29.099607,29.181683,28.952511,29.048248,29.048248,15781209,438639778.66493183,-67901917,15.981759270001652,-44.0,0.08590470780144344,54.91699801705787,82.51644222883712,28.898781346153843,28.776068422652518,-17.48355777116288
2014-08-25,29.155952,29.169914,28.870735,28.930571,28.930571,27228551,422302684.4692933,-95130468,14.942040413727836,-44.0,0.08501359083406612,52.728358015344526,73.88440045831383,28.87024426923077,28.78751305801159,-26.115599541686162
2014-08-26,28.983425,29.010351,28.750067,28.81389,28.81389,32793789,405591313.10039616,-127924257,14.189856049902414,-44.0,0.07403872038003456,50.576043981222654,64.87576961315372,28.847978461538464,28.78946690556629,-35.12423038684627
2014-08-27,28.784472,28.845304,28.427103,28.47183,28.47183,34067276,378811093.1029024,-161991533,14.46285483064972,-36.0,0.0373095914444832,44.80240587788967,39.459030499195244,28.802449576923078,28.765938245894713,-60.540969500804756
2014-08-28,28.400028,28.584023,28.277365,28.382076,28.382076,25858801,370611710.16152835,-187850334,15.104794547358024,-36.0,0.0009481645981743725,43.40232257219345,31.44360448635651,28.75109053846154,28.737504005458067,-68.5563955136435
2014-08-29,28.488285,28.523687,28.27582,28.501747,28.501747,21675347,388449861.30100685,-166174987,15.70490841254014,-28.0,-0.018004533524692334,45.832891732803326,40.513863350760815,28.70937807692308,28.720040523572283,-59.486136649239185
2014-09-02,28.514214,28.812395,28.481304,28.787464,28.787464,31568434,415264118.1832116,-134606553,15.12343430873833,-28.000000000000004,-0.009856094350020328,51.219188066171476,53.63593718794837,28.686958884615386,28.72503485515952,-46.36406281205163
2014-09-03,28.920597,29.069689,28.671284,28.817881,28.817881,24302540,408846290.75649756,-110304013,14.349781661737167,-24.0,-0.0009332420695820076,51.76903965067611,53.62830860311005,28.66267946153846,28.731912347369928,-46.37169139688995
2014-09-04,28.920597,29.219776,28.881704,29.019327,29.019327,29163850,403426593.0586701,-81140163,14.074111459523285,-20.0,0.02213799823070417,55.357987707641904,73.55818412424539,28.65571776923077,28.75320232163882,-26.44181587575462
2014-09-05,29.119055,29.247202,29.017832,29.223766,29.223766,32647388,429402453.0892931,-48492775,13.898587841313795,36.0,0.05626999563713042,58.71550331921084,93.7841693593227,28.653147884615386,28.788058890406315,-6.2158306406773
2014-09-08,29.249695,29.507486,29.234735,29.405268,29.405268,28620362,436570896.211518,-19872413,14.455021421266238,88.0,0.09684912755798081,61.485033801007624,91.70083447947735,28.68789869230769,28.83377808370955,-8.299165520522653
2014-09-09,29.36438,29.369366,28.920597,28.970961,28.970961,25744488,416604861.6859423,-45616901,13.850375561687995,88.0,0.09289262832151834,52.42272520766515,56.43908332291378,28.716550807692308,28.843939781212548,-43.56091667708622
2014-09-10,28.995394,29.095119,28.768017,29.075174,29.075174,19547521,433768567.8126306,-26069380,12.911784388413768,88.0,0.09704748928074025,54.16832589484773,64.90022457386992,28.735633000000004,28.861068241863467,-35.09977542613009
2014-09-11,28.938549,29.010851,28.73411,28.987913,28.987913,24420864,454141128.3199642,-50490244,12.145928778642235,88.0,0.09223577647920678,52.43357243954806,57.815430481965,28.76685496153846,28.870464149873584,-42.184569518035
2014-09-12,28.970463,29.002375,28.644358,28.702198,28.702198,32033708,432457932.5622318,-82523952,11.719483609129167,80.0,0.06462271629020933,47.11330506883253,34.61798896778831,28.784587076923078,28.85799999062369,-65.3820110322117
2014-09-15,28.568565,28.668791,28.332712,28.576544,28.576544,31951483,446869322.59420323,-114475435,12.209701207469687,80.0,0.03222843020150634,44.95302104524801,24.416034866595226,28.80326661538462,28.837151398725638,-75.58396513340477
2014-09-16,28.559589,28.995394,28.554604,28.918104,28.918104,29607064,466093528.6502388,-84868371,11.564959781729128,72.0,0.033727967537124925,51.46744220606136,52.14757897027277,28.824707692307694,28.843147887708923,-47.85242102972723
2014-09-17,28.921097,29.295568,28.859516,29.158445,29.158445,33856699,478656748.262565,-51011672,11.35093712755996,72.0,0.05369095584808292,55.46157703180496,71.66106720490787,28.857099538461544,28.866503229360113,-28.338932795092138
2014-09-18,29.26964,29.396292,29.169914,29.38283,29.38283,28891103,504111722.0575538,-22120569,11.410366207318814,68.0,0.0866192691304768,58.86525881520161,89.87907435944472,28.90799823076923,28.90474965681492,-10.12092564055528
2014-09-19,29.494024,29.742342,29.394299,29.722397,29.722397,74732617,570279063.8124548,52612048,12.265915619630155,56.0,0.13851865681177955,63.42103022252317,98.58508970439053,28.948847615384615,28.96531612668048,-1.4149102956094777
2014-09-22,29.609707,29.616138,29.093124,29.28809,29.28809,33790518,561680996.2340039,18821530,12.118925623939978,56.0,0.14295643739613695,55.0267568674894,67.7750899172123,28.973242192307687,28.989225302481927,-32.22491008278771
2014-09-23,29.262161,29.262161,28.970463,28.976944,28.976944,29428575,533560120.2554235,-10607045,11.630132803076638,56.0,0.1199834342938999,49.92819432094208,45.70220554329851,28.98791346153846,28.988315576372152,-54.29779445670149
2014-09-24,28.993399,29.40078,28.946527,29.319004,29.319004,34562632,555678613.000726,23955587,11.525740585211478,56.0,0.12790414771187386,54.8779669093311,69.96814766995587,28.99909426923077,29.0128110151594,-30.031852330044135
2014-09-25,29.297066,29.318506,28.630396,28.674274,28.674274,38519466,522071609.0464686,-14563879,10.86204605715824,56.0,0.08122078474633199,45.706650791706174,24.23061370714299,28.976464076923076,28.987734199221666,-75.769386292857
2014-09-26,28.724138,28.883202,28.654329,28.775995,28.775995,28873054,523895657.70133865,14309175,10.245758281108804,56.0,0.05183440310955589,47.20577458595201,31.446762625653612,28.96229142307692,28.972049814094134,-68.5532373743464
2014-09-29,28.509228,28.830345,28.480307,28.739098,28.739098,25648224,536172056.3833557,-11339049,10.14174324970702,56.0,0.025276828857268896,46.70205140111223,28.829267254527622,28.94884765384615,28.954794124161236,-71.17073274547238
2014-09-30,28.767519,28.913118,28.564077,28.78896,28.78896,32434806,545531976.3765653,21095757,9.787120755383635,56.0,0.00815915297462766,47.517089749301576,32.36650752325069,28.93887503846154,28.942510114964108,-67.63349247674931
2014-10-01,28.721645,28.799931,28.272877,28.335705,28.335705,28909153,523515112.4576993,-7813396,10.214715961010741,-32.0,-0.04150220736618593,41.32994880538494,4.275569680121655,28.915995576923077,28.89756158792973,-95.72443031987835
2014-10-02,28.287836,28.517206,28.088882,28.425957,28.425957,23568530,537041689.1981573,15755134,11.036914047687471,-36.0,-0.0727381311959796,42.92360853316391,20.38603897282056,28.901075076923078,28.862627914749748,-79.61396102717943
2014-10-03,28.574051,28.782228,28.546625,28.685246,28.685246,22834521,541077319.5590568,38589655,10.941454075177623,-36.0,-0.07569777372705744,47.3484924607376,36.06763997919502,28.90928338461538,28.84948851365717,-63.93236002080498
2014-10-06,28.860764,28.970463,28.64336,28.788462,28.788462,24292512,538336991.8938013,62882167,10.302319447397823,-35.99999999999999,-0.06892017430010355,49.04206880221761,42.31006495470092,28.924913615384618,28.844968031164047,-57.68993504529908
2014-10-07,28.641365,28.684746,28.109823,28.109823,28.109823,38226664,500110327.89380133,24655503,10.944978999010791,-36.0,-0.11696111863169634,39.94446449372305,1.2664957120218816,28.909839615384612,28.790512843670417,-98.73350428797812
2014-10-08,28.201075,28.615437,27.79818,28.546625,28.546625,39817018,533222261.34239084,64472521,12.118000932273958,-52.0,-0.11842254090138127,46.78685248493903,38.49704911421988,28.900576576923076,28.772447077472606,-61.50295088578012
2014-10-09,28.480806,28.496264,27.876465,27.967216,27.967216,50496258,497513332.4918668,13976263,13.207235584589755,-52.0,-0.16443864620211812,40.23785561483197,9.298124599138257,28.867858692307696,28.712800330993154,-90.70187540086174
2014-10-10,27.809649,28.179134,27.128019,27.14996,27.14996,61638766,438447864.68436927,-47662503,15.348641488900796,-60.0,-0.2638114164952654,33.18251725703996,0.96538967361732,28.795959961538458,28.597034380549218,-99.03461032638269
2014-10-13,27.174891,27.399775,26.58202,26.587503,26.587503,51633371,387506891.21955544,-99295874,17.930018010952356,-64.0,-0.38352954232043146,29.366182958898037,0.1945181569201237,28.69456523076923,28.44818020421224,-99.80548184307987
2014-10-14,26.871225,27.28459,26.585508,26.823357,26.823357,44451708,373302834.5568578,-54844166,20.32701049571452,-64.0,-0.454140523610004,32.85355826580323,8.819230209838512,28.595260961538465,28.327822929826148,-91.18076979016149
2014-10-15,26.477804,26.56706,25.844046,26.42894,26.42894,74387672,419269410.26649547,-129231838,23.201011277922767,-72.0,-0.5357505913028611,30.17086603678503,18.708124987805594,28.497490923076928,28.187164935024214,-81.29187501219441
2014-10-16,25.878948,26.399021,25.679497,26.153694,26.153694,74171079,442862139.4190047,-203402917,25.990277966789325,-76.0,-0.6155416290530695,28.42640811283208,14.4090519318644,28.385126307692307,28.036537458355753,-85.59094806813559
2014-10-17,26.290319,26.476309,25.356882,25.488522,25.488522,110787334,358131072.86254513,-314190251,28.80376240552238,-80.0,-0.7241034092955054,24.708365477761774,3.642923736869351,28.25053434615385,27.84779557255162,-96.35707626313065
2014-10-20,25.402758,26.016573,25.335442,25.970697,25.970697,52150788,403256869.9275033,-262039463,31.43086407738851,-84.0,-0.7624429418581471,31.683803301824668,17.47596506320049,28.145476615384613,27.708751233844094,-82.52403493679951
2014-10-21,26.187601,26.267384,25.884434,26.254917,26.254917,46725935,446940463.98667526,-215313528,33.05253563318157,-84.0,-0.7611194082037187,35.47839075615066,25.294902010194683,28.056183269230765,27.6010598091149,-74.70509798980532
2014-10-22,26.421959,26.916101,26.367607,26.562572,26.562572,58385859,430061709.8955164,-156927669,32.7804200601627,-84.0,-0.7268664469849639,39.40206324670145,33.75853949674567,27.965585884615386,27.524134786217502,-66.24146050325433
2014-10-23,26.892168,27.286085,26.719143,27.124531,27.124531,46976621,450265712.07724595,-109951048,31.694697027740094,-84.0,-0.6469180648678758,45.87645707582535,49.218120060379334,27.88735842307692,27.494534505756945,-50.781879939620666
2014-10-24,27.143478,27.169407,26.71615,26.915106,26.915106,39462046,445447194.2476927,-149413094,30.691150084810157,-84.0,-0.5936144257178171,43.99017956385053,47.16394809190211,27.792445961538462,27.451613875700875,-52.836051908097886
2014-10-27,26.777981,27.145971,26.777981,26.96447,26.96447,23706909,445768534.67023665,-125706185,29.759285066375217,-80.0,-0.5411496095664283,44.56872449257117,49.66556351457848,27.686371846153847,27.415529144167476,-50.33443648542152
2014-10-28,27.075665,27.373844,27.006853,27.369856,27.369856,25419598,470635675.7608084,-100286587,28.348935372756063,-72.0,-0.46153926517925825,49.208598554634804,64.36344722986611,27.61259361538462,27.41214594830322,-35.636552770133896
2014-10-29,27.424706,27.633633,27.274118,27.391296,27.391296,35410955,458307957.2599252,-64875632,26.45970239847168,-72.0,-0.39219646812173536,49.4495983365988,72.2952415381131,27.551607153846156,27.410601507688167,-27.70475846188689
2014-10-30,27.372349,27.564322,27.101093,27.440163,27.440163,29113713,471815007.0658374,-35761919,25.05750150653134,-68.0,-0.3295003682262809,50.03156456783829,91.58163964613901,27.479344038461537,27.412791247859413,-8.41836035386099
2014-10-31,27.890924,27.901896,27.661554,27.877462,27.877462,40701440,504240748.39511013,4939521,23.50856315264516,-40.0,-0.24174025157626744,55.02181758170535,99.047947089642,27.448697423076926,27.447211303573532,-0.9520529103580037
2014-11-03,27.698954,27.818624,27.585764,27.684992,27.684992,27645693,500156223.6936931,-22706172,21.903632271593562,-40.0,-0.1855811829578613,52.53499525922252,91.54849453759937,27.40673576923077,27.46482468849401,-8.451505462400632
2014-11-04,27.574295,27.698954,27.389801,27.629642,27.629642,24884132,513882327.4217113,-47590304,20.691534450249783,-40.00000000000001,-0.1438824120122959,51.80979004338398,89.39182233540909,27.364064384615386,27.47703337823519,-10.608177664590917
2014-11-05,27.763775,27.763775,27.128019,27.221264,27.221264,40645286,485159759.2350552,-88235590,20.098310514665787,-40.0,-0.1421499115619298,46.6887957712463,73.47967273132505,27.30376838461539,27.458087498365916,-26.520327268674958
2014-11-06,27.200321,27.269382,26.974442,27.027796,27.027796,26665008,468142034.32200146,-114900598,19.84276989345605,-40.0,-0.1546059421314503,44.447391359484556,65.94133384038825,27.253464192307693,27.426214054042514,-34.05866615961175
2014-11-07,27.235723,27.235723,26.859756,26.976437,26.976437,32675465,455748168.1413925,-147576063,19.823493085799857,-40.0,-0.16670006360749312,43.845627720440376,54.12756225396071,27.197713423076927,27.39289723522455,-45.87243774603929
2014-11-10,26.998875,27.404263,26.976934,27.299549,27.299549,22692131,467319201.3196485,-124883932,19.338417741620695,-40.0,-0.1485004828424863,48.56375978474815,60.74096861803733,27.144417384615387,27.385982551133843,-39.25903138196267
2014-11-11,27.349413,27.521441,27.240211,27.439165,27.439165,19310873,475330985.41058475,-105573059,18.570342480661413,-36.0,-0.12141178015944831,50.49913892948226,60.97553776272483,27.092521346153845,27.389921991790594,-39.02446223727517
2014-11-12,27.444153,27.447641,27.183867,27.290573,27.290573,22593862,471017171.01627725,-128166921,17.98750231349168,-32.0,-0.11065832044869595,48.411339103440795,48.444017521458946,27.06101173076923,27.382562807213514,-51.555982478541054
2014-11-13,27.414734,27.414734,27.099598,27.194338,27.194338,26787343,460336098.8061582,-154954264,17.645675359110808,-28.000000000000004,-0.10864904779270645,47.05449999494721,37.0452391862372,27.00900069230769,27.3686202289014,-62.9547608137628
2014-11-14,27.259159,27.259159,27.033279,27.145472,27.145472,25790614,460165516.296348,-180744878,17.487769586261212,-24.0,-0.10973480798767099,46.344210859276146,27.41627804325722,26.977395153846153,27.35209073046426,-72.58372195674278
2014-11-17,27.104584,27.115055,26.629938,26.752052,26.752052,34520517,443024058.00976336,-215265395,18.21219371205097,36.00000000000001,-0.14071886730865302,40.98071590159629,9.600474229494974,26.962091,27.307643417096536,-90.39952577050502
2014-11-18,26.801416,27.022808,26.635372,26.678255,26.678255,39253475,412460053.10766333,-254518870,18.88487325742717,36.0,-0.16927743381587845,40.044529060844184,3.798631715827156,26.965581461538463,27.261022052867162,-96.20136828417284
2014-11-19,26.67676,26.838314,26.431433,26.775988,26.775988,27844237,431773933.982595,-226674633,19.912551416919836,36.0,-0.18192692684784717,41.936326808259224,23.431735446590817,26.963759576923074,27.22509360450663,-76.56826455340918
2014-11-20,26.489773,26.682243,26.481297,26.668282,26.668282,31267610,458696823.47848,-257942243,20.8668239935916,36.0,-0.19835618860398085,40.42257991664997,17.07400062428337,26.97296503846154,27.1838483004691,-82.92599937571663
2014-11-21,27.006353,27.032782,26.754545,26.801416,26.801416,44485801,429198921.13085884,-213456442,20.47237930625159,36.0,-0.19834727187612344,43.15404834019523,27.769371527730954,26.997877423076922,27.155519981915837,-72.23062847226905
2014-11-24,26.808895,27.060705,26.707674,26.889673,26.889673,34127440,430259098.94663113,-179329002,20.22101275469078,36.0,-0.1890394736206602,44.95570354456003,34.39357162049983,27.051767846153844,27.135827612885034,-65.60642837950017
2014-11-25,26.876211,27.124531,26.856365,26.979927,26.979927,35798014,427450160.41382664,-143530988,19.76111971207208,32.0,-0.17239299380660356,46.81216705009499,50.32018113628534,27.090584384615383,27.124279419337995,-49.67981886371466
2014-11-26,26.969954,27.003363,26.77858,26.944525,26.944525,30459397,441963778.58992934,-173990385,19.545675231209028,28.000000000000004,-0.16021037863825072,46.15460737169589,47.07231506557749,27.11710776923077,27.11096427716481,-52.92768493442251
2014-11-28,26.956989,27.025801,26.75654,27.017324,27.017324,22966883,463484553.4109427,-151023502,19.257551623642275,-52.0,-0.14303250773838982,47.77904680093935,53.751073386617314,27.13459823076923,27.10402796033779,-46.248926613382686
2014-12-01,26.871225,26.996382,26.520189,26.616922,26.616922,42307838,438365393.5026156,-193331340,19.63565080762826,-52.0,-0.1598849620733951,40.535574345851664,17.01721455255377,27.115074807692313,27.067946037349806,-82.98278544744623
2014-12-02,26.602463,26.701691,26.417471,26.614429,26.614429,30533600,450149975.1140436,-223864940,20.243726377955685,-84.0,-0.17146527288203472,40.49441057638038,19.118980362464626,27.10351030769231,27.034352182731304,-80.88101963753537
2014-12-03,26.499247,26.726423,26.390545,26.493263,26.493263,25559983,440223468.16066754,-249424923,20.876537258608444,-88.0,-0.1882498095796059,38.45066943448737,10.029203594258426,27.08538696153846,26.99427150252899,-89.97079640574157
2014-12-04,26.485285,26.79344,26.357136,26.791943,26.791943,27842232,467874641.53501195,-221582691,21.147120925907444,-92.0,-0.17542846585741856,45.72275021902338,48.20353804725593,27.06315953846154,26.97928420604536,-51.79646195274407
2014-12-05,26.477306,26.571548,26.142227,26.191092,26.191092,51312493,428242848.8522344,-272895184,21.969445963514268,-96.0,-0.2113152026465066,36.40447621259056,4.974529269961508,27.016997846153842,26.92089959819015,-95.02547073003849
2014-12-08,26.284336,26.477306,26.117794,26.276857,26.276857,46587556,422879821.7693666,-226307628,22.79473069147732,-100.0,-0.2301817889895581,38.33627062500543,15.79985636765109,26.972255307692308,26.87319273906495,-84.20014363234891
2014-12-09,26.035519,26.63637,25.953745,26.595482,26.595482,37426473,455822739.0014883,-188881155,23.96408097377729,-100.0,-0.21692276929834264,45.018280521617086,54.81249348728113,26.92294838461538,26.85262157320829,-45.18750651271887
2014-12-10,26.581022,26.743076,26.206051,26.230984,26.230984,34245764,424756900.08435047,-223126919,24.49207614340336,-92.0,-0.2331393576394305,39.71621419396284,23.679733102377213,26.867024999999998,26.80657434556323,-76.32026689762279
2014-12-11,26.317745,26.622908,26.282841,26.344671,26.344671,32216207,404255608.54989123,-190910712,24.982357372341852,-92.0,-0.23411875468570287,42.01028880848063,33.390047369886595,26.817603038461534,26.772359282928917,-66.60995263011341
2014-12-12,26.103832,26.35265,25.861996,25.861996,25.861996,39891221,364364387.54989123,-230801933,26.439113231775675,-88.0,-0.27072205716143216,35.78405706764056,0.0,26.7653235,26.704924965674923,-100.0
2014-12-15,26.065437,26.083387,25.593233,25.619661,25.619661,56268061,314164020.8504905,-287069994,28.27239714142809,-92.0,-0.3156462735494081,33.12928240507662,1.7258561037759623,26.711164461538463,26.624535042291594,-98.27414389622403
2014-12-16,25.507969,25.582264,24.383057,24.701681,24.701681,79285081,277010331.0924429,-366355075,31.254000347703798,-96.0,-0.4204753744397145,25.432232108221527,12.056559394326493,26.623673846153846,26.482101409529253,-87.9434406056735
2014-12-17,24.781961,25.280592,24.772488,25.175381,25.175381,57663883,310793769.16655046,-308691192,34.022631896388376,-96.0,-0.460026660043912,33.95893642586255,29.98111054267839,26.541975076923077,26.385307305119678,-70.0188894573216
2014-12-18,25.577278,25.623152,25.165907,25.485031,25.485031,58534266,333964886.9454169,-250156926,35.26571372444106,-92.0,-0.46107024095838156,38.879022852761445,42.167506911692904,26.46681607692308,26.318620171407108,-57.8324930883071
2014-12-19,25.505474,25.815125,25.276154,25.746813,25.746813,73804074,389060333.19703007,-176352852,35.75046061182202,-88.0,-0.4357506050257527,42.76142791227107,56.578394387945764,26.407440692307695,26.276264084636214,-43.42160561205423
2014-12-22,25.733349,26.250929,25.733349,26.171646,26.171646,54475152,426846457.5065628,-121877700,34.866875865200136,-84.0,-0.3770576525996141,48.48073434313578,74.20351869391706,26.368106384615388,26.268514596885385,-25.796481306082953
2014-12-23,26.277855,26.654819,26.242451,26.456863,26.456863,43952341,428600424.16618705,-77925359,33.024336586759055,-56.0,-0.30402383913069997,51.95187987326433,86.0363684941355,26.341621423076923,26.28246633044943,-13.963631505864502
2014-12-24,26.452873,26.515154,26.278851,26.366112,26.366112,14118657,424909126.34890604,-92044016,31.313407256778053,-56.0,-0.2505783517789233,50.77954242933706,84.02707774810297,26.326777576923078,26.288662305971695,-15.97292225189703
2014-12-26,26.366112,26.639362,26.293312,26.628391,26.628391,20810980,444400544.0799856,-71233036,29.415231811536888,-56.0,-0.1849269716397366,54.00963527787889,95.14050522474615,26.324859730769234,26.313827394418237,-4.859494775253845
2014-12-29,26.536644,26.700693,26.427992,26.443897,26.443897,45570772,404145507.10596645,-116803808,27.49788940437769,-56.0,-0.14610074535815798,51.451795676930054,87.32302578919919,26.312087000000002,26.323462180016886,-12.676974210800806
2014-12-30,26.332205,26.484785,26.284336,26.448385,26.448385,17525986,415306324.0065944,-99277822,26.06260112841726,-56.0,-0.11365835444970429,51.5119534892852,87.5131937497113,26.303629423076924,26.332715722237857,-12.486806250288687
2014-12-31,26.489773,26.557089,26.218018,26.247936,26.247936,27364925,392770498.6709713,-126642747,24.52902208677507,-56.0,-0.10293550853054612,48.61447517421695,80.46470627829385,26.282341730769232,26.32643574281283,-19.53529372170616
2015-01-02,26.378078,26.49077,26.133251,26.168653,26.168653,28951268,369552815.6817591,-155594015,23.322996006760814,-56.00000000000001,-0.0996859339952465,47.47696321538555,77.04384985390277,26.25461019230769,26.3147481322341,-22.95615014609723
2015-01-05,26.091366,26.14472,25.582764,25.623152,25.623152,41196796,334277679.72933584,-196790811,23.40919809520342,-48.0,-0.1395196982881579,40.46182824676148,53.506892367912826,26.20242653846154,26.26351878910565,-46.493107632087174
2015-01-06,25.679497,25.738087,24.983908,25.029282,25.029282,57998800,283257693.9132363,-254789611,24.440205227150468,-48.0,-0.21651276491892446,34.48742670164067,27.882937614016935,26.128763346153846,26.172093841764493,-72.11706238598308
2015-01-07,25.280592,25.292759,24.914099,24.986401,24.986401,41301082,257728812.99475548,-296090693,25.493760516896536,-44.0,-0.27778829273596983,34.09594645096158,11.093893024859979,26.050650923076923,26.08426474237453,-88.90610697514002
2015-01-08,24.831326,25.105074,24.482782,25.065184,25.065184,67071641,316201636.2066753,-229019052,27.01933839685501,-32.0,-0.31634582258994115,35.543609019960826,26.259033838598487,25.990968692307693,26.008777279976417,-73.7409661614015
2015-01-09,25.1689,25.176876,24.671764,24.740576,24.740576,41427428,286061622.3862475,-270446480,28.204241689506805,-32.0,-0.36884428817251447,32.38689049725953,11.623279743867108,25.918897423076924,25.91483644442261,-88.37672025613288
2015-01-12,24.679243,24.730902,24.311253,24.56007,24.56007,46535413,294709478.5298459,-316981893,29.734281814673242,-100.0,-0.4201715499460654,30.751370286478434,10.41319304941739,25.844543846153847,25.814483374465375,-89.58680695058261
2015-01-13,24.873709,25.080141,24.552092,24.741074,24.741074,47409807,281234401.62676525,-269572086,30.084554351621883,-84.0,-0.44115787127923767,34.33248675763487,17.98835710459356,25.765664269230765,25.734971568949423,-82.01164289540644
2015-01-14,24.664783,25.092607,24.582508,24.974932,24.974932,44714427,305318440.4188876,-224857659,30.372921328730296,-84.0,-0.43391736666814396,38.74037275858843,27.775503883755114,25.71888888461539,25.678672341619837,-72.2244961162449
2015-01-15,25.209288,25.214773,24.819857,25.020805,25.020805,54316718,306278469.1126856,-170540941,30.267983041113897,-84.0,-0.41964029477434295,39.59687554999842,29.695326101513263,25.67057919230769,25.629941427425777,-70.30467389848674
2015-01-16,24.932049,25.33993,24.931549,25.334444,25.334444,45965854,351009355.3984977,-124575087,29.791598742722062,-84.0,-0.37865269377749655,45.23477010212936,42.82137237176914,25.62207773076923,25.608052729097942,-57.178627628230856
2015-01-20,25.480045,25.554838,25.231527,25.275606,25.275606,44640224,318541290.3024385,-169215311,28.724864174898066,-36.0,-0.3469184001899137,44.39757000409526,42.93960022014069,25.585332423076924,25.583427045461058,-57.06039977985931
2015-01-21,25.293058,25.892912,25.240702,25.831081,25.831081,45374234,355312361.9392306,-123841077,26.856534851263778,-36.0,-0.2737904676048828,53.20326665498544,67.6731515569258,25.565578961538463,25.601771782834312,-32.326848443074205
2015-01-22,26.002609,26.743076,25.913855,26.646341,26.646341,53538588,396359574.7565472,-70302489,26.400697845654644,28.0,-0.14834139828493065,62.572034356654946,96.02212003093979,25.595746076923074,25.67914728040214,-3.977879969060207
2015-01-23,26.706179,27.034277,26.577032,26.92358,26.92358,45634948,419898483.0458629,-24667541,26.41213316519107,32.0,-0.026248658523886803,65.12872198246177,95.93477692447813,25.645896807692306,25.771327481853834,-4.065223075521858
2015-01-26,26.852776,26.876211,26.41099,26.687229,26.687229,30874534,425689320.54726076,-55542075,26.01699789334095,32.0,0.0508529656025587,61.28523756130731,87.25505173659867,25.72226403846154,25.839172038753553,-12.744948263401316
2015-01-27,26.425947,26.462349,25.83856,25.8605,25.8605,38080263,390287786.9580708,-93622338,24.41678077728471,32.0,0.044730808258862,50.139202556173004,56.89435715586782,25.74861476923077,25.840751887734772,-43.10564284413218
2015-01-28,26.067432,26.077904,25.430182,25.430182,25.430182,33676205,356611581.9580708,-127298543,23.14645995124602,31.999999999999993,0.005097131613414518,45.50054655974656,41.09141160709558,25.746505192307698,25.81033930345812,-58.90858839290442
2015-01-29,25.480045,25.484531,24.991386,25.463091,25.463091,83727244,433058565.1367702,-43571299,22.65165198872992,32.0,-0.023387761845135913,45.91266324461221,42.29995769409298,25.735592807692306,25.78461720690567,-57.70004230590701
2015-01-30,25.72238,26.919592,25.705425,26.652824,26.652824,112127002,495914097.7762353,68555703,22.079922360468704,32.0,0.04946901691918981,58.214570026179786,85.99156672875448,25.754099653846154,25.848928821208954,-14.008433271245522
2015-02-02,26.513706,26.577032,25.85651,26.351652,26.351652,56996054,517253306.7374443,11559649,21.549030562797572,32.0,0.08196167245341712,54.81572203459709,72.4990280740558,25.750053076923074,25.886167575193475,-27.500971925944185
2015-02-03,26.327717,26.596977,26.091366,26.389547,26.389547,40773638,524571676.8325135,52333287,21.082047869904304,32.0,0.10950780801494986,55.17038598661152,73.70347695888155,25.750954423076923,25.92345493999396,-26.29652304111845
2015-02-04,26.389547,26.560678,25.99214,26.066435,26.066435,33273101,499994652.5724851,19060186,20.464991152214814,32.0,0.10406626968834587,51.461304673885515,56.29365702983171,25.72934073076923,25.934046055549963,-43.70634297016829
2015-02-05,26.117794,26.35265,26.033026,26.306774,26.306774,36995292,526369991.02837086,56055478,19.892009914360283,32.0,0.11778935766962917,53.94171722038997,65.40194452159295,25.72406676923077,25.96165553291663,-34.59805547840705
2015-02-06,26.309767,26.786457,26.248434,26.477306,26.477306,35270570,521107230.72067016,91326048,19.995991436567717,31.999999999999996,0.1408024282228375,55.67262585794226,72.73613717031401,25.72517911538462,25.999851863811692,-27.263862829685994
2015-02-09,26.327717,26.52717,26.228989,26.319241,26.319241,25355423,511100724.22840244,65970625,20.050201625133116,32.00000000000001,0.14461885183890288,53.659693842635306,64.9988178517602,25.727921615384616,26.023510318344158,-35.0011821482398
2015-02-10,26.392538,26.81139,26.273865,26.773493,26.773493,34997823,541163660.4855309,100968448,20.504733449899856,32.0,0.1821974760185725,58.32334514152332,87.23456121741194,25.751184692307692,26.079064591059403,-12.765438782588053
2015-02-11,26.691717,26.848787,26.595881,26.725126,26.725126,27555446,541772066.812245,73413002,20.979450029638013,32.0,0.2057047573443107,57.65797464318995,84.86698507164601,25.793568307692308,26.12692099172167,-15.133014928353976
2015-02-12,26.788952,27.166414,26.660454,27.072172,27.072172,32404724,562105140.8825744,105817726,21.857004863879933,88.0,0.24946251043605017,61.08821712794744,95.66709026274599,25.872141,26.19693958492747,-4.332909737254013
2015-02-13,27.093117,27.420218,27.082146,27.375341,27.375341,38006060,590021054.6733645,143823786,22.99297391636191,92.0,0.30508719436335596,63.843829056725546,98.15232177441669,25.964023307692308,26.284228578636544,-1.8476782255833097
2015-02-17,27.26664,27.424706,26.980425,27.067686,27.067686,32336537,570386922.4809387,111487249,23.769793440475983,96.0,0.32064873083787404,59.25770671355828,85.32786481021807,26.041042615384615,26.342262461700503,-14.672135189781937
2015-02-18,26.995884,27.199823,26.801914,26.911116,26.911116,29061570,557276645.7019515,82425679,24.006440674244228,96.0,0.3166967866986745,57.013147907906756,78.89344599148488,26.124524923076926,26.384399760833798,-21.106554008515126
2015-02-19,26.828342,27.081148,26.826847,27.069181,27.069181,19782163,575196974.5399076,102207842,24.226184534171885,92.0,0.3226006277668354,58.71337667656492,79.32129768199611,26.22102919230769,26.43512429706833,-20.678702318003882
2015-02-20,27.082146,27.113062,26.716648,26.873718,26.873718,28887092,569201584.3488246,73320750,24.112348128100518,88.0,0.30795729381434356,55.77553112926013,64.8648510772888,26.303053961538463,26.467612719507716,-35.1351489227112
2015-02-23,26.729115,26.748512,26.398024,26.522682,26.522682,29157834,560784872.845298,44162916,23.145401451949898,84.0,0.26497223964856076,50.85411815322464,37.034384454189194,26.362582807692306,26.471691925470108,-62.965615545810806
2015-02-24,26.427443,26.766014,26.340183,26.73111,26.73111,20101036,577590674.0665058,64263952,22.098569098811794,80.0,0.24490159903834652,53.4788539129809,51.58366176497287,26.428363769230767,26.49090807913899,-48.41633823502713
2015-02-25,26.721636,27.236223,26.698948,27.119045,27.119045,36519991,598180873.0404558,100783943,22.052779739428438,48.0,0.25733221851423593,57.97736994007382,78.0365457576454,26.49700226923077,26.53743673994351,-21.963454242354594
2015-02-26,27.086136,27.730865,27.00087,27.697954,27.697954,46230579,640242945.1726853,147014522,22.78632436539704,76.0,0.31031952188122247,63.62941002624594,97.8086739517775,26.5901695,26.623400981429175,-2.1913260482224945
2015-02-27,27.636126,28.158192,27.569307,27.843555,27.843555,48203982,636936848.6869571,195218504,24.018678276255162,80.0,0.35991228068007786,64.90782267327597,83.69082984009454,26.667572346153847,26.713782760582568,-16.309170159905463
2015-03-02,27.949764,28.529173,27.861008,28.488785,28.488785,42592618,674380347.3652805,237811122,25.575597391704036,84.0,0.44613678081387675,69.94882648607691,98.20920246813296,26.738435576923077,26.84526440794682,-1.7907975318670488
2015-03-03,28.444407,28.690729,28.248444,28.60347,28.60347,34095352,695022264.0456655,271906474,27.188606673791845,88.0,0.5177560697413384,70.75302707047473,96.28771357803679,26.803046730769232,26.97550185921002,-3.7122864219632152
2015-03-04,28.515211,28.776493,28.322741,28.590006,28.590006,37536775,701704649.1612132,234369699,28.77570410373264,92.0,0.5668936428925875,70.51444751600982,92.34551432288995,26.87623046153846,27.095094758527793,-7.654485677110044
2015-03-05,28.672279,28.816385,28.592001,28.687738,28.687738,27792094,697628432.4365803,262161793,30.292570971392525,96.0,0.606727700000917,71.27170812973824,94.80466456290719,26.984970384615387,27.213068331970177,-5.195335437092806
2015-03-06,28.665298,28.755053,28.26041,28.306534,28.306534,33182854,670633984.854526,228978939,30.666728282272526,96.0,0.6006130074219556,64.33160632639593,79.40995928442021,27.095599307692304,27.294065788861275,-20.59004071557979
2015-03-09,28.265396,28.435431,28.099604,28.364626,28.364626,21242161,682918848.1410903,250221100,30.549529038956074,92.0,0.5936118208438899,64.89264188267015,81.75597144336372,27.207196807692306,27.37336654524192,-18.24402855663629
2015-03-10,28.135256,28.165173,27.660559,27.67452,27.67452,35846146,649056190.6860219,214374954,29.300957145464533,88.0,0.526310562746044,54.02186533660406,53.886435759279784,27.24649280769231,27.395674208557335,-46.11356424072022
2015-03-11,27.681002,27.830591,27.458612,27.483543,27.483543,36415706,617521835.3336987,177959248,27.675374146747142,80.0,0.452349183179404,51.45308775349602,46.17393895974565,27.290027076923078,27.40218300792346,-53.82606104025435
2015-03-12,27.599726,27.742332,27.447641,27.699451,27.699451,27792094,637225777.4538379,205751342,26.140290345087692,80.0,0.40647068712941703,54.1098272380046,54.89325991982883,27.340408000000004,27.42420285918839,-45.10674008017117
2015-03-13,27.599226,27.843555,27.136497,27.291073,27.291073,34071287,618051721.6832762,171680055,24.538391799170054,76.0,0.33331668951613125,48.68303393573806,38.40114821004106,27.38750946153846,27.414341388137398,-61.59885178995894
2015-03-16,27.472075,27.766268,27.225252,27.649588,27.649588,32819860,636715174.9788535,204499915,23.050914577960818,68.0,0.30080331030895735,53.12745637283077,44.895786745957516,27.439156153846152,27.431767063090184,-55.104213254042484
2015-03-17,27.509972,27.614185,27.32498,27.466591,27.466591,36110871,635968122.3995658,168389044,21.669685729695097,68.0,0.25730385582687987,50.71312936798553,25.65228048239765,27.477205576923076,27.434346613972394,-74.34771951760236
2015-03-18,27.549362,27.912367,27.275116,27.898405,27.898405,42690887,676788317.4295447,211079931,20.600166497940336,64.0,0.25473754982722596,55.81563105883403,45.35469031268757,27.537942653846155,27.4687213092337,-54.64530968731243
2015-03-19,27.89292,27.963226,27.731113,27.823112,27.823112,23945563,671824611.1151845,187134368,19.72769141931773,28.0,0.24381764000040462,54.75127072158863,40.87266532054512,27.578312615384615,27.494972471512686,-59.12733467945488
2015-03-20,28.005611,28.009102,27.875967,27.941286,27.941286,52337299,670843004.2078896,239471667,19.03062601132219,28.000000000000004,0.24191059224434142,56.1641791133058,47.90730096292147,27.625087999999998,27.528032732882117,-52.09269903707853
2015-03-23,27.944778,28.041014,27.715406,27.863998,27.863998,32876014,667973087.5537037,206595653,17.90299491037788,28.0,0.23149422614208248,54.95554743734966,43.30651805358449,27.655542846153846,27.55291904896492,-56.69348194641551
2015-03-24,28.050985,28.650839,27.983671,28.43144,28.43144,51665459,685658049.7698617,258261112,18.238730674636702,28.0,0.26596117319994406,61.50536050065765,77.08507948148916,27.696162038461537,27.617994674967516,-22.914920518510844
2015-03-25,28.446899,28.534658,27.86051,27.862753,27.862753,43045859,642898631.9125693,215215253,18.18527564282402,28.0,0.24456895026009207,53.162259032966155,44.87061306497904,27.726741538461535,27.63612492126622,-55.12938693502096
2015-03-26,27.803165,27.868486,27.457115,27.682499,27.682499,31452115,645910800.914893,183763138,17.05946260775028,28.0,0.21064231462048966,50.80961223645647,36.055395676802235,27.756410115384615,27.639560038209463,-63.944604323197765
2015-03-27,27.574295,27.687983,27.331461,27.341932,27.341932,37949906,610190061.5061607,145813232,15.969526468153285,28.0,0.15449339707242515,46.61243391570759,13.565958020051019,27.76690053846154,27.617513516860612,-86.43404197994899
2015-03-30,27.505484,27.597731,27.333456,27.525928,27.525928,25750504,621947842.4811906,171563736,14.957442909956074,28.0,0.12341921498123654,49.06068062623639,25.716185643665774,27.79198553846154,27.610729404500564,-74.28381435633423
2015-03-31,27.424706,27.659561,27.261154,27.32498,27.32498,31760961,600363284.4901034,139802775,14.205531706659766,28.000000000000004,0.08163681915501897,46.549982110677014,12.446527930943022,27.822843153846154,27.589562781944966,-87.55347206905698
2015-04-01,27.354897,27.481548,26.901142,27.053724,27.053724,39261497,581744571.1114097,100541278,14.364673540633367,24.0,0.026332334457492834,43.32670939764504,8.720481317622353,27.835251384615386,27.549871020319415,-91.27951868237764
2015-04-02,26.968458,26.968458,26.619267,26.703186,26.703186,34327989,563916265.7166054,66213289,15.084029842669105,-80.0,-0.04526061890333111,39.51851920221539,4.130742105128347,27.819256807692305,27.487153611406868,-95.86925789487165
2015-04-06,26.538139,26.846792,26.406002,26.764767,26.764767,26488525,580546485.1147313,92701814,16.142649065597606,-84.0,-0.09592372915578551,40.507799305778306,15.981783978079395,27.783365,27.433643492043394,-84.0182160219206
2015-04-07,26.830338,27.060205,26.726622,26.777481,26.777481,26057345,562434691.9525352,118759159,16.45428702996453,-84.0,-0.13350967902132282,40.72337534004329,16.548150266589545,27.742362153846155,27.385038863003146,-83.45184973341046
2015-04-08,26.845297,27.118048,26.845297,27.006353,27.006353,23570536,566700360.0068998,142329695,16.56564072166812,-84.0,-0.14317828727470427,44.61413603320499,26.743634393053917,27.68534553846154,27.356988058336245,-73.25636560694609
2015-04-09,26.977432,27.023308,26.701193,26.964968,26.964968,31157308,586571528.9030392,111172387,16.976913974588584,-84.0,-0.15242311382906593,44.05109155166282,24.90007069555598,27.62232623076923,27.327949535496522,-75.09992930444403
2015-04-10,27.04026,27.04026,26.791943,26.926573,26.926573,28189181,588948998.0963811,82983206,17.30100297024627,-84.0,-0.16099204501747977,43.50256022925038,23.18970152398594,27.55834803846154,27.298217940274558,-76.81029847601405
2015-04-13,26.846792,27.128519,26.791943,26.884687,26.884687,32906096,574177546.0842113,50077110,17.291482613990286,-80.0,-0.16921226124751598,42.87532408975234,21.323819947728882,27.48899992307692,27.26758601877274,-78.67618005227112
2015-04-14,26.739088,26.804907,26.332306,26.44689,26.44689,52082601,547350214.3408741,-2005491,18.271236606032403,-56.0,-0.20864823394914112,36.88850793748489,5.202801368718562,27.417475153846155,27.20679372108587,-94.79719863128143
2015-04-15,26.362621,26.663296,26.089373,26.553596,26.553596,46376979,575998143.9865181,44371488,19.60898226781967,-60.0,-0.22865544636267288,39.11984410044268,26.092946316507152,27.347820153846154,27.15840870470914,-73.90705368349286
2015-04-16,26.422457,26.706179,26.407997,26.616922,26.616922,25997180,586431471.7401718,70368668,20.692242986516543,-60.0,-0.23667320598737973,40.46510357214822,33.00048166844948,27.307143307692307,27.118298578434388,-66.99951833155052
2015-04-17,26.360626,26.419464,25.979174,26.130758,26.130758,43037837,573027955.2280682,27330831,22.391686535474474,-68.0,-0.2790401093288146,34.21445171289564,9.020779141947644,27.255113115384614,27.045147424476284,-90.97922085805234
2015-04-20,26.208046,26.73111,26.153196,26.695707,26.695707,33585958,602498963.0068448,60916789,22.8927967376322,-68.0,-0.2639864511566792,44.87139775405421,42.640951161845365,27.216507576923075,27.01926294858915,-57.359048838154635
2015-04-21,26.801914,26.895658,26.610689,26.625401,26.625401,36895018,569413478.7092192,24021771,22.840371965447904,-68.0,-0.25479233776076526,43.91791721600363,43.0137236134278,27.19090480769231,26.990087989434397,-56.9862763865722
2015-04-22,26.646841,26.979927,26.514704,26.894411,26.894411,31871263,589567767.5840881,55893034,22.98068249397722,-68.0,-0.22322586900030927,48.43308700619046,79.63118123800956,27.161859538461538,26.983000805031846,-20.36881876199044
2015-04-23,26.975939,27.472574,26.937544,27.275116,27.275116,83697161,611486433.857669,139590195,21.70100888914402,-68.0,-0.16558079098000889,54.06895853517322,86.7779563412347,27.154495115384616,27.00463896762208,-13.222043658765292
2015-04-24,28.227501,28.478811,27.786213,28.175644,28.175644,98650102,623773434.973652,238240297,21.726122181112547,-68.0,-0.04669331628057449,64.07171619874295,87.87155895035951,27.16515815384615,27.091380081131554,-12.128441049640486
2015-04-27,28.1695,28.297501,27.66,27.768499,27.768499,47960000,592138466.746151,190280297,21.45573078010079,-68.0,0.014505455250670707,57.92918410314316,71.58339390879549,27.163057653846156,27.14153703808477,-28.416606091204518
2015-04-28,27.732,27.801001,27.518299,27.684,27.684,29820000,597275444.9069002,160460297,20.87492918756894,-68.0,0.05554724542187017,56.71395500850634,68.2029430673334,27.153162038461538,27.18171947970812,-31.797056932666596
2015-04-29,27.5235,27.684,27.345249,27.454,27.454,33976000,585114429.813218,126484297,19.93933989693312,-68.0,0.0687218987420728,53.4285060271107,59.00160703334125,27.137392884615387,27.20188840713715,-40.99839296665875
2015-04-30,27.393499,27.429501,26.752501,26.867001,26.867001,41644000,557556804.997856,84840297,19.137180914570205,-64.0,0.031434633978790316,46.09002835363332,35.51823724804834,27.077222153846154,27.1770819325344,-64.48176275195168
2015-05-01,26.921499,26.976999,26.605,26.895,26.895,35364000,577330372.5719624,120204297,18.64909047596795,20.0,0.00409627401919721,46.467720993732854,36.63835988985598,27.040000884615385,27.156186974568886,-63.36164011014402
2015-05-04,26.9265,27.203501,26.753,27.039,27.039,26160000,584385659.5524576,146364297,17.705432781848398,19.999999999999993,-0.005882170667316444,48.46738156588553,42.399196363311994,27.015250923076923,27.147506457934156,-57.600803636688006
2015-05-05,26.9105,26.987,26.51955,26.540001,26.540001,27662000,559144091.9495056,118702297,17.258411170882187,20.0,-0.053439195186182786,42.53763948764393,22.436337756242196,26.984407423076924,27.10250605364274,-77.5636622437578
2015-05-06,26.562,26.618999,26.054251,26.211,26.211,31340000,545201280.2883751,87362297,17.602540007729182,20.0,-0.11633507257063513,39.13775341401608,9.274386640940188,26.93383326923077,27.036468568187722,-90.7256133590598
2015-05-07,26.199499,26.673,26.0875,26.535,26.535,30926000,561549012.1414924,118288297,17.793208744696862,20.0,-0.13844055972289482,43.89368097118534,19.828298742864664,26.903449423076925,26.999322748321966,-80.17170125713533
2015-05-08,26.8325,27.057501,26.25,26.910999,26.910999,30552000,581015133.3524879,148840297,17.09573443686008,20.0,-0.12418778117012863,48.88548847317645,35.336225954399964,26.897959999999998,26.992780248446266,-64.66377404560004
2015-05-11,26.918501,27.099001,26.77,26.785,26.785,18106000,564560131.3737706,130734297,16.357845174550597,20.000000000000007,-0.12165703123653415,47.364709760680924,30.139447982314298,26.901106692307696,26.977389118931725,-69.86055201768569
2015-05-12,26.58,26.66045,26.263,26.452,26.452,32684000,562960675.3415654,98050297,16.560647687668936,20.0,-0.1448519475992569,43.512076305392306,16.40499719536745,26.889077192307695,26.938471406418266,-83.59500280463254
2015-05-13,26.528,26.716101,26.432751,26.481001,26.481001,25046000,546444546.5256133,123096297,16.616849463937992,19.999999999999996,-0.159060398338152,43.93974875502304,17.60113175174046,26.877674115384615,26.904584709646542,-82.39886824825955
2015-05-14,26.688499,26.950001,26.620501,26.92,26.92,28078000,569409538.4649155,151174297,16.11896125131964,20.0,-0.1333598580528026,50.09864946806952,38.593513874958255,26.874352846153844,26.905726583006057,-61.40648612504174
2015-05-15,26.959,26.963699,26.518999,26.692499,26.692499,39426000,560747698.5728537,111748297,15.848681780961721,20.0,-0.12985256457507433,47.20440536751453,36.5391727493918,26.86387326923077,26.88993194722783,-63.4608272506082
2015-05-18,26.6005,26.740999,26.442499,26.615,26.615,40068000,566989715.7788835,71680297,15.745377646660598,20.0,-0.1318071401742884,46.22473264003312,34.40707740885238,26.851889692307694,26.869566617803542,-65.59292259114761
2015-05-19,26.698999,27.033001,26.652,26.868,26.868,39338000,572255315.2445015,111018297,14.927303468723997,20.0,-0.11165409096941303,49.881565334415974,59.17098709325572,26.851247884615386,26.869450572040318,-40.82901290674428
2015-05-20,26.9245,27.146,26.6486,26.963499,26.963499,28616000,579872326.0366204,139634297,13.90305078374583,20.000000000000004,-0.08697409981494175,51.22972310831902,79.11664128779633,26.87111746153846,26.876417122259554,-20.88335871220368
2015-05-21,26.897499,27.191999,26.799,27.1255,27.1255,29254000,599226241.069483,168888297,12.97815923302014,20.0,-0.053723609881210166,53.514101314091626,93.21287796388944,26.89311376923077,26.894867705795882,-6.787122036110553
2015-05-22,27.0075,27.209499,26.9755,27.005501,27.005501,23524000,581734262.7789773,145364297,12.163498021024836,20.0,-0.03663299115955709,51.586601608652764,82.34162707920706,26.908059115384614,26.903062764625815,-17.658372920792946
2015-05-26,26.906,26.950001,26.493999,26.615999,26.615999,48130000,559357921.7541571,97234297,12.314908503344043,-32.0,-0.05389681989718298,45.81790074249617,48.62574962259167,26.926722230769233,26.88179878206094,-51.37425037740833
2015-05-27,26.639999,27.0275,26.585501,26.9895,26.9895,30500000,584613565.997696,127734297,12.240442414074183,-32.0,-0.03701345130247802,51.42711188586669,80.39222851357256,26.93802196153846,26.889776650056426,-19.60777148642743
2015-05-28,26.900499,27.0305,26.8125,26.989,26.989,20596000,597367969.667421,107138297,12.162575648279542,-32.0,-0.023403821192069074,51.419437631289696,77.01936114576462,26.95200653846154,26.897126527830025,-22.980638854235387
2015-05-29,26.8685,26.931499,26.5725,26.605499,26.605499,51948000,554970035.556183,55190297,12.638321654737556,-32.0,-0.04306696773015872,45.776932835212584,36.185880809171145,26.94089453846154,26.875524488731504,-63.814119190828855
2015-06-01,26.8395,26.8395,26.488001,26.699499,26.699499,38086000,562716955.8660555,93276297,13.263921817178263,-32.0,-0.05048319971606574,47.30335142409769,46.11721723953201,26.91875542307692,26.86248556364028,-53.88278276046799
2015-06-02,26.6465,27.15,26.5665,26.959,26.959,38780000,576108849.6106999,132056297,12.878189867386412,-28.000000000000004,-0.03501739628945799,51.37305188449754,67.75028709439857,26.871961423076925,26.86963478114841,-32.24971290560142
2015-06-03,26.995501,27.174999,26.855499,27.015499,27.015499,34340000,576162589.8297921,166396297,12.446253075048613,-24.0,-0.01799421245049615,52.237918442087654,74.70664928292011,26.842999884615384,26.88043953810038,-25.29335071707989
2015-06-04,26.888,27.029499,26.716,26.834999,26.834999,26966000,569668278.9516073,139430297,12.407195558130473,-20.0,-0.01885075830372429,49.22570878009725,51.173402868317936,26.810346,26.877073572315165,-48.826597131682064
2015-06-05,26.817499,26.860001,26.625999,26.6665,26.6665,27764000,551515049.4920298,111666297,12.600118334664534,-16.0,-0.03274853345023132,46.52844936125592,29.20482398956947,26.780057538461538,26.86147552992145,-70.79517601043052
2015-06-08,26.665501,26.705999,26.312,26.341499,26.341499,30412000,525656987.89288837,81254297,13.509139383318935,48.0,-0.06918990675931269,41.77391518270165,3.28680031955442,26.759845923076924,26.822958749927267,-96.71319968044558
2015-06-09,26.378,26.459999,26.150499,26.334499,26.334499,29106000,531158445.0819031,52148297,14.686619989905116,48.00000000000001,-0.09751075585606372,41.67513622284258,17.374881964117172,26.738288192307696,26.78677654622895,-82.62511803588282
2015-06-10,26.468,26.917999,26.467501,26.834499,26.834499,36300000,554002003.5438722,88448297,14.291626379154108,48.0,-0.07870218171983367,50.65131511372241,64.58923512747879,26.73042276923077,26.790311542804584,-35.41076487252121
2015-06-11,26.921249,26.948999,26.650999,26.730499,26.730499,24350000,542644117.6378318,64098297,13.834798615133732,48.0,-0.07136552469891555,48.96337463971775,54.76864966949931,26.73774961538461,26.785880984078318,-45.23135033050069
2015-06-12,26.58,26.656,26.507999,26.616501,26.616501,19116000,551556634.0938017,44982297,13.767572056433384,44.0,-0.07389800680846648,47.11014425821302,45.48579795021959,26.753345807692305,26.773334318591036,-54.51420204978041
2015-06-15,26.4,26.415001,26.200001,26.360001,26.360001,32654000,567503936.4193832,12328297,14.400679661171226,-44.0,-0.09550154114719334,43.152482497976074,20.44919472913622,26.746615076923074,26.742717035732444,-79.55080527086378
2015-06-16,26.42,26.482,26.278,26.407499,26.407499,21436000,573283039.9880111,33764297,14.765029991211108,-44.0,-0.1075500362428059,44.08916595154916,25.085407515861544,26.727249692307694,26.71788607012263,-74.91459248413845
2015-06-17,26.4685,26.549,26.254999,26.462999,26.462999,25884000,584023895.005511,59648297,14.875039617175275,-44.0,-0.11133674851152975,45.22487494674041,30.502684236212794,26.714865038461536,26.699005546409843,-69.4973157637872
2015-06-18,26.549999,26.907499,26.539499,26.8365,26.8365,36662000,606539344.255511,96310297,13.867750762158963,-44.0,-0.08323979945128102,52.253862979010854,66.95959004392398,26.729653499999998,26.709190320749855,-33.040409956076026
2015-06-19,26.8605,26.9125,26.650499,26.834499,26.834499,37870000,621860591.6171623,58440297,12.917998840784929,-44.0,-0.06043754250150002,52.215204353284435,66.76427525622266,26.743249576923077,26.718472445138755,-33.23572474377733
2015-06-22,26.9795,27.187,26.876499,26.9095,26.9095,25006000,602170020.5916265,83446297,12.714726013963945,-44.0,-0.03590079369467958,53.60082057128844,73.22723277642766,26.74284573076923,26.732622634387738,-26.772767223572338
2015-06-23,26.982,27.074949,26.762501,27.024,27.024,23950000,618309258.1607581,107396297,12.170659031204703,-44.0,-0.007133816211329247,55.71217291075075,84.27401420741514,26.75559576923077,26.75420614295161,-15.725985792584867
2015-06-24,27.0,27.0,26.783001,26.892,26.892,25732000,618427720.7711849,81664297,11.665453975785407,-44.00000000000001,0.004955796531593393,52.733062913274594,71.53886006863463,26.766249615384616,26.764413095325565,-28.46113993136537
2015-06-25,26.943501,27.045,26.761499,26.761499,26.761499,26714000,591713720.7711849,54950297,11.333739735904075,-44.0,0.00396090285119044,49.89255020659283,58.94832711208189,26.76215342307692,26.76419723641256,-41.05167288791811
2015-06-26,26.863001,26.888,26.567499,26.584499,26.584499,42182000,554006552.3629739,12768297,10.680175791735538,-44.0,-0.010983368868227927,46.25338811412937,41.87164315326281,26.7475765,26.750886255937555,-58.12835684673719
2015-06-29,26.2505,26.4305,26.027,26.076,26.076,38756000,524663409.859876,-25987703,11.506542304251955,-100.0,-0.06313070005731092,37.73733367404516,4.224137931034438,26.707211115384613,26.700894681423662,-95.77586206896557
2015-06-30,26.301001,26.3125,26.025,26.025499,26.025499,44344000,480473341.3798764,-70331703,12.278418707163464,-24.0,-0.10729600284012264,37.008561732105136,0.042943201377053215,26.669518730769234,26.650865371688575,-99.95705679862294
2015-07-01,26.2365,26.2845,25.911501,26.091999,26.091999,39220000,479211253.11690515,-31111703,13.258986441548018,-28.0,-0.13537085826438044,38.68765458239066,14.151167503855358,26.649364884615387,26.609467862674606,-85.84883249614464
2015-07-02,26.054001,26.2325,26.054001,26.17,26.17,24718000,486619632.3347161,-6393703,14.169513623476533,-28.0,-0.14960183777609615,40.68485653300193,20.26649962093271,26.617845653846153,26.57691468766167,-79.7335003790673
2015-07-06,25.975,26.262501,25.950001,26.143,26.143,25610000,492642940.43071616,-32003703,15.269197439620262,-28.0,-0.16120044750434914,40.196751500056685,18.1496810267981,26.585307192307692,26.54477285894599,-81.85031897320191
2015-07-07,26.1565,26.309,25.759001,26.250999,26.250999,31944000,517849532.0208826,-59703,16.727332324576206,-40.0,-0.15983533036831687,43.135499708508405,34.45366558379935,26.571672576923074,26.523011832357398,-65.54633441620065
2015-07-08,26.0525,26.1367,25.8055,25.841499,25.841499,25934000,497553201.50155896,-25993703,18.08131471774959,-39.99999999999999,-0.18961097557093254,35.92655033664195,5.777174913987862,26.538672576923076,26.472529400330924,-94.22282508601212
2015-07-09,26.156,26.188499,26.0175,26.034,26.034,36846000,467817874.6633905,10852297,19.08085064707759,-40.0,-0.19542245855792828,40.924674412178376,19.257646538967997,26.503095653846152,26.44004574104715,-80.74235346103201
2015-07-10,26.314501,26.628,26.2775,26.5065,26.5065,39134000,479820456.6890679,49986297,18.164744198364644,-40.0,-0.16005627048724946,51.023486637481206,52.345905004135005,26.483518769230766,26.44496827874736,-47.654094995864995
2015-07-13,26.643999,27.355499,26.620001,27.327499,27.327499,44130000,520590447.5524015,94116297,18.38182740801377,16.0,-0.06503091777675252,62.89326096014977,98.24616128551375,26.50246107692308,26.510340924766076,-1.7538387144862535
2015-07-14,27.337999,28.29245,27.335501,28.055,28.055,64882000,553273801.8565494,158998297,20.06847113297053,20.0,0.06819450577451036,69.86317919117798,90.62740161732091,26.555864923076925,26.624760115524147,-9.37259838267908
2015-07-15,28.0065,28.32515,27.8395,28.011,28.011,35692000,542789988.8224711,123306297,21.675325620833632,24.0,0.16828628199530726,69.0187835957364,87.75792052604889,26.6200765,26.72744455141125,-12.242079473951106
2015-07-16,28.256001,29.034,28.25,28.9925,28.9925,95366000,628059843.4143081,218672297,23.932484262763275,28.0,0.3230842686982669,75.99004379925714,98.73282404055698,26.722307307692308,26.895226436491896,-1.2671759594430176
2015-07-17,32.450001,33.7234,32.25,33.6465,33.6465,223298000,828049011.8682257,441970297,27.932643666571064,32.0,0.8119421298621425,88.82756842592853,99.03445319602903,26.984307346153848,27.395320774529534,-0.9655468039709574
2015-07-20,32.962002,33.444,32.650501,33.151001,33.151001,117218000,858701668.2899729,324752297,31.6470773986783,32.0,1.1461705381260074,83.69660576031961,92.8130295832743,27.231249730769232,27.821667457897718,-7.1869704167257
2015-07-21,32.760502,33.650002,32.715,33.115002,33.115002,67544000,848949491.3833987,257208297,35.136679870411584,32.0,1.3920969145364346,83.32004685381504,92.36103063143871,27.48119207692308,28.213766312868255,-7.638969368561286
2015-07-22,33.044498,33.931999,32.950001,33.105,33.105,78586000,795171589.5954108,178622297,38.432704272506875,43.99999999999999,1.5681120423276624,83.20803307953075,89.88132628932492,27.740615115384614,28.57607991932246,-10.118673710675093
2015-07-23,33.063499,33.181499,32.049999,32.214001,32.214001,60582000,752151355.6829057,118040297,39.929023298807024,44.0,1.6170685664680526,73.70244732295723,78.97958619346298,27.963942115384615,28.845555554928204,-21.02041380653703
2015-07-24,32.349998,32.408501,31.125999,31.177999,31.177999,72514000,685517624.0957425,45526297,39.97704650370348,44.0,1.554352651575563,64.47887531879374,66.30367461242497,28.14528826923077,29.01832914345204,-33.69632538757502
2015-07-27,31.049999,31.715,31.025,31.363001,31.363001,53508000,684432109.6261774,99034297,39.884246884735894,44.0,1.502260824789989,65.31366328906007,68.38739535930543,28.319384461538466,29.192008540233367,-31.612604640694563
2015-07-28,31.6415,31.6415,31.165501,31.4,31.4,34546000,683924006.5713389,133580297,39.79807580998028,44.0,1.4472798456868752,65.48834742893557,68.00809501650073,28.494980653846156,29.355563463179042,-31.99190498349926
2015-07-29,31.440001,31.667999,31.1325,31.5965,31.5965,31502000,707013809.7306352,165082297,39.666972307505475,44.0,1.4033855760683416,66.45458833153799,69.48854523333272,28.675249884615386,29.52155876220282,-30.51145476666728
2015-07-30,31.5,31.761,31.102501,31.629499,31.629499,29484000,724722012.0938885,194566297,39.61352396604691,44.0,1.3556348796313884,66.6235865927074,68.51065878300297,28.852384461538463,29.67770248352113,-31.48934121699703
2015-07-31,31.569,31.6455,31.275,31.2805,31.2805,34122000,691613080.9197997,160444297,39.563893363263965,44.0,1.2749341587234504,63.00820372550472,59.80444472203283,29.02117292307692,29.79642822548253,-40.19555527796717
2015-08-03,31.267,31.6528,31.267,31.560499,31.560499,26090000,705219239.0846521,186534297,39.502575242878585,44.0,1.219514036545167,64.66492440362327,61.07508593764236,29.205749846153847,29.927100134706045,-38.924914062357644
2015-08-04,31.421,31.740499,31.358,31.4625,31.4625,29818000,691693992.7911974,156716297,39.52357032151115,44.0,1.154378532997562,63.59144816764694,56.538200728300026,29.393365269230767,30.040833458061154,-43.46179927169998
2015-08-05,31.716499,32.393002,31.658001,32.188999,32.188999,46686000,712464153.0630883,203402297,40.07983924893288,44.0,1.148145468588499,67.85208512614946,40.041259044120906,29.628480615384618,30.199956831538106,-59.958740955879094
2015-08-06,32.25,32.268951,31.612499,32.133999,32.133999,31452000,730984483.1039749,171950297,40.49865410243252,44.00000000000001,1.1257902703353793,67.21084186722666,38.14927352916202,29.86342292307692,30.343219214387133,-61.85072647083798
2015-08-07,32.011501,32.133999,31.4855,31.764999,31.764999,28078000,727109366.7537569,143872297,40.604459190152845,44.0,1.066010097683101,62.91487139556518,25.455770710619483,30.08161523076923,30.448536235543642,-74.54422928938052
2015-08-10,31.974001,32.172001,31.56245,31.686501,31.686501,36184000,705653129.9236968,107688297,40.73865954272963,44.0,1.0007635681386304,62.00688616567698,22.75546018419688,30.293788346153846,30.540237329207077,-77.24453981580312
2015-08-11,33.459999,33.744999,32.713501,33.039001,33.039001,100584000,668549799.7844232,208272297,42.00896700084013,44.0,1.0461315171492203,70.03193287582727,74.04418163389029,30.559019153846155,30.725330934450994,-25.955818366109717
2015-08-12,33.153999,33.25,32.614498,32.978001,32.978001,58734000,677006729.7956585,149538297,42.97848050378913,40.0,1.0648883829877178,69.32074694207681,71.80153375056386,30.817749999999997,30.892195383750924,-28.19846624943614
2015-08-13,32.966099,33.224998,32.58305,32.822498,32.822498,36214000,667808531.2998306,113324297,43.80866398747629,36.0,1.0550436552772808,67.4405566250623,66.08450958989336,31.08624996153846,31.035180762732338,-33.915490410106635
2015-08-14,32.7505,32.992748,32.632999,32.855999,32.855999,21442000,672949320.9670706,134766297,44.57954865090007,32.0,1.0379797044468582,67.64416464345766,66.35759043147797,31.348634538461535,31.17005618771513,-33.64240956852202
2015-08-17,32.84,33.069,32.562,33.043499,33.043499,21034000,691867391.838865,155800297,45.351872661476044,28.000000000000004,1.0277389486173618,68.81941488899935,73.45314925498512,31.60005757692308,31.30882972936586,-26.54685074501487
2015-08-18,33.095001,33.200001,32.673,32.806499,32.806499,29122000,677499663.1893939,126678297,46.16853972191125,24.0,0.989097456743913,65.57705370537364,64.48436290207229,31.810788346153842,31.41976819385728,-35.51563709792771
2015-08-19,32.830002,33.349998,32.709499,33.044998,33.044998,42682000,679532075.9144722,169360297,47.04133641230192,20.0,0.9665765789884269,67.2492767740121,71.75136067447968,32.002711346153845,31.54015558690489,-28.248639325520315
2015-08-20,32.772999,33.149502,32.145,32.341499,32.341499,57106000,644768036.1972786,112254297,46.373660562791834,16.0,0.8817973205875376,58.25904052745247,43.36155906439023,32.169269,31.599514358245273,-56.63844093560977
2015-08-21,31.989,32.002499,30.616501,30.624001,30.624001,85304000,560387240.9926679,26950297,43.08217558712486,-88.0,0.6683174649106292,43.107578212379465,0.2397316539758147,32.23201903846154,31.527254109486364,-99.76026834602419
2015-08-24,28.65,29.966499,28.252501,29.480499,29.480499,115406000,610347054.9411088,-88455703,42.26802002965997,-92.0,0.4022254815180588,36.33253204176529,22.35773231050788,32.07178823076923,31.37564261989478,-77.64226768949212
2015-08-25,30.745501,30.872499,29.0555,29.103001,29.103001,70760000,543286749.613478,-159215703,40.43034712024205,-92.0,0.15905128961199466,34.409865288069184,15.48475757296589,31.916095923076924,31.20729879619887,-84.51524242703411
2015-08-26,30.5175,31.585501,29.952499,31.431,31.431,84718000,611974131.5027837,-74497703,37.984676744483124,-92.0,0.15242697071565203,51.46677411105092,57.86982535086952,31.85132661538461,31.223869255739697,-42.130174649130474
2015-08-27,31.969999,32.179501,31.1,31.880501,31.880501,69826000,643119344.7318586,-4671703,35.389024223329336,-36.0,0.18135754741264165,53.95656067038528,66.05373365634361,31.804230500000003,31.272508644203423,-33.94626634365639
2015-08-28,31.641001,31.844,31.228001,31.518999,31.518999,39574000,640934869.2343335,-44245703,32.97877545368653,-36.0,0.17311943459788992,51.661193731636175,59.471992525076956,31.777499653846153,31.290767189077243,-40.528007474923044
2015-08-31,31.377001,31.790001,30.884001,30.9125,30.9125,43534000,600139667.1725234,-87779703,30.848478029231337,-36.0,0.11631051504675582,47.97382729222753,52.182453466868196,31.767288153846152,31.262747397293744,-47.817546533131804
2015-09-01,30.118,30.643,29.705,29.8895,29.8895,74042000,555225063.7610099,-161821703,29.89712507399768,-36.0,-0.011130211268774559,42.467760797366935,32.11378054759037,31.710615038461533,31.16102536786458,-67.88621945240963
2015-09-02,30.279499,30.716999,29.9855,30.716999,30.716999,51512000,606737063.7610099,-110309703,28.930337334522257,-36.0,-0.04483877791177804,47.69701864614819,48.34721825240902,31.684345769230767,31.128134525800537,-51.65278174759098
2015-09-03,30.85,30.9855,30.14105,30.3125,30.3125,35192000,585835237.0098702,-145501703,27.722051362964827,-36.0,-0.10300536684391304,45.51902605234941,40.41197081626534,31.634961153846152,31.067717153519016,-59.58802918373466
2015-09-04,30.0,30.1735,29.762501,30.035,30.035,41780000,599456871.6610492,-187281703,26.937463645651782,-36.0,-0.16954038248197634,44.033505567611336,34.96812259036153,31.57363426923077,30.99121958659168,-65.03187740963847
2015-09-08,30.6245,30.8155,30.205999,30.733,30.733,45590000,632705054.3383542,-141691703,25.464340269179036,-36.0,-0.1640559601758227,48.57921339525886,48.6611174072295,31.552576576923077,30.97209220980711,-51.338882592770496
2015-09-09,31.061001,31.326,30.48,30.636,30.636,34042000,611217550.7922548,-175733703,23.733904574478746,-36.00000000000001,-0.1656273562587387,47.99579834495909,48.67262636866933,31.517018923076918,30.947196490562135,-51.32737363133067
2015-09-10,30.655001,31.208,30.571501,31.067499,31.067499,38106000,632500488.6790389,-137627703,22.1270714293999,-36.0,-0.13054944314696826,50.825002204358675,71.6831678125796,31.50182657692308,30.956107787557535,-28.31683218742041
2015-09-11,30.987499,31.289,30.871,31.2885,31.2885,27470000,659904770.9756893,-110157703,20.726034953242465,-36.0,-0.08394929534547302,52.25761570977573,77.3108989050165,31.467191999999997,30.980729432923646,-22.689101094983503
2015-09-14,31.285,31.292999,30.9715,31.162001,31.162001,34046000,666206000.9577425,-144203703,19.429846304456643,-36.0,-0.05657360922925392,51.33571980736652,67.42958789065686,31.42980746153846,30.994156956410784,-32.57041210934314
2015-09-15,31.334999,31.934999,31.188999,31.757,31.757,41688000,688000107.3598874,-102515703,18.963617291417048,-36.0,0.012983599086634712,55.3276667217345,82.92581009262071,31.42949980769231,31.050663848528504,-17.0741899073793
2015-09-16,31.7735,31.897499,31.615999,31.799,31.799,25730000,695723860.3261396,-76785703,18.530690350737423,-36.0,0.07068245347558744,55.60450813856676,84.62312199510116,31.433826692307694,31.106096156044913,-15.37687800489884
2015-09-17,31.8895,32.544998,31.750999,32.145,32.145,45494000,695380248.4097521,-31291703,18.814758779074925,-12.0,0.1426837501794651,57.91816317378074,85.9155534616575,31.399442038461537,31.18305199633788,-14.084446538342503
2015-09-18,31.8395,32.0,31.351,31.4625,31.4625,102668000,627989542.7086734,-133959703,18.480422001255953,-12.000000000000004,0.14302455243829115,52.145361262622515,61.883846397074905,31.34115353846154,31.203751848461,-38.116153602925095
2015-09-21,31.719999,31.824499,31.297001,31.771999,31.771999,35770000,656639420.9262213,-98189703,18.089751795162538,-12.0,0.16635103224291825,54.3666036193912,72.78170618430019,31.30074973076923,31.24584423005648,-27.21829381569981
2015-09-22,31.35,31.377501,30.7715,31.134501,31.134501,51258000,666789587.7708306,-149447703,16.972399536702373,-12.0,0.1318764847138567,49.29146519581539,49.30822926314028,31.23453826923077,31.23759658338563,-50.69177073685972
2015-09-23,31.102501,31.446501,31.0,31.118,31.118,29418000,652920596.6196347,-178865703,16.025763014765577,-12.0,0.10204732656757187,49.16353445700023,48.7152007711059,31.16048061538461,31.228737577208918,-51.284799228894094
2015-09-24,30.832001,31.365999,30.620001,31.290001,31.290001,44802000,688594254.7313188,-134063703,15.14744452465458,-12.0,0.09123484851487262,50.60270331732786,54.89673483924692,31.10215376923077,31.233275608526775,-45.10326516075308
2015-09-25,31.488501,31.488501,30.549999,30.598499,30.598499,43480000,649608182.2882128,-177543703,14.151623992976496,-8.0,0.026561267721277204,45.07755535607759,16.780682676649356,31.00805765384615,31.186255119006272,-83.21931732335065
2015-09-28,30.517,30.730249,29.469,29.744499,29.744499,62554000,614381957.2890254,-240097703,14.551961275747521,68.0,-0.09253696529616917,39.36156295602522,8.956410244740084,30.908173038461538,31.07945836945025,-91.04358975525992
2015-09-29,29.864,30.25,29.511,29.748501,29.748501,46190000,597881189.1970093,-193907703,14.923703038320614,68.0,-0.18447374654578041,39.40034273702796,9.086514360542495,30.874499961538465,30.980868934676156,-90.9134856394575
2015-09-30,30.164,30.438,30.036501,30.421,30.421,48268000,642061726.9617361,-145639703,14.956750922560227,64.0,-0.2007550794730193,45.68622943560693,30.949304908520702,30.91067307692308,30.939397161737183,-69.0506950914793
2015-10-01,30.418501,30.6045,29.9925,30.564501,30.564501,37352000,674531234.6480104,-108287703,14.710240367355388,-28.0,-0.199775929151361,46.950743460823105,35.6144899964174,30.966884615384615,30.911627075682578,-64.3855100035826
2015-10-02,30.360001,31.367001,30.1565,31.345501,31.345501,53696000,726319819.4538057,-54591703,13.970841816274186,-27.999999999999993,-0.13443014551870647,53.32047224224576,61.00462354006727,30.963596192307698,30.943765884891274,-38.99537645993273
2015-10-05,31.6,32.150501,31.35,32.073502,32.073502,36072000,755452395.4480891,-18519703,14.213495085714255,-28.0,-0.02362718517382234,58.34168851100716,84.67177156812188,30.971019307692305,31.027450041565995,-15.328228431878115
2015-10-06,31.941999,32.462502,31.8265,32.271999,32.271999,43326000,772823341.916811,24806297,14.764134653283717,-28.0,0.07928802518383549,59.61720336430832,91.12486419041889,30.999980846153846,31.119638853301847,-8.875135809581112
2015-10-07,32.462002,32.530449,31.6075,32.118,32.118,41854000,777269770.2178333,-17047703,14.927113948098938,-28.0,0.1467312124989988,58.13012534785172,86.52765406185124,31.04634623076923,31.193591530835043,-13.472345938148756
2015-10-08,32.068001,32.2225,31.278,31.958,31.958,43642000,796468553.7011579,-60689703,14.569605813165907,-28.0,0.18513563318752446,56.55180416944361,81.30137069080688,31.125903923076923,31.25021438040282,-18.698629309193116
2015-10-09,32.0,32.2995,31.7659,32.1805,32.1805,32974000,814735259.8480846,-27715703,14.334700034040305,-28.0,0.23086404673907523,58.2494648391294,88.5691710036654,31.182192423076927,31.31912442629891,-11.430828996334599
2015-10-12,32.1045,32.424999,31.9505,32.3335,32.3335,25504000,830403241.2431983,-2211703,14.280047577375939,-28.0,0.2762653502710428,59.423549180630275,93.5668044772264,31.259923192307692,31.394263357684174,-6.433195522773587
2015-10-13,32.157501,32.890598,32.157501,32.615002,32.615002,36154000,839374214.2113045,33942297,14.806137159191636,43.99999999999999,0.33114384904655836,61.56514370722654,91.94540095008237,31.359154038461536,31.48468844230016,-8.054599049917627
2015-10-14,32.6605,32.969501,32.442501,32.557999,32.557999,28310000,823473126.4693693,5632297,15.388486175512671,48.0,0.36581885692998384,60.864610144868706,88.24448271833093,31.429346307692306,31.564192928055704,-11.755517281669073
2015-10-15,32.733002,33.156502,32.723,33.087002,33.087002,37714000,849094342.5837117,43346297,16.155062276440727,52.0,0.43101667955169987,64.86067534533072,98.11525525952243,31.523615615384617,31.676993600051578,-1.8847447404775635
2015-10-16,33.205502,33.248501,32.860001,33.110001,33.110001,32222000,858342098.0534672,75568297,16.97917615549553,56.0,0.4790204017817956,65.02786927136106,96.29431537275842,31.602173384615387,31.783142296344053,-3.705684627241587
2015-10-19,33.058998,33.341,32.979,33.305,33.305,29546000,882011545.5672791,105114297,17.860745711832823,60.0,0.5267267094916264,66.48395827534293,98.92489174257126,31.679731076923076,31.895872496614864,-1.0751082574287396
2015-10-20,33.202,33.236,32.209751,32.514,32.514,49964000,861672903.6158624,55150297,17.12888241934131,60.0,0.495001147617657,56.25252187586841,75.30237419740189,31.73173103846154,31.941659719087838,-24.697625802598115
2015-10-21,32.7075,32.793499,32.086498,32.130501,32.130501,35822000,830309950.960916,19328297,16.232933982844763,60.0,0.4339113866324382,52.06873812246449,61.987784581567006,31.74609646153846,31.95564796211837,-38.012215418432994
2015-10-22,32.334999,32.889999,32.2005,32.5895,32.5895,81420000,840760657.0823172,100748297,15.558979097692701,60.0,0.4177194840185763,56.261703559838296,63.572467280659275,31.776500307692306,32.002599964924414,-36.427532719340725
2015-10-23,36.375,36.5,35.075001,35.099998,35.099998,133078000,712351503.5390514,233826297,18.148156808383884,76.0,0.6005408311556479,71.13499031319171,73.19031022596707,31.890154076923075,32.2320368564115,-26.809689774032943
2015-10-26,35.077499,35.9575,35.063,35.639,35.639,54332000,727992073.6899737,288158297,20.533678225735308,76.0,0.7799304697256559,73.23906679341198,83.5120643431636,32.05078869230769,32.484404496677314,-16.487935656836402
2015-10-27,35.368999,35.681,35.227501,35.4245,35.4245,44916000,722098903.2177135,243242297,22.748805256133057,76.0,0.894478699719528,71.02038787262389,79.4044427422444,32.1912695,32.70218934877529,-20.59555725775561
2015-10-28,35.366501,35.648998,35.153999,35.647499,35.647499,43578000,765412969.6663333,286820297,24.67460990403297,76.0,0.9918200685213421,71.97103431991437,81.99233222787866,32.36484634615385,32.9203604340512,-18.00766777212134
2015-10-29,35.525002,35.912998,35.5005,35.846001,35.846001,29120000,785073759.4883444,315940297,26.62360454904913,76.0,1.0726167982832067,72.82557640621657,85.6248159138367,32.54669253846154,33.1370745500474,-14.375184086163296
2015-10-30,35.786499,35.900002,35.502499,35.540501,35.540501,38176000,754197147.6791252,277764297,28.43338529084985,76.0,1.0993251558085007,69.32263818470832,78.25991695483539,32.71017330769231,33.315106138932784,-21.740083045164607
2015-11-02,35.553001,36.081001,35.2925,36.0555,36.0555,37726000,789482946.0154623,315490297,29.68355993555058,76.0,1.1488051264530128,71.78633836603154,89.92863263684943,32.92005796153846,33.518098276789615,-10.071367363150573
2015-11-03,35.943001,36.232498,35.736,36.108002,36.108002,31308000,805090094.177187,346798297,30.95983026655631,72.0,1.1786678826394166,72.0329258481617,91.11820953066292,33.16480807692308,33.70994299702742,-8.881790469337068
2015-11-04,36.099998,36.654999,36.095001,36.405499,36.405499,34134000,808808153.4059699,380932297,32.453463982435,96.0,1.212364470732588,73.44899345637128,94.53869004297039,33.42084646153846,33.909613812062425,-5.461309957029619
2015-11-05,36.473499,36.973999,36.473499,36.5625,36.5625,37232000,784817652.8345417,418164297,34.056166490467696,100.0,1.237473108461053,74.19167276227022,91.5805848428471,33.657058,34.1061239000578,-8.419415157152892
2015-11-06,36.575001,36.7705,36.350498,36.688,36.688,30232000,803172852.2478783,448396297,35.26338669254895,96.0,1.2530542564424891,74.79851043582185,94.1483592535327,33.89257719230769,34.297373981535,-5.8516407464673
2015-11-09,36.509998,36.7355,35.9715,36.244499,36.244499,41396000,791360796.2374068,407000297,35.54624920689742,80.0,1.215602890827462,68.65495052919044,85.07417185183182,34.08100019230769,34.44160546438426,-14.925828148168186
2015-11-10,36.220001,36.529499,35.924999,36.416,36.416,32160000,811444277.3292178,439160297,35.70780962151168,80.0,1.1860886198660907,69.69163453991636,88.31048252026443,34.248019346153846,34.58785691146691,-11.689517479735562
2015-11-11,36.623001,37.049999,36.511501,36.77,36.77,27328000,810353183.2118767,466488297,36.34278489226583,96.0,1.177687540111556,71.76727232673827,85.90844786534885,34.421019384615384,34.749497140247136,-14.091552134651147
2015-11-12,36.549999,36.889999,36.432251,36.561501,36.561501,36744000,794359298.9961071,429744297,36.750775381872245,96.0,1.1410521580803774,68.77959253641168,75.41528707362205,34.59192326923077,34.883719648376974,-24.584712926377946
2015-11-13,36.4585,36.557499,35.836498,35.849998,35.849998,41510000,754403762.8595414,388234297,35.86509856235042,92.0,1.0425877059695665,59.653206322653276,36.70880801687765,34.7416155,34.95529582257127,-63.29119198312235
2015-11-16,35.779999,36.474499,35.566502,36.448002,36.448002,38118000,790297058.0510454,426352297,34.53340659585218,88.0,1.0012658736209872,63.979366791813106,68.24910337552758,34.90575019230769,35.06586665052895,-31.750896624472414
2015-11-17,36.4645,36.592251,36.151348,36.264999,36.264999,30218000,775657568.145103,396134297,33.451887506967594,60.0,0.9428822514262691,61.7956791786235,55.33425623570794,35.056961692307695,35.154691269008296,-44.66574376429206
2015-11-18,36.379002,37.070499,36.349998,37.0,37.0,33686000,802751407.0960553,429820297,33.04006612663476,80.0,0.9450275588073183,66.71015053794517,96.03492465406347,35.22561546153846,35.29138080463731,-3.9650753459365298
2015-11-19,36.937,37.099998,36.871498,36.920502,36.920502,26542000,787593776.1813937,403278297,32.69272542601356,84.0,0.9295970895610566,65.72534572919932,90.06936660510827,35.39340403846154,35.41205644873825,-9.930633394891727
2015-11-20,37.3265,37.896,37.150002,37.830002,37.830002,44246000,824010941.4981908,447524297,33.215496155639094,88.0,0.9794666981053055,70.99993241113513,97.16685740876359,35.57582711538462,35.59116352660949,-2.833142591236413
2015-11-23,37.872501,38.135399,37.591,37.799,37.799,28290000,817338615.2999427,419234297,33.91801169601269,92.0,1.004903221060431,70.60109263360556,86.90492456490081,35.756173230769235,35.75470696908286,-13.095075435099194
2015-11-24,37.599998,37.76395,36.8815,37.414001,37.414001,46662000,826991560.4231789,372572297,33.148102442972025,92.0,0.9826680613123315,65.66768703135385,71.91798659113228,35.91421173076923,35.87761763803969,-28.082013408867724
2015-11-25,37.407001,37.599998,37.303001,37.407501,37.407501,22442000,820342238.4636983,350130297,32.43318670800569,92.0,0.9535303371642456,65.58436225844656,71.66495970838861,36.102423307692305,35.990942331518234,-28.33504029161139
2015-11-27,37.423,37.670502,37.3745,37.513,37.513,16770000,819265679.7242303,366900297,31.85601423911544,88.0,0.9282510679637426,66.33110490273577,75.77174172417183,36.309442499999996,36.10368734399836,-24.228258275828168
2015-11-30,37.440498,37.746498,37.063499,37.130001,37.130001,41952000,785483214.0983655,324948297,30.70036591385306,80.0,0.8673143861916799,61.14424300858487,60.86265817586304,36.48407715384615,36.179710577776255,-39.13734182413696
2015-12-01,37.355499,38.447498,37.334999,38.352001,38.352001,42692000,820845844.9501684,367640297,30.49956987869319,100.0,0.9071695285504049,69.37323781954105,96.68527828570392,36.60915419230769,36.34062097942246,-3.314721714296084
2015-12-02,38.445,38.797749,37.948002,38.118999,38.118999,44608000,794191033.7840213,323032297,30.68548989578546,96.0,0.909469899018923,66.48209697053252,78.99417778956544,36.704538769230766,36.472352684650424,-21.005822210434552
2015-12-03,38.300499,38.449749,37.281502,37.626999,37.626999,51812000,773024762.9217803,271220297,29.631340301634015,96.0,0.8616599909926137,60.727041108608745,63.76785804365918,36.78925026923077,36.557882041342985,-36.23214195634082
2015-12-04,37.654999,38.4245,37.5,38.3405,38.3405,55146000,818149640.1527157,326366297,28.652487107064815,84.0,0.8713000574564234,65.40420241568258,85.84914740346363,36.892827230769235,36.689927816058315,-14.150852596536383
2015-12-07,38.3885,38.436501,37.754501,38.162498,38.162498,36246000,825270969.366792,290120297,27.7596902501429,84.0,0.8547238809542037,63.37637450698389,75.99566354456476,36.98192326923077,36.799007088942886,-24.00433645543524
2015-12-08,37.894501,38.240002,37.709999,38.1185,38.1185,36590000,845084618.365005,253530297,26.842570974289384,84.0,0.8284865930284866,62.857603142724,72.25007772440887,37.08107707692307,36.89674730457674,-27.749922275591132
2015-12-09,37.9585,38.211498,36.850052,37.580502,37.580502,54000000,849029333.0286791,199530297,25.34506470813442,44.0,0.7555716512857913,56.74141069584194,37.50326667854409,37.139731,36.94739580053402,-62.49673332145591
2015-12-10,37.642502,37.7925,37.191502,37.473,37.473,39768000,846514743.0699772,159762297,23.95452317527624,44.0,0.6812583989086249,55.577701480647214,31.9838249994737,37.19223092307692,36.9863294449389,-68.0161750005263
2015-12-11,37.057999,37.2855,36.837502,36.943501,36.943501,44488000,823078995.5889611,115274297,23.197983625724053,44.0,0.5730329003349652,50.124770222861756,5.407430798261491,37.21292330769231,36.98315696753602,-94.59256920173851
2015-12-14,37.0895,37.436501,36.2085,37.3885,37.3885,48250000,867556933.1069274,163524297,23.312845310010243,44.0,0.5172090493118944,54.1924355757138,45.57305998766432,37.244692538461535,37.013182377348166,-54.42694001233568
2015-12-15,37.650002,37.903999,37.150501,37.169998,37.169998,53324000,816992483.9697036,110200297,22.56715908999556,44.0,0.4501479347005244,51.951944694978536,37.1342424000163,37.263230923076925,37.02479834939645,-62.8657575999837
2015-12-16,37.5,38.029499,36.971748,37.904499,37.904499,39866000,847436134.0971911,150066297,22.110468251506642,44.0,0.4510699567605556,58.20698198335369,65.5015798017108,37.327077076923075,37.089961360552266,-34.498420198289196
2015-12-17,38.120998,38.133999,37.450001,37.4715,37.4715,31068000,818321154.2288288,118998297,21.493118371010354,44.00000000000001,0.41211070957955087,53.76352472702251,48.77862268171184,37.367673230769235,37.118223481992835,-51.22137731828816
2015-12-18,37.3255,37.706501,36.907501,36.9655,36.9655,62974000,764489654.9196916,56024297,21.632002254107327,44.0,0.3365259921633168,49.0511142865767,29.23627661920492,37.37519246153847,37.106910631474854,-70.76372338079508
2015-12-21,37.306499,37.5,37.0,37.3885,37.3885,30514000,781394410.9196917,86538297,21.76096585984023,44.0,0.307215732168693,52.77742905637403,45.57305998766432,37.40700011538461,37.12776910321745,-54.42694001233568
2015-12-22,37.5825,37.7425,37.276501,37.5,37.5,27308000,780280933.620384,113846297,21.383761718742814,44.0,0.28964540616527756,53.73791114315232,57.624119408419205,37.47046173076923,37.155341762238386,-42.375880591580795
2015-12-23,37.6735,37.710499,37.200001,37.515499,37.515499,31318000,787673237.5353845,145164297,21.145588378937163,40.0,0.2738150663487531,53.878340549805216,58.66240634541897,37.51151930769231,37.18202007614666,-41.33759365458103
2015-12-24,37.477501,37.567501,37.331001,37.419998,37.419998,10544000,785064834.7277734,134620297,20.924427420546202,-32.0,0.25067366545149383,52.81450389175453,54.376007910229816,37.55594234615385,37.199648070506164,-45.623992089770184
2015-12-28,37.646,38.149502,37.476002,38.1255,38.1255,30306000,813210761.6409141,164926297,19.519986613012343,-32.0,0.285965620127989,59.22038501381626,94.363677712353,37.59923080769231,37.26822969491311,-5.63632228764701
2015-12-29,38.334499,38.999001,38.321499,38.830002,38.830002,35300000,830899995.3258331,200226297,19.356959334608145,40.0,0.3665567342462879,64.41554924028586,93.9437756875916,37.67267311538462,37.38391653232695,-6.0562243124084
2015-12-30,38.830002,38.880001,38.345001,38.549999,38.549999,25866000,824856343.9912534,174360297,19.205576861804246,39.99999999999999,0.40318421414812633,61.084708973652035,83.90962769767864,37.70036530769231,37.470293011413844,-16.09037230232135
2015-12-31,38.474998,38.474998,37.917,37.944,37.944,30018000,797743322.145297,144342297,18.2572869320272,40.0,0.37894446519203484,54.51463705608606,62.19313306105256,37.705942230769224,37.50538241797579,-37.80686693894744
2016-01-04,37.150002,37.202999,36.562901,37.091999,37.091999,65456000,840497748.3237891,78886297,18.401185069199876,40.0,0.2876688617057326,46.88015568060769,31.66094547179882,37.69355753846154,37.47476142405166,-68.33905452820117
2016-01-05,37.322498,37.599998,36.931999,37.129002,37.129002,39014000,824495384.6945025,117900297,17.912491242736415,40.0,0.215830165393605,47.22583175931,23.238003366035983,37.68284603846154,37.44914961486265,-76.76199663396402
2016-01-06,36.5,37.359001,36.445999,37.181,37.181,38940000,848251718.19651,156840297,18.009404748261982,40.0,0.16123467209614972,47.74048216446418,28.789675840441845,37.67007680769231,37.429286680428376,-71.21032415955816
2016-01-07,36.515499,36.924999,35.952999,36.3195,36.3195,59274000,833677266.0853987,97566297,18.600804563735966,-24.0,0.047899346326389036,40.66487533454452,12.032198271701704,37.63890369230769,37.347080259655904,-87.9678017282983
2016-01-08,36.572498,36.661499,35.650002,35.723499,35.723499,49018000,791782719.6319734,48548297,19.436484787935125,-28.0,-0.08898623763939639,36.62111972326468,2.1945960569112195,37.53780746153846,37.226814981162875,-97.80540394308878
2016-01-11,35.830502,35.942749,35.176998,35.801498,35.801498,41812000,818169374.2860323,90360297,20.629775407065505,-32.0,-0.18899654715515624,37.49709607232673,16.339599942752645,37.448672807692304,37.12123594552118,-83.66040005724736
2016-01-12,36.084,36.4375,35.865849,36.303501,36.303501,40490000,839677094.8533012,130850297,20.898879522322876,-32.0,-0.22515257259166788,42.96121387642559,29.474152689048097,37.39776903846154,37.060662986593684,-70.52584731095192
2016-01-13,36.5425,36.737,34.9305,35.028,35.028,50034000,795043941.7949008,80816297,21.955579013182383,-40.0,-0.35266346918618297,34.66823183410561,2.396460022991186,37.27036519230769,36.91009535795712,-97.60353997700881
2016-01-14,35.269001,36.096249,34.455002,35.736,35.736,44516000,820017673.6487898,125332297,23.284106307709813,-43.99999999999999,-0.3920675794048307,41.42701726147687,28.1909833166776,37.17703834615385,36.82312533144177,-71.8090166833224
2016-01-15,34.614498,35.337002,34.268501,34.7225,34.7225,72162000,809177985.6316513,53170297,24.649149798300233,-48.0,-0.49932074177664987,35.728812995730706,9.597273015537388,37.04642296153846,36.667523455038676,-90.4027269844626
2016-01-19,35.165001,35.499001,34.670502,35.0895,35.0895,45362000,809697965.6364553,98532297,25.63051547699164,-48.0,-0.5483843790562659,39.00075646853428,17.355438114364244,36.950615192307694,36.550632828739516,-82.64456188563577
2016-01-20,34.4305,35.342499,33.662998,34.922501,34.922501,68900000,844137894.2223864,29632297,27.23959946652238,-56.0,-0.5938970136308228,38.05147829662148,24.142270955182422,36.85251907692307,36.43003047105511,-75.85772904481759
2016-01-21,35.109001,35.959499,34.723,35.329498,35.329498,48244000,843220886.8232701,77876297,27.731837237705715,-56.0,-0.5903200063757765,41.77127951004746,34.63216957605985,36.790442038461535,36.34850954727325,-65.36783042394015
2016-01-22,36.18,36.406502,36.00605,36.262501,36.262501,40236000,854519464.930009,118112297,27.529901969705634,-56.0,-0.506362624550583,49.28871810130301,66.02750825501651,36.747134384615386,36.342138543771526,-33.972491744983486
2016-01-25,36.179001,36.484001,35.5005,35.5835,35.5835,34234000,826063643.0914953,83878297,27.757034848512383,-56.0,-0.48897885674394104,44.75981544361084,48.78084836169673,36.68611523076923,36.28594309608474,-51.21915163830327
2016-01-26,35.692501,35.914001,35.324001,35.652,35.652,26634000,829042949.416919,110512297,28.107727354605533,-56.0,-0.46432229955362914,45.305813966150744,53.81494549652694,36.59948065384616,36.238984348226616,-46.18505450347306
2016-01-27,35.683498,35.911751,34.719501,34.9995,34.9995,43884000,805771197.0428361,66628297,28.887119040648248,-56.0,-0.4917643439252828,41.13498555130993,40.97184519563289,36.504403730769226,36.147170692802426,-59.02815480436711
2016-01-28,36.111,36.684502,35.6175,36.548,36.548,53528000,845603479.4040688,120156297,28.469391813143964,-56.0,-0.38413330354494946,52.34679856216567,93.85166307634152,36.488346038461536,36.17686175259484,-6.148336923658476
2016-01-29,36.5765,37.2495,36.34,37.147499,37.147499,69486000,899503681.7438167,189642297,27.352068449999543,-56.0,-0.24760612030058837,55.852587618994285,97.15597537656484,36.47907676923077,36.248760807958185,-2.8440246234351565
2016-02-01,37.522999,37.893002,37.163502,37.599998,37.599998,102784000,919721202.9610881,292426297,25.569925329932776,-56.0,-0.10172186994901722,58.343672476481856,93.07319803952896,36.48292284615385,36.34885245181314,-6.926801960471037
2016-02-02,39.224998,39.4935,38.232498,38.232498,38.232498,126962000,792759202.9610881,419388297,25.02300557646087,36.0,0.06418997143696004,61.60493849719852,78.37232540182649,36.510499730769226,36.48838175167883,-21.627674598173513
2016-02-03,38.511002,38.724998,36.025002,36.3475,36.3475,123420000,698822730.4626099,295968297,23.873107993892557,36.0,0.04307616088252786,49.233937008392374,46.042381942412455,36.46924980769231,36.47794606636929,-53.957618057587545
2016-02-04,36.140499,36.349998,35.092999,35.400501,35.400501,103374000,646025877.6966171,192594297,23.41542907762544,35.99999999999999,-0.04950097457615499,44.409080299243,29.8002298944413,36.364442153846156,36.398135320712306,-70.1997701055587
2016-02-05,35.193501,35.199501,34.0075,34.178501,34.178501,102114000,573209833.1748419,90480297,23.61091257706649,36.0,-0.2189502861226913,39.08616792646105,8.841485690254386,36.18553826923077,36.23371796362251,-91.15851430974561
2016-02-08,33.392502,34.2015,33.153,34.137001,34.137001,84948000,647706596.0704062,5532297,24.224522981034454,-16.0,-0.3525250996007685,38.91557439609695,15.51929658544278,36.01580757692307,36.07840559594677,-84.48070341455721
2016-02-09,33.616001,34.994999,33.438499,33.905499,33.905499,72178000,618840033.2692497,-66645703,24.079318587273033,-16.0,-0.4716277472020991,37.92128269115157,11.868133427963102,35.86048061538462,35.91744955180256,-88.1318665720369
2016-02-10,34.342999,35.065498,34.106499,34.206001,34.206001,52760000,577028377.3655419,-13885703,23.881710622904283,-16.0,-0.5355954426481375,40.062050452244726,16.607538837631136,35.74948069230769,35.790675585002376,-83.39246116236886
2016-02-11,33.75,34.467499,33.443401,34.155499,34.155499,60480000,600656904.166688,-74365703,24.079889332007543,-16.0,-0.5836375807594365,39.8135633996264,15.811040138790323,35.635115192307694,35.66955139352071,-84.18895986120967
2016-02-12,34.513,34.6875,33.93,34.119999,34.119999,42828000,579313464.356787,-117193703,24.049607250130567,-16.0,-0.61745820086648,39.62749540609706,15.251147385852875,35.51738438461538,35.554769734741406,-84.74885261414713
2016-02-16,34.648998,34.900002,34.252499,34.549999,34.549999,50400000,575226763.2913091,-66793703,23.809079386634437,-16.0,-0.602617282706845,43.09649635148479,22.032946928475692,35.44932665384615,35.48034227290871,-77.9670530715243
2016-02-17,34.904499,35.487499,34.569,35.419998,35.419998,49852000,617751461.1342027,-16941703,23.00976800688118,-16.0,-0.5147207196734414,49.42804501148751,35.75424651052759,35.43765353846153,35.47587232676732,-64.2457534894724
2016-02-18,35.5,35.6175,34.801498,34.8675,34.8675,37664000,586180336.7104878,-54605703,22.141475600041698,-15.999999999999993,-0.4840640424287628,45.93270368972936,27.04045422285311,35.401730538461536,35.43080770996974,-72.9595457771469
2016-02-19,34.751499,35.154049,34.702499,35.045502,35.045502,31786000,602684419.1288244,-22819703,21.41600997544264,-16.0,-0.44032928911821756,47.22750357424057,29.847835344215767,35.35334596153846,35.40226654626828,-70.15216465578423
2016-02-22,35.372501,35.661999,35.1255,35.323002,35.323002,38996000,592399704.674557,16176297,20.21823019436358,-16.0,-0.37890941926957566,49.26726359702945,34.22446179323404,35.36469219230769,35.39639509839655,-65.77553820676596
2016-02-23,35.072498,35.419998,34.679001,34.7925,34.7925,40186000,564524337.0091006,-24009703,19.503805152503706,-16.0,-0.3687896304221283,45.635768001638866,29.423915801836216,35.32840373076923,35.35166212814495,-70.57608419816378
2016-02-24,34.445999,35.0,34.039001,34.978001,34.978001,39272000,601998323.2172027,15262297,19.370784560911602,-16.000000000000007,-0.3418604895254447,47.103997172754646,57.08483395985859,35.33823069230769,35.32398352606014,-42.91516604014141
2016-02-25,35.0005,35.299,34.529251,35.287498,35.287498,32844000,633860778.0953512,48106297,18.911592418709834,-16.0,-0.2921770943553881,49.55204032795761,85.07368874997552,35.345846,35.32128089450013,-14.926311250024483
2016-02-26,35.429001,35.671501,35.042999,35.253502,35.253502,44870000,619047228.5441958,3236297,18.074826629065278,-16.0,-0.25263363552578966,49.282239851258325,83.40286543463745,35.35857680769231,35.316260235648265,-16.59713456536256
2016-02-29,35.015999,35.544498,34.883999,34.8885,34.8885,49622000,570101531.2244418,-46385703,17.44929113056713,-15.999999999999996,-0.2478902460094332,46.36341082497276,64.93505155839541,35.341615346153844,35.28457429226691,-35.06494844160458
2016-03-01,35.181,35.940498,34.988499,35.940498,35.940498,43028000,613129531.2244418,-3357703,16.417537955733525,-16.0,-0.15742888674722622,54.692421575320004,100.0,35.32923061538462,35.333161233580476,-0.0
2016-03-02,35.950001,36.0,35.599998,35.942501,35.942501,32580000,636342990.9571431,29222297,15.391368581260867,-16.0,-0.08460075756175911,54.70684324615353,97.75095742429689,35.34303834615385,35.37829751257451,-2.249042575703112
2016-03-03,35.933998,35.9725,35.300999,35.620998,35.620998,39160000,634505826.9320712,-9937703,14.772279874521677,-16.0,-0.05222453375478153,51.8537643492624,81.69072463768117,35.34184596153846,35.39627532645788,-18.30927536231883
2016-03-04,35.7495,35.824501,35.300999,35.544498,35.544498,39442000,631755520.7861538,-49379703,14.197411789692428,-16.000000000000004,-0.032365959162369506,51.16993446574466,76.7719412401535,35.36280742307692,35.4072547837573,-23.228058759846512
2016-03-07,35.345001,35.404549,34.345001,34.757999,34.757999,59702000,618595643.6460897,-109081703,14.66509864774144,-16.0,-0.07917906500406957,44.65042649658869,36.66488356189875,35.293961230769234,35.359161762738246,-63.33511643810125
2016-03-08,34.429501,35.189499,34.266998,34.698502,34.698502,41526000,615917590.9198594,-150607703,15.173177433617099,-16.0,-0.11969987368341606,44.19173301400466,33.63086875617981,35.19976903846154,35.31022400253541,-66.36913124382019
2016-03-09,34.9235,35.284,34.700001,35.262001,35.262001,28430000,642205698.3138788,-122177703,15.499494769272752,-16.0,-0.10513135770646187,49.48473832706156,62.366171527879324,35.10984607692308,35.30665192827353,-37.633828472120676
2016-03-10,35.405998,35.821999,35.167999,35.640999,35.640999,56670000,667507900.1487415,-65507703,15.0070999592273,-12.0,-0.06228574139737475,52.73187536360596,81.69295343852806,35.01017303846154,35.331418378031046,-18.307046561471935
2016-03-11,36.0,36.346001,35.856251,36.341,36.341,39416000,706118920.3998901,-26091703,14.009913557111995,-8.0,0.027833106040198174,58.09032035801446,99.78322496749024,35.00992303846154,35.4062022018806,-0.21677503250975416
2016-03-14,36.3405,36.775002,36.2575,36.524502,36.524502,34366000,707214776.5163878,8274297,13.597564994105182,96.0,0.11276019043100405,59.38998232029801,90.84430159199495,35.05315384615385,35.489039223963516,-9.15569840800505
2016-03-15,36.346001,36.614498,36.238499,36.4165,36.4165,34420000,705384195.2116506,-26145703,13.187965765161067,96.0,0.16939794383769424,58.24512509599748,85.70568467992868,35.13923073076923,35.55774002218844,-14.294315320071318
2016-03-16,36.318501,36.873501,36.225498,36.804501,36.804501,32488000,730953486.5019691,6342297,13.125214802888511,100.0,0.24279343788752072,61.143083810098716,97.35277496323636,35.241826884615385,35.65009268721152,-2.6472250367636487
2016-03-17,36.822498,37.1535,36.799999,36.889,36.889,37216000,712477242.3499023,43558297,13.400131062654909,96.0,0.30427081427541225,61.765447753013355,90.83665973555543,35.35657692307692,35.74186359926993,-9.163340264444583
2016-03-18,37.092999,37.099998,36.591499,36.880001,36.880001,59614000,720508442.1556052,-16055703,13.313576822682265,96.0,0.3482515072941368,61.652194158131394,90.52489830251282,35.45942307692307,35.826170073398075,-9.475101697487167
2016-03-21,36.825001,37.125,36.6758,37.1045,37.1045,36730000,753885971.0959438,20674297,13.266169203374611,92.0,0.39664938920572723,63.452589401866206,98.30244358049987,35.57284619230769,35.9208611790723,-1.6975564195001245
2016-03-22,36.873001,37.25,36.873001,37.037498,37.037498,25394000,750652437.3995677,-4719703,13.393841864160294,76.0,0.42470284780649337,62.509331973895186,92.8762367574678,35.685057692307694,36.00357501765953,-7.123763242532211
2016-03-23,37.118,37.285999,36.807499,36.903,36.903,28642000,733443413.9596512,-33361703,13.386725922207079,80.0,0.4311129495842181,60.56306908036882,87.313717352197,35.77555773076923,36.07019909042549,-12.686282647802987
2016-03-24,36.600498,36.887348,36.549999,36.764999,36.764999,31898000,742204019.7358655,-65259703,12.888078147279296,80.0,0.42021351422962994,58.548763019729215,82.74263572618908,35.82728853846153,36.121665750393966,-17.25736427381092
2016-03-28,36.8395,36.949501,36.625,36.676498,36.676498,26026000,724438622.6184456,-91285703,12.529064424483712,80.0,0.39982540374691666,57.234074482307335,79.8111693238924,35.89686538461538,36.162764435549974,-20.188830676107607
2016-03-29,36.7295,37.362499,36.438,37.238499,37.238499,38076000,752300606.1619647,-53209703,12.85504299994197,92.0,0.42412738665935734,62.927011084848225,95.34271950626808,35.98121142307693,36.24244847736109,-4.657280493731915
2016-03-30,37.505001,37.894001,37.437,37.526501,37.526501,35648000,730615514.9871101,-17561703,13.879747518940727,96.0,0.4613085597484812,65.46419067327449,86.51871862162979,36.065961384615385,36.337563479038046,-13.481281378370213
2016-03-31,37.462502,37.5425,37.047001,37.247501,37.247501,34376000,724059502.5148348,-51937703,14.032827269333419,96.0,0.4629256206046577,61.1016458783693,68.27383143172605,36.1603845,36.40496625836856,-31.72616856827395
2016-04-01,36.93,37.516998,36.849998,37.495499,37.495499,31534000,753560670.532826,-20403703,13.796874367656727,60.0,0.47870035921727094,63.434240920865854,76.11619517615489,36.257211346153845,36.48574646145237,-23.883804823845104
2016-04-04,37.502998,37.639999,37.121498,37.2645,37.2645,22684000,743389114.5512556,-43087703,13.767562596523343,60.0,0.4671769395067287,59.83500699751907,62.27150925110687,36.333249884615384,36.5434319087522,-37.72849074889313
2016-04-05,36.900002,37.139999,36.768501,36.889999,36.889999,22646000,735555811.8363017,-65733703,13.058085097055748,60.0,0.4229499418473992,54.441808159430195,39.826179515409976,36.39619207692308,36.56910354514092,-60.173820484590024
2016-04-06,36.788502,37.312,36.778,37.2845,37.2845,21074000,754459268.7651409,-44659703,12.690064919473453,60.0,0.4149493830904092,58.66807159700192,58.138696333312865,36.48834592307692,36.622095875130476,-41.861303666687135
2016-04-07,37.268501,37.349998,36.813999,37.014,37.014,29064000,747084969.9175686,-73723703,12.413922575320106,60.0,0.38237402357321315,54.90691858793089,39.56041238982667,36.529634461538464,36.651125810306,-60.43958761017333
2016-04-08,37.198502,37.272499,36.7775,36.9575,36.9575,25816000,740044280.5747617,-99539703,12.078148056508356,60.0,0.3479873570161729,54.126380613421865,35.679920549505155,36.56867288461538,36.673820194727774,-64.32007945049484
2016-04-11,37.151001,37.25,36.802502,36.805,36.805,24402000,715914711.7185884,-123941703,11.766357431897445,60.0,0.30491532644280284,51.97856340798295,25.206026644212276,36.614211423076924,36.683537217340536,-74.79397335578773
2016-04-12,36.900002,37.191502,36.550499,37.154499,37.154499,27060000,739850541.6913031,-96881703,10.956395080830687,60.0,0.29557487711674924,56.26214090290967,49.21006235572631,36.67613453846154,36.71842327531531,-50.78993764427369
2016-04-13,37.458,37.719002,37.213051,37.585999,37.585999,34142000,756042232.5665063,-62739703,11.187446062645902,60.0,0.3193101390166504,60.899524914131085,78.84603101234121,36.78490376923077,36.782688143810475,-21.153968987658782
2016-04-14,37.7005,37.865501,37.63525,37.66,37.66,22706000,738217631.5615155,-40033703,11.657694179224348,56.00000000000001,0.3401704936217982,61.6504850549062,83.92851378536098,36.89880753846154,36.84767420723192,-16.07148621463902
2016-04-15,37.699001,38.049999,37.634701,37.950001,37.950001,36186000,756977457.4503953,-3847703,12.408884639947079,100.0,0.3757714723737351,64.52585285776985,93.79664627583519,37.00219215384615,36.92932804373326,-6.2033537241648125
2016-04-18,38.022999,38.4025,37.865002,38.330502,38.330502,31176000,779801390.473402,27328297,13.658139820099354,100.0,0.4297350372378048,67.92408875775828,96.11242110560413,37.10563457692307,37.03311870716042,-3.8875788943958787
2016-04-19,38.475498,38.494999,37.466499,37.696499,37.696499,40610000,757354346.2342191,-13281703,13.817894272324196,92.0,0.41654118022545816,57.96092904281633,58.935458986886196,37.157769153846154,37.0822579881115,-41.064541013113804
2016-04-20,37.900002,37.906601,37.5005,37.633499,37.633499,30584000,746803005.1835935,-43865703,13.966237692247265,92.0,0.3964315637032456,57.06519618381982,55.695551555669816,37.200422884615385,37.1230906556588,-44.304448444330184
2016-04-21,37.769001,38.022499,37.477501,37.957001,37.957001,61210000,793300538.0552728,17344297,14.314769247371547,92.0,0.40196485487583544,60.44553180411428,72.33232193365892,37.25967292307692,37.18486179227666,-27.667678066341082
2016-04-22,36.314999,36.806,35.6805,35.938499,35.938499,119038000,728836833.85625,-101693703,15.082251871876606,-12.0,0.24069915588141555,39.5317278272232,9.166782436234595,37.22636515384615,37.09253862247839,-90.8332175637654
2016-04-25,35.805,36.196499,35.779499,36.157501,36.157501,39184000,760691828.4269936,-62509703,15.794914308917015,-12.0,0.12907862070480292,41.88129746229398,16.94798967773667,37.19823057692308,37.023276576368886,-83.05201032226333
2016-04-26,36.271,36.2883,35.151299,35.407001,35.407001,54892000,730489330.342999,-117401703,17.153981713123382,-20.0,-0.01971329284615564,36.628748166300795,7.647276968627555,37.14157673076923,36.90355245960082,-92.35272303137245
2016-04-27,35.364498,35.449001,34.618252,35.292,35.292,61972000,769037489.9965165,-179373703,18.91121558985108,-24.0,-0.14523736992630631,35.88605181046458,17.379209940705522,37.07186519230769,36.78417820333409,-82.62079005929449
2016-04-28,35.412998,35.7085,34.477501,34.550999,34.550999,57346000,718539288.0987083,-236719703,20.008071766577274,-28.0,-0.30103850872212945,31.459702456694473,1.82944708373223,36.976230615384615,36.618757521605644,-98.17055291626777
2016-04-29,34.535,34.881001,34.450001,34.650501,34.650501,49754000,715076132.646272,-186965703,21.054716614300776,-32.0,-0.4117368082490884,32.66082005732568,4.956739162788168,36.88959603846154,36.47296074222744,-95.04326083721183
2016-05-02,34.8815,35.032001,34.549999,34.9105,34.9105,32906000,731392525.5243095,-154059703,21.69743018172227,-32.0,-0.4730334268727887,35.82547774590455,11.384406123315728,36.81826915384616,36.357222909469854,-88.61559387668427
2016-05-03,34.843498,34.891998,34.599998,34.618,34.618,30876000,704323578.6202005,-184935703,22.29423563718509,-32.0,-0.539000482183404,33.89555240090468,4.153252980594844,36.739096153846155,36.22839158284246,-95.84674701940516
2016-05-04,34.524502,34.987499,34.4505,34.785,34.785,33870000,712649243.7890366,-151065703,23.03731531745294,-31.999999999999993,-0.5712196795671218,36.01490219142265,8.281808791994367,36.64473080769231,36.121473687817094,-91.71819120800563
2016-05-05,34.884998,35.116001,34.785999,35.071499,35.071499,33670000,737238193.7347957,-117395703,23.406801754644906,-32.0,-0.5670983934196983,39.59298711453687,15.364605866307045,36.550307653846154,36.04369778501583,-84.63539413369296
2016-05-06,34.918999,35.592999,34.90535,35.556,35.556,36586000,769887169.4273363,-80809703,22.659367297001715,-32.0,-0.5187571533506983,45.17635172038706,27.342386819474253,36.48524992307692,36.00757202316281,-72.65761318052574
2016-05-09,35.599998,35.935501,35.5,35.645,35.645,30206000,759795336.7886057,-50603703,21.285101365409506,-32.0,-0.4678714848823802,46.16078738852906,33.44995574525169,36.41407688461538,35.98071483626186,-66.55004425474831
2016-05-10,35.837502,36.174999,35.785999,36.159,36.159,31392000,788605122.8657264,-19211703,19.96152056773113,-32.0,-0.38166907813504025,51.569525211955124,47.837647494834066,36.37155765384615,35.99392114468691,-52.162352505165934
2016-05-11,36.170502,36.223999,35.639999,35.7645,35.7645,33842000,769192447.6670958,-53053703,18.615748297820147,-32.0,-0.3412521602773211,47.61571252903974,55.793699403098195,36.32826923076923,35.97692698582121,-44.206300596901805
2016-05-12,35.853001,35.962502,35.450001,35.665501,35.665501,27214000,764864713.25487,-80267703,17.72069758602077,-32.0,-0.3135949265109943,46.64913861623449,66.1209085137945,36.26600003846154,35.9538583942789,-33.879091486205496
2016-05-13,35.5965,35.833099,35.463001,35.5415,35.5415,26290000,749727103.7568454,-106557703,16.889579067921346,-31.999999999999996,-0.2982442399247134,45.40583969523164,59.375487883091886,36.209365423076925,35.92331332803602,-40.624512116908114
2016-05-16,35.456501,35.924,35.282501,35.824501,35.824501,26342000,767897609.622014,-80215703,16.469448873134187,-32.00000000000001,-0.2602429756200806,48.7622093706121,77.48035792599532,36.16578853846154,35.91599389632965,-22.51964207400468
2016-05-17,35.7995,36.076,35.205502,35.311501,35.311501,40024000,737620912.8346575,-120239703,15.719514329057487,-32.0,-0.26842725030311954,43.53708079010066,48.56262521152786,36.10834626923077,35.87121664474968,-51.43737478847214
2016-05-18,35.183498,35.580002,35.031502,35.331501,35.331501,35336000,740938567.0333815,-84903703,15.378973693129383,-32.0,-0.2701849897236954,43.789966776153605,49.690022198446854,36.03823096153846,35.831237708101554,-50.309977801553146
2016-05-19,35.118,35.299999,34.84,35.015999,35.015999,33404000,733095799.1056249,-118307703,15.438559179092051,-32.0,-0.29365135548370347,40.69365331880291,31.88606252385833,35.939384807692306,35.770849655649585,-68.11393747614167
2016-05-20,35.081001,35.729,35.026001,35.487,35.487,36568000,744487501.557549,-81739703,14.458296771492943,-32.0,-0.2711175012445821,46.747290772678454,58.44378824008376,35.85580788461538,35.7498237552311,-41.55621175991624
2016-05-23,35.3265,35.573898,35.209,35.212002,35.212002,26614000,718311406.0020779,-108353703,13.548053107293772,-32.0,-0.2723102763991747,43.927943962037354,42.93783080791135,35.75050023076923,35.709985106695456,-57.06216919208865
2016-05-24,35.342999,36.0485,35.342999,36.004501,36.004501,38590000,752088028.2464122,-69763703,13.460322249740711,-32.0,-0.20692224238754875,52.76846713892555,84.73588317107085,35.661038653846155,35.73180109879209,-15.264116828929149
2016-05-25,36.037998,36.3755,35.985249,36.2635,36.2635,32584000,765969152.4049661,-37179703,13.960509781641028,-24.000000000000004,-0.1326733240891187,55.25156255803399,92.70595897101909,35.60592330769231,35.77118620258527,-7.294041028980915
2016-05-26,36.143501,36.4165,36.014,36.206001,36.206001,31526000,764520287.9378853,-68705703,14.495331872012573,-24.0,-0.07757596275457246,54.56571420507033,86.64770060260075,35.55101953846154,35.80339470609747,-13.352299397399253
2016-05-27,36.2005,36.6968,36.200001,36.632999,36.632999,39500000,793874778.3857317,-29205703,15.460822925368275,-20.0,0.0005380606585845271,58.668810179576944,96.56392718655724,35.50009638461539,35.86484687601617,-3.436072813442757
2016-05-31,36.587002,36.9865,36.563,36.785999,36.785999,42590000,796137328.137797,13384297,16.794912986340318,84.0,0.07393750281238454,60.060618964619685,90.65916608432318,35.53269253846154,35.93308036668164,-9.340833915676827
2016-06-01,36.726501,36.8605,36.533001,36.7075,36.7075,25072000,797783204.6992526,-11687703,17.943642062160855,84.0,0.12433956714584582,58.96352833413219,87.00209643605885,35.55384634615385,35.99044478396448,-12.997903563941154
2016-06-02,36.625,36.651001,36.2085,36.52,36.52,26836000,808729781.4617913,-38523703,18.073541857149504,84.0,0.14745412390686852,56.31736376147506,78.26694619147462,35.596653999999994,36.02967109626341,-21.733053808525376
2016-06-03,36.463501,36.474499,36.028,36.117001,36.117001,24526000,793981355.5481837,-63049703,17.716628028919377,84.0,0.13173536212240577,51.01777377609764,59.49224318658285,35.62838480769231,36.03613997802167,-40.50775681341715
2016-06-06,36.245499,36.245499,35.730499,35.827499,35.827499,31306000,774468295.354009,-94355703,16.65705415749046,84.0,0.09482465859187528,47.55571116694329,46.00507803400892,35.677480961538464,36.02068509076081,-53.99492196599108
2016-06-07,35.992001,36.098999,35.827499,35.8325,35.8325,26724000,748728801.6081527,-67631703,15.673164134020753,72.0,0.06522433350564683,47.62183433731953,46.23806196133247,35.722942461538466,36.00674545440816,-53.76193803866753
2016-06-08,36.198002,36.428501,36.028999,36.414001,36.414001,31674000,778103574.0698678,-35957703,15.479495952961155,72.0,0.0876774425291984,54.76383011181353,73.32872117400412,35.78076942307692,36.03691253185941,-26.67127882599588
2016-06-09,36.143501,36.477001,36.116798,36.429001,36.429001,19778000,792610413.0856448,-16179703,15.400283298350562,72.0,0.10546631777523174,54.93453213353628,71.56341319225359,35.85042330769231,36.06595612209205,-28.436586807746412
2016-06-10,35.973499,36.294498,35.821499,35.970501,35.970501,24328000,783609805.5579331,-40507703,14.542941094130581,68.0,0.08162607681101264,48.864648295061954,42.84112517580856,35.896019499999994,36.05888537230745,-57.15887482419144
2016-06-13,35.8255,36.271999,35.8255,35.917999,35.917999,25178000,768863810.2074399,-65685703,13.746837618783456,28.0,0.05782941990958079,48.207787501242116,34.98628841722656,35.92857719230769,36.04844934472912,-65.01371158277344
2016-06-14,35.824001,36.123501,35.655998,35.913502,35.913502,26122000,771518179.5056053,-91807703,12.965634865738222,28.0,0.03816755572857744,48.148085442229835,19.353898002408403,35.942327269230766,36.038453245119555,-80.6461019975916
2016-06-15,35.950001,36.148998,35.865501,35.945999,35.945999,24290000,761022303.7467788,-67517703,12.169501418167444,28.000000000000004,0.024920356661077392,48.64305259327196,21.796359569546166,35.95390415384615,36.03160478251811,-78.20364043045383
2016-06-16,35.745499,35.8325,35.162998,35.518002,35.518002,39650000,763421195.6096859,-107167703,12.988968229911334,28.0,-0.019884706501905214,42.842509938008455,19.46825394213998,35.929250384615386,35.99356013196122,-80.53174605786002
2016-06-17,35.432499,35.441002,34.4226,34.585999,34.585999,68048000,717209317.5968775,-175215703,14.848663395295151,-52.0,-0.12910959978911762,33.47996243234391,6.373064472093237,35.88392342307692,35.889296344408535,-93.62693552790677
2016-06-20,34.938499,35.124001,34.670502,34.685501,34.685501,41650000,678314377.0347158,-133565703,16.575523191722983,-52.0,-0.2052758426803578,35.110360576618845,10.783912383608822,35.84623111538462,35.80012631889679,-89.21608761639118
2016-06-21,34.919998,35.1385,34.600498,34.797001,34.797001,29312000,670414549.9857457,-104253703,18.27316861741705,-52.0,-0.2537163367668853,36.974528498439234,16.801329742716828,35.81759653846154,35.725820739719246,-83.19867025728317
2016-06-22,34.952999,35.042999,34.654099,34.873001,34.873001,23686000,673393053.8273503,-80567703,19.84955365556154,-52.0,-0.28271425849545295,38.27615402384275,21.92371401688374,35.78100038461538,35.66264890714745,-78.07628598311626
2016-06-23,34.872501,35.0975,34.349998,35.093498,35.093498,43428000,716356041.4099922,-37139703,21.73177496215074,-68.0,-0.28462210875577654,42.017603547637165,34.9552868519695,35.77261565384615,35.62048958069208,-65.04471314803051
2016-06-24,33.758499,34.470001,33.672501,33.761002,33.761002,88980000,647124803.7422806,-126119703,24.212273023509987,-72.0,-0.38916928364627523,30.13118466089064,3.1556783740417433,35.71221184615385,35.482749759900074,-96.84432162595827
2016-06-27,33.549999,33.615002,33.1642,33.412998,33.412998,52580000,652582695.4996382,-178699703,26.930769142310446,-76.0,-0.49440548866138556,27.91048351145774,7.5102005825282205,35.65055796153846,35.32943481472229,-92.48979941747177
2016-06-28,33.948502,34.016499,33.650002,34.001999,34.001999,43476000,692618547.2855997,-135223703,28.273113506345812,-76.0,-0.5242354214947511,36.44779302752226,25.289747256173758,35.59344253846154,35.23110623585398,-74.71025274382625
2016-06-29,34.150002,34.371449,34.070499,34.205502,34.205502,38652000,688644307.4185133,-96571703,28.598438895589318,-76.0,-0.5253984011049937,39.12999642662496,33.26526739626716,35.554731000000004,35.15513555171665,-66.73473260373284
2016-06-30,34.273499,34.616001,34.182499,34.605,34.605,31954000,718976511.1915063,-64617703,28.315935325468896,-76.0,-0.4884533349750697,44.116257686400814,46.36078459385552,35.50090403846154,35.114384770108,-53.63921540614448
2016-07-01,34.610001,35.032501,34.606499,34.960499,34.960499,26894000,736779371.7696251,-37723703,27.14962357394726,-76.0,-0.42558245598467437,48.18391846192169,60.18159352827223,35.45078861538462,35.10298582417408,-39.81840647172777
2016-07-05,34.803001,34.847,34.444,34.747501,34.747501,29252000,751586980.9606918,-66975703,26.323845154913393,-76.0,-0.38846599573880525,46.02244095313879,53.045499226413305,35.39469246153846,35.076653614975996,-46.954500773586695
2016-07-06,34.499001,35.084,34.454498,34.8885,34.8885,28238000,762285627.6305989,-38737703,25.058490884638427,-76.0,-0.3437114015776501,47.695132649660685,64.62166922759802,35.32759634615385,35.06271631016296,-35.37833077240197
2016-07-07,34.903999,34.91,34.410751,34.768002,34.768002,26084000,773531837.942488,-64821703,23.96094892151566,-72.0,-0.3143426978721564,46.372581662489985,70.44099574754433,35.24998107692308,35.040885620521266,-29.559004252455672
2016-07-08,34.974998,35.2855,34.821751,35.281502,35.281502,31504000,804492643.2746834,-33317703,22.331290083662577,-68.0,-0.24678781379665793,52.42665088101729,99.81153066515836,35.195135,35.05870905603821,-0.18846933484164102
2016-07-11,35.4025,35.8255,35.362,35.754501,35.754501,22236000,819916415.5983078,-11081703,21.75515013741251,-48.0,-0.15331568736945655,57.217684675315695,97.33216848908427,35.16569273076923,35.11024920003538,-2.6678315109157387
2016-07-12,35.956001,36.146999,35.795502,36.032001,36.032001,26738000,829158866.4243463,15656297,21.700401789252783,-48.0,-0.056198600426547785,59.77702004504983,96.14462791492153,35.1624235,35.17852711114387,-3.8553720850784763
2016-07-13,36.181,36.200001,35.842499,35.848999,35.848999,18718000,811121517.1619649,-3061703,21.72706061184177,-48.00000000000001,0.005932275103383233,57.34086628287936,88.43791144412953,35.163250423076924,35.22819169550358,-11.562088555870467
2016-07-14,36.078999,36.1105,35.901501,36.047501,36.047501,19004000,818668687.2632563,15942297,21.751815232817258,-48.0,0.07037762459147245,59.279421212232165,94.97661407977651,35.17151969230769,35.28888127361442,-5.0233859202234745
2016-07-15,36.286499,36.286999,35.952751,35.9925,35.9925,25586000,799168096.3846273,-9643703,22.05512244163409,-48.0,0.11567942690160038,58.486352171341814,90.56938983264688,35.15530811538462,35.34100117927262,-9.430610167353127
2016-07-18,36.135502,36.806499,36.059502,36.688999,36.688999,25910000,816926992.6988027,16266297,23.064411335792666,56.0,0.20541518168131745,64.89180876006918,96.27751903455001,35.16530803846154,35.44085286969687,-3.72248096544998
2016-07-19,36.494499,36.849499,36.450001,36.848,36.848,24550000,841292759.2358063,40816297,24.056862986387898,60.0,0.28606389916763675,66.17491362495767,99.94605973371708,35.199058,35.54508599046006,-0.05394026628292838
2016-07-20,36.866501,37.106499,36.855,37.059502,37.059502,25794000,857446636.4679232,66610297,25.30433287522855,64.0,0.3628621832475929,67.85770355542608,98.39271545827641,35.24296196153846,35.65726495412969,-1.6072845417235815
2016-07-21,37.018002,37.084499,36.79155,36.931499,36.931499,20526000,856532194.61627,46084297,26.2718455762277,64.0,0.40868553193419643,65.7265146501548,93.50829528576124,35.28211569230769,35.75165266123119,-6.491704714238758
2016-07-22,37.092999,37.161999,36.827999,37.137001,37.137001,25196000,877956640.0773473,71280297,27.276096561199942,72.0,0.4563229529059356,67.49172822390173,99.09139416003197,35.32792346153846,35.854271056695545,-0.9086058399680288
2016-07-25,37.033501,37.130501,36.875,36.988499,36.988499,20648000,875653205.08492,50632297,28.20861533295988,72.0,0.47659914366265355,64.8908306250288,93.69377097230043,35.38448103846154,35.93828794138476,-6.306229027699573
2016-07-26,36.952,37.084499,36.713501,36.921001,36.921001,23734000,878468162.2221547,26898297,28.519963238709675,72.0,0.48166926298870294,63.689442221785356,91.24041162410643,35.474288807692304,36.011081501282185,-8.759588375893571
2016-07-27,36.914001,37.223,36.849998,37.088501,37.088501,30250000,886902757.747112,57148297,29.043219858942173,84.0,0.4935142936516925,65.40130297773858,94.3987899630568,35.56671188461538,36.09089035303906,-5.601210036943197
2016-07-28,37.352001,37.432499,36.965,37.295502,37.295502,70604000,916126835.27455,127752297,29.865352293477223,88.0,0.5136833941010224,67.4440217534434,93.38338245997699,35.66280807692308,36.180120845406535,-6.616617540023011
2016-07-29,38.635502,38.927502,38.338501,38.439499,38.439499,76830000,865645436.855871,204582297,32.15984689785907,92.0,0.614890474007467,75.90921554035734,84.41880587484037,35.799981076923075,36.347482190191236,-15.581194125159623
2016-08-01,38.054501,39.0215,38.054501,38.644001,38.644001,54010000,877486373.6200248,258592297,33.49556301844923,96.0,0.7034900212389275,77.0576379070345,88.1252317945166,35.93653888461539,36.517594694621515,-11.874768205483404
2016-08-02,38.434502,38.792,38.392502,38.553501,38.553501,35690000,870562746.9685766,222902297,34.73587084471153,96.0,0.7576692674033083,75.34586624142486,85.00002724359827,36.12086576923077,36.66840256909399,-14.999972756401718
2016-08-03,38.359001,38.6605,38.341,38.659,38.659,25748000,896068981.7103605,248650297,35.73410938655468,92.0,0.7998988617782103,76.0147622674861,88.18736885942761,36.32263507692308,36.815854230642586,-11.812631140572389
2016-08-04,38.611,38.703499,38.439751,38.580502,38.580502,22806000,897604150.5988452,225844297,36.70736655580014,88.0,0.8176071210545217,74.39734805470925,85.11146867756156,36.498731346153846,36.94656888022462,-14.888531322438444
2016-08-05,38.688999,39.152,38.617001,39.111,39.111,36024000,928106704.7643665,261868297,38.06095550248968,100.0,0.8644825820709556,77.83047282097138,98.4826049158418,36.68740434615384,37.106897111319086,-1.517395084158207
2016-08-08,39.099998,39.1315,38.904549,39.088001,39.088001,22158000,941770793.3738012,239710297,39.31785952441569,84.0,0.8895220391969758,77.34624054924424,97.37547565120992,36.859827461538465,37.25364554751768,-2.6245243487900787
2016-08-09,39.055,39.446999,39.0285,39.213001,39.213001,26378000,938650996.5140715,266088297,40.77674428940842,92.0,0.9089743541624173,78.14220938688729,91.43961327207849,37.02338523076923,37.39878298844229,-8.560386727921511
2016-08-10,39.1875,39.340599,39.138901,39.234001,39.234001,15728000,937754405.8488197,281816297,42.131422999758804,92.0,0.9155313034468691,78.2802808575984,92.20785967284414,37.19594292307692,37.5347250633725,-7.7921403271558685
2016-08-11,39.25,39.487499,39.148499,39.2425,39.2425,19502000,929067789.341445,301318297,43.52559820547441,100.0,0.9109130921632129,78.33991446403496,91.16801814565115,37.36340446153846,37.6612269105301,-8.831981854348852
2016-08-12,39.075001,39.16975,39.02,39.160999,39.160999,14810000,942146873.6820118,286508297,44.32680147603946,96.0,0.8904125552069289,76.17989806434639,88.22998430424236,37.53236588461539,37.77232113937972,-11.77001569575764
2016-08-15,39.1875,39.3745,39.005501,39.122002,39.122002,18764000,935231278.4961171,267744297,45.291618125947686,92.0,0.8610928575322703,75.11271152227123,86.14229909296725,37.68007742307692,37.87229749942566,-13.857700907032743
2016-08-16,39.014999,39.049,38.672199,38.856998,38.856998,20560000,934838249.6028814,247184297,44.9817471207101,88.0,0.8071686401799596,68.12824750384269,75.00490584931833,37.79940423076923,37.945238277245984,-24.99509415068166
2016-08-17,38.866001,39.040501,38.676498,38.995499,38.995499,18484000,948751864.3697929,265668297,44.69400975870376,84.0,0.7667703315400587,69.7133454787178,65.66638613591937,37.91338492307692,38.023035367820356,-34.333613864080625
2016-08-18,39.0005,39.143002,38.849998,38.875,38.875,14388000,936819317.3738475,251280297,44.581799402463716,80.0,0.7167686557505064,66.60948999340302,57.25751187370808,38.02976957692307,38.08614385909292,-42.74248812629192
2016-08-19,38.75,38.855,38.656502,38.771,38.771,17230000,939466601.1751958,234050297,43.76701921946897,76.0,0.661128953570639,63.962539340829984,37.505484086772015,38.13451953846154,38.13687394360456,-62.494515913227985
2016-08-22,38.663502,38.727001,38.502499,38.607498,38.607498,19028000,938237293.142305,215022297,42.475580100072115,72.0,0.5969594666368963,59.93043658486499,23.24450348408493,38.23509638461539,38.17173498481904,-76.75549651591507
2016-08-23,38.773998,38.821999,38.589249,38.604,38.604,18564000,922026354.9167407,196458297,41.467515006398926,68.0,0.539602227966455,59.84351964217747,15.676384016003688,38.30875026923077,38.20375461557318,-84.32361598399632
2016-08-24,38.528999,38.724998,38.3535,38.481998,38.481998,21440000,915418182.3828373,175018297,39.72660076426229,48.0,0.4787825540455515,56.75201357252917,11.331403290479102,38.37159634615385,38.22436523664183,-88.6685967095209
2016-08-25,38.349998,38.594501,38.159248,38.470501,38.470501,18538000,923393534.9111367,156480297,37.505616413033295,48.0,0.42475846132636974,56.45603137819863,23.433296869341735,38.42586553846154,38.2425975154091,-76.56670313065827
2016-08-26,38.450001,38.804001,38.2925,38.477001,38.477001,23334000,916892918.7520288,179814297,35.948624964086555,48.00000000000001,0.3781098592093386,56.59386302839238,23.922662207670303,38.485307923076924,38.25996073648991,-76.0773377923297
2016-08-29,38.437,38.7495,38.33075,38.607498,38.607498,16952000,922347758.6135215,196766297,34.502847190064585,48.0,0.34766288194716566,59.374183781934065,33.74738660087597,38.5418655,38.285704237490656,-66.25261339912403
2016-08-30,38.466499,38.723301,38.341999,38.454498,38.454498,22600000,913083526.0629448,174166297,33.160339257044186,48.0,0.30764131421245366,54.93154346651236,22.22847940637745,38.59825007692308,38.298207479158016,-77.77152059362255
2016-08-31,38.350498,38.454498,38.269001,38.352501,38.352501,24972000,910593420.6488396,149194297,31.644290688819527,44.0,0.26464298833241173,52.13113530469686,15.902298453324795,38.65330776923077,38.3022292214426,-84.09770154667521
2016-09-01,38.462502,38.550999,38.215,38.438999,38.438999,18502000,916760717.2717465,167696297,30.515524301546787,40.0,0.23483909212060894,54.2607073058259,23.0199991442108,38.70525,38.31236031615056,-76.9800008557892
2016-09-02,38.650501,38.695999,38.420502,38.573002,38.573002,21454000,919058228.1774918,189150297,29.869925172219464,32.0,0.21950193022109943,57.42100331836193,42.05868540305833,38.754384615384616,38.331667107546814,-57.94131459694167
2016-09-06,38.672501,39.099998,38.549999,39.004002,39.004002,28856000,937841262.3139175,218006297,30.20884277793633,32.0,0.23936595516910586,65.64336187761904,85.87045135267535,38.77609626923077,38.38146969217297,-14.12954864732466
2016-09-07,39.0,39.136501,38.810001,39.017502,39.017502,17874000,942686238.5711915,235880297,30.59836759929288,-40.0,0.25327804360222217,65.86570978485331,87.24274564576085,38.790461692307694,38.42858319645646,-12.757254354239148
2016-09-08,38.929501,39.017502,38.679001,38.765999,38.765999,25406000,930339409.3742322,210474297,30.39511829598026,-40.0,0.2412285511369774,58.296370273006914,62.0874021363966,38.798634692307694,38.453576959681904,-37.9125978636034
2016-09-09,38.505001,38.662251,37.983002,37.983002,37.983002,37710000,892629409.3742322,172764297,28.52426492211656,-80.0,0.16657772312417762,42.08209415567586,0.0,38.77263476923077,38.41871955526103,-100.0
2016-09-12,37.7565,38.5145,37.700001,38.451,38.451,26220000,914761080.2295679,198984297,27.46254983772991,-84.0,0.1435254593178712,50.876627621691796,52.27977723633825,38.76765392307693,38.42111069931576,-47.72022276366175
2016-09-13,38.223999,38.311001,37.790001,37.984501,37.984501,27900000,907692366.218052,171084297,26.476671545085157,-84.0,0.08661535565973111,43.745972468110274,19.80508179603208,38.72432703846154,38.38876924010719,-80.19491820396792
2016-09-14,37.980499,38.383999,37.955502,38.1245,38.1245,21748000,903099065.1027578,192832297,25.328329487003405,-84.0,0.05220860942432637,46.18369297065578,29.5509223807864,38.687269307692304,38.36919374083999,-70.4490776192136
2016-09-15,38.144501,38.689999,37.998001,38.588001,38.588001,26102000,921506384.4938542,218934297,23.680400341697492,-84.0,0.061631225799160916,53.385791065494786,61.81691611555842,38.663230846153844,38.385401685962954,-38.18308388444158
2016-09-16,38.487499,38.487499,38.233002,38.444,38.444,40986000,948481610.1900324,177948297,22.150180421056287,-84.0,0.05682400813500976,51.09783764841219,51.79248172641845,38.63284619230769,38.38974230181755,-48.20751827358155
2016-09-19,38.620998,38.700001,38.22205,38.285,38.285,23456000,931204298.8003705,154492297,21.31943490357541,-76.0,0.03972634178121126,48.620109103260106,40.72391228680789,38.596019269230766,38.38198361279403,-59.27608771319211
2016-09-20,38.450001,38.6665,38.426498,38.570499,38.570499,19572000,935118666.1806419,174064297,20.548028351628883,-76.0,0.04865286139825287,53.02476804265094,60.598538113469985,38.57330773076923,38.39594771555002,-39.401461886530015
2016-09-21,38.632999,38.858002,38.415051,38.811001,38.811001,23356000,953518111.8168408,197420297,20.350562555575767,-64.0,0.0742774695153301,56.414460655229036,77.34075878872227,38.56134615384615,38.426692403287056,-22.659241211277738
2016-09-22,39.0,39.4925,38.922001,39.3605,39.3605,29724000,969487248.092277,227144297,21.486170485240866,32.0,0.1373419406097227,62.98629799032268,92.63597915535809,38.580711615384615,38.49586333637691,-7.364020844641918
2016-09-23,39.329498,39.446499,39.2075,39.345001,39.345001,28238000,973741042.936607,198906297,22.540663562787024,32.0,0.18394988872515938,62.69913571201162,91.77132037451645,38.594154,38.55876242257121,-8.228679625483547
2016-09-26,39.137001,39.137001,38.6535,38.710499,38.710499,30664000,950306882.5274246,168242297,21.716566952670544,32.0,0.1677542482033516,52.20579003913121,56.37369951112936,38.58782703846154,38.57000216904742,-43.62630048887064
2016-09-27,38.775002,39.2995,38.715401,39.150501,39.150501,23064000,961603997.338441,191306297,21.30283256364343,31.999999999999993,0.18825350137625918,57.51570080417254,80.92054723600954,38.60242323076923,38.61300208245132,-19.079452763990464
2016-09-28,38.892502,39.0905,38.748501,39.077999,39.077999,22196000,982177348.1728002,169110297,20.9186506309754,32.0,0.1963851954419198,56.40371394081022,76.87580299905319,38.62051942307692,38.64744629856603,-23.124197000946804
2016-09-29,39.071999,39.290001,38.711601,38.7505,38.7505,26294000,959420036.6444461,142816297,21.000209520676687,32.0,0.17439289654245727,51.55497812246925,58.605276767239616,38.626154038461536,38.655079906079656,-41.394723232760384
2016-09-30,38.816502,39.047001,38.704498,38.864498,38.864498,31706000,957336901.2616897,174522297,21.05161272482457,32.0,0.16426893704524304,53.067381179662064,63.11292987543599,38.640865576923076,38.67059235748116,-36.88707012456401
2016-10-03,38.712502,38.803249,38.474998,38.627998,38.627998,25576000,955603192.678928,148946297,20.329844459662194,32.0,0.13559895240160813,49.607327642007355,43.75386304991917,38.64692315384615,38.66743721988997,-56.24613695008083
2016-10-04,38.801498,38.935501,38.644501,38.821499,38.821499,24028000,960804800.5414714,172974297,19.990822064555903,32.0,0.12702740372181864,52.34511277451886,55.10194386212383,38.66017307692307,38.67884920360183,-44.89805613787617
2016-10-05,38.9655,39.1035,38.782501,38.823502,38.823502,29224000,939046326.7518325,202198297,20.076941306599764,32.0,0.11902398063968178,52.37395700050484,47.34165059624513,38.66848092307692,38.68956422555725,-52.65834940375487
2016-10-06,38.950001,39.023998,38.777,38.842999,38.842999,21414000,929076165.0501181,223612297,20.136658972340204,31.999999999999996,0.112952410069461,52.67423300624883,48.876303671927076,38.68342326923077,38.70092976440486,-51.123696328072924
2016-10-07,38.983002,38.983002,38.537498,38.754002,38.754002,18664000,928552656.0715231,204948297,19.338485410672625,32.00000000000001,0.09980879882420624,51.09075968782395,31.45865836805279,38.69886561538462,38.704861041115606,-68.5413416319472
2016-10-10,38.885502,39.469002,38.793499,39.297001,39.297001,23498000,940084226.6167316,228446297,19.75236633222136,32.0,0.13168983504146325,59.15804470559753,81.85538248214088,38.73186569230769,38.74872326029223,-18.144617517859114
2016-10-11,39.333,39.613998,39.028999,39.1535,39.1535,27450000,924318186.5893129,200996297,20.42539864982863,84.0,0.1437197427895498,56.50547039388638,59.56997366110623,38.75419253846154,38.77870672249281,-40.43002633889377
2016-10-12,39.188,39.406502,39.103001,39.306999,39.306999,18748000,930773098.6324358,219744297,21.050357230463952,84.0,0.16375198683388703,58.64171779271546,73.04661984196629,38.76584626923077,38.81783948378964,-26.953380158033706
2016-10-13,39.061001,39.061001,38.650002,38.9095,38.9095,27306000,937948216.0463471,192438297,20.12104160899504,84.0,0.14587132348590615,51.577095268179995,38.14767339771737,38.76169234615384,38.82462915165708,-61.85232660228263
2016-10-14,39.0825,39.197498,38.799999,38.926498,38.926498,17050000,931750107.2460736,209488297,19.589265168192444,84.0,0.13155587130745516,51.844258580755806,39.64003511852518,38.767865384615384,38.83217499227507,-60.35996488147482
2016-10-17,38.990002,39.2925,38.875,38.998001,38.998001,21860000,922770595.1981697,231348297,19.322593173436513,84.0,0.12454479200744117,53.01851737631863,45.91773485513621,38.80690380769231,38.844458400254695,-54.08226514486379
2016-10-18,39.392502,40.080502,39.278252,39.763,39.763,41138000,931346682.387948,272486297,20.550082720627195,100.0,0.17865802854438328,63.3230861206359,80.22415391054747,38.85736534615384,38.91249851875435,-19.77584608945253
2016-10-19,39.911999,40.23,39.901501,40.075001,40.075001,35336000,933336799.0580142,307822297,21.90644937604623,100.0,0.2439074186682575,66.54587989872455,91.16815821292529,38.93776919230769,38.99860981366144,-8.831841787074703
2016-10-20,40.165001,40.198502,39.801498,39.848499,39.848499,35150000,906509562.3047312,272672297,22.83448413365884,96.0,0.2741806283816288,62.26821384072608,78.26207605461414,39.00407684615384,39.061564568205036,-21.73792394538585
2016-10-21,39.75,39.974998,39.700001,39.968498,39.968498,25324000,930636414.6994841,297996297,23.358284228999363,88.0,0.30434695931510447,63.603088556378864,84.54938310264919,39.05717288461538,39.128744822412074,-15.450616897350816
2016-10-24,40.244999,40.758999,40.241001,40.655499,40.655499,33950000,951019470.4255676,331946297,24.97125614779511,100.0,0.37931670623660807,70.12044770516954,95.3409879176285,39.14223053846154,39.24183772445562,-4.659012082371503
2016-10-25,40.834,40.834,40.257,40.383499,40.383499,31528000,933315596.8449786,300418297,26.55682302698213,96.0,0.4120329842379391,65.14657221081637,80.38316535321972,39.22294203846154,39.326405226347795,-19.616834646780276
2016-10-26,40.317001,40.348999,39.816002,39.953499,39.953499,32954000,917363854.4111567,267464297,26.70600695841808,96.0,0.39866786889153616,58.1269750860835,61.659036221174595,39.276134346153846,39.3728566169887,-38.340963778825405
2016-10-27,40.049999,40.1745,39.575001,39.767502,39.767502,54984000,897690922.4329548,212480297,26.210795080176588,64.0,0.36881603357578285,55.34885249259911,51.16762927438571,39.312922846153846,39.402089608322875,-48.83237072561429
2016-10-28,40.4175,40.774502,39.679501,39.768501,39.768501,85398000,826174959.0703641,297878297,26.645227797012172,64.0,0.3413045040996181,55.36119292836135,51.21337107451557,39.328615192307694,39.42923119289155,-48.78662892548443
2016-10-31,39.773499,39.842999,39.200001,39.227001,39.227001,48546000,781705929.7607863,249332297,25.929769241806337,64.0,0.2726637957738518,47.670503612472,26.41939232545085,39.324076730769235,39.41425117860329,-73.58060767454916
2016-11-01,39.144501,39.474499,38.777,39.1805,39.1805,48128000,789261588.088612,201204297,24.423074540026825,64.0,0.21206870183458904,47.06583955715355,24.29022370899611,39.34215369230769,39.396936276484524,-75.70977629100389
2016-11-02,38.91,39.0825,38.172501,38.435001,38.435001,37448000,773418227.2145891,163756297,23.341504161749047,-24.0,0.10270717009488806,38.610368374962356,9.862862995627735,39.31463446153846,39.32568181155975,-90.13713700437226
2016-11-03,38.362499,38.497501,37.9515,38.106499,38.106499,38864000,756619685.4683282,124892297,22.663440984074565,-28.0,-0.010350681497129699,35.57731013572635,5.37724197745001,39.277269076923076,39.23537197366643,-94.62275802254999
2016-11-04,37.533001,38.518002,37.528049,38.101002,38.101002,42696000,763345832.3540894,82196297,22.61295321805443,-32.0,-0.09924932098947892,35.527017088329174,17.3309586258235,39.25228838461538,39.15134456820966,-82.66904137417652
2016-11-07,38.724998,39.259499,38.627499,39.125999,39.125999,31702000,781654740.5819377,113898297,21.25306510701872,-32.0,-0.08600206337249716,49.78223249695396,48.33556214233052,39.26234611538461,39.14946711871265,-51.66443785766948
2016-11-08,39.169998,39.781651,39.009499,39.525501,39.525501,27338000,790854786.6557678,141236297,20.23856346415182,-32.0,-0.04277397192475263,54.0469602488064,60.41989128090511,39.29686546153847,39.17732148028949,-39.58010871909489
2016-11-09,38.997002,39.561352,38.5835,39.265499,39.265499,52142000,811445248.9465847,89094297,18.921550677552883,-31.999999999999993,-0.029159256722955718,51.010709143722956,52.55522541017684,39.31394238461539,39.1838531484162,-47.44477458982316
2016-11-10,39.558498,39.558498,37.609001,38.127998,38.127998,94904000,767072120.5385901,-5809703,18.88549309135906,-32.0,-0.10890097835434176,40.33477602640316,18.147546651477747,39.28719223076923,39.10564165594093,-81.85245334852226
2016-11-11,37.827,38.039001,37.519001,37.701,37.701,48636000,752481133.4770514,-54445703,18.94845982912278,-52.0,-0.2041981679133542,37.18839940122415,5.4901675686779265,39.24326919230769,39.001594125871236,-94.50983243132208
2016-11-14,37.779999,37.892502,36.376999,36.804001,36.804001,73088000,720579092.4306134,-127533703,20.064007731795922,-56.0,-0.34808963930102976,31.610035494953493,9.710101391630696,39.168269153846154,38.83880944988078,-90.2898986083693
2016-11-15,37.348499,38.220798,37.348499,37.9245,37.9245,47680000,735867702.2306936,-79853703,20.58064819698715,-56.0,-0.36747375347312783,43.09333490846344,35.190447851883306,39.115480653846156,38.77108282396369,-64.8095521481167
2016-11-16,37.759998,38.318001,37.525501,38.223999,38.223999,29452000,758332833.0723338,-50401703,20.90642140281282,-56.0,-0.3545813443091177,45.71699044258807,42.001108356264936,39.07973061538461,38.73055809626267,-57.998891643735064
2016-11-17,38.346001,38.634998,38.211498,38.561501,38.561501,26080000,775360640.5811883,-24321703,20.707189008157886,-56.0,-0.31351640443066486,48.59325884557005,63.02660126947494,39.051057615384615,38.71803534839136,-36.97339873052506
2016-11-18,38.568501,38.75,38.0,38.027,38.027,30942000,746646464.5811884,-55263703,20.74892910994446,-56.0,-0.3204084383785286,44.56586001973189,48.46313220851951,39.01711530769231,38.666847544806814,-51.53686779148049
2016-11-21,38.130501,38.485001,38.029999,38.459999,38.459999,26612000,770333847.8806033,-28651703,20.787687775889136,-56.0,-0.2876155710912087,48.30378367007928,61.18099588445475,38.99917303846154,38.65152543037668,-38.81900411554525
2016-11-22,38.6315,38.848,38.349998,38.413502,38.413502,31862000,746597776.8849047,-60513703,20.203017371493864,-56.0,-0.2623546457681982,47.93003164800264,59.81530564650966,38.97669230769231,38.633894065163595,-40.18469435349034
2016-11-23,38.386501,38.41415,37.762501,38.0495,38.0495,29568000,743074431.0837144,-90081703,20.353069804327216,-56.0,-0.2686107225576535,44.9948896820811,49.123992701750566,38.910788461538466,38.59060561589222,-50.876007298249434
2016-11-25,38.213001,38.25,38.026001,38.084,38.084,11748000,737410139.0645539,-78333703,20.492404206243897,-56.0,-0.26769897961425926,45.33656868753472,50.13731212470484,38.834211499999995,38.553079273974284,-49.86268787529516
2016-11-28,38.0,38.976501,37.990002,38.411999,38.411999,43764000,731088197.7143855,-34569703,19.4220359817618,-56.0,-0.23776878808180868,48.60524674444828,59.77116016556184,38.7789615,38.54262888330952,-40.22883983443816
2016-11-29,38.5765,38.924999,38.411999,38.542,38.542,32332000,715142912.4590249,-2237703,18.42812263045699,-56.0,-0.2012391418602988,49.88435539342238,67.98872486812871,38.72409619230769,38.54258229936067,-32.01127513187129
2016-11-30,38.503502,38.649502,37.741501,37.902,37.902,47858000,684203750.9669122,-50095703,18.370206321430867,-56.00000000000001,-0.2213798561669762,44.06943117349639,47.933411263055625,38.618192384615384,38.495131758667284,-52.066588736944375
2016-12-01,37.872002,37.9925,36.85125,37.396,37.396,60358000,681466816.4652693,-110453703,19.227761754564835,-44.0,-0.2750014430891099,40.09041692977938,39.199854433657,38.503288576923076,38.4137145913586,-60.800145566343
2016-12-02,37.2295,37.700001,37.154999,37.525002,37.525002,29050000,691861028.22963,-81403703,20.02406322818923,-44.0,-0.3035879805000192,41.53962341085467,44.16242034051146,38.409884846153844,38.34788402903574,-55.83757965948854
2016-12-05,37.885502,38.195,37.645,38.125999,38.125999,27884000,712748577.7423573,-53519703,19.917896217755352,-44.0,-0.27458236758263155,47.86678625511474,59.98110340849155,38.346750115384616,38.331448100959015,-40.01889659150845
2016-12-06,38.2365,38.441502,37.867001,37.955502,37.955502,33814000,689352567.6640459,-87333703,19.426151920937176,-40.0,-0.2623289287717725,46.33470114890244,51.958662765010025,38.277019384615386,38.303600241628715,-48.041337234989975
2016-12-07,38.049999,38.568001,37.790001,38.559502,38.559502,35220000,723803069.5149456,-52113703,18.767524696106996,-16.0,-0.20155681655504054,52.174681330109685,80.37883525287144,38.251346346153845,38.322555927433996,-19.621164747128564
2016-12-08,38.624001,38.909,38.3615,38.820999,38.820999,29762000,743997632.9414299,-22351703,17.622899076270215,-16.0,-0.1307862349999951,54.484063252487296,92.68312307581559,38.23751938461539,38.359477636512956,-7.316876924184418
2016-12-09,39.0,39.4715,38.95105,39.4645,39.4645,36438000,779455458.0927415,14086297,16.956221431243417,-16.000000000000004,-0.02251534363919916,59.6478865644898,99.73284991890094,38.2771155,38.4413311449194,-0.26715008109905164
2016-12-12,39.251999,39.5625,39.217751,39.463501,39.463501,42082000,797368709.7105854,-27995703,16.457460823029205,-16.0,0.06248917060231918,59.63657502990449,96.34858460119874,38.32930788461538,38.51704743048093,-3.6514153988012605
2016-12-13,39.695,40.219002,39.667,39.805,39.805,42904000,775916631.986229,14908297,16.79722928046031,80.0,0.15561810716644686,62.27057227648643,87.70687390282886,38.39484626923077,38.61245132451938,-12.293126097171145
2016-12-14,39.869999,40.200001,39.7005,39.8535,39.8535,34084000,762712878.4722217,48992297,17.112728562360626,80.0,0.23067789385154924,62.643419919891784,89.14700369860947,38.42282707692308,38.70438085603646,-10.852996301390545
2016-12-15,39.867001,40.150002,39.646,39.892502,39.892502,32530000,762003030.2176512,81522297,17.302846284903417,80.0,0.2899678817803064,62.960411090190554,90.30510560160005,38.4369425,38.79238982966339,-9.69489439839996
2016-12-16,40.02,40.042801,39.5145,39.540001,39.540001,48876000,717845502.7399441,32646297,17.223225425730853,80.0,0.304995936348071,58.15709754024842,79.83815316567235,38.447500269230765,38.847768434873515,-20.161846834327648
2016-12-19,39.511002,39.882999,39.313499,39.709999,39.709999,24642000,727516243.7408224,57288297,16.75946643089145,80.0,0.3268554100254093,59.75182939583677,84.88597141357204,38.508346461538466,38.911637365623626,-15.114028586427962
2016-12-20,39.838001,39.932499,39.663502,39.820999,39.820999,19020000,730768558.5993525,76308297,16.407289000605527,80.0,0.3491116311683342,60.80231507303539,88.1819385750494,38.58988488461539,38.97899748668854,-11.818061424950603
2016-12-21,39.792,39.833801,39.355,39.728001,39.728001,24226000,744288186.6410649,52082297,15.470935213063001,32.0,0.35515171746357765,59.403402338815646,83.9751788754775,38.702346423076925,39.034479228415314,-16.0248211245225
2016-12-22,39.618,39.666,39.429001,39.563,39.563,19444000,746831423.3467057,32638297,14.601463838916372,32.0,0.34267419285200873,56.9019330283784,74.51431661669257,38.76536565384615,39.073628915199365,-25.48568338330743
2016-12-23,39.544998,39.637001,39.363998,39.495499,39.495499,12468000,746374679.3988372,20170297,13.659071864466425,32.0,0.32360854031756503,55.86551260841321,70.21396862331473,38.8142695,39.104878551110524,-29.78603137668527
2016-12-27,39.534,39.893002,39.382851,39.577499,39.577499,15782000,742635916.5423497,35952297,13.291211206759204,32.0,0.3115245271886735,56.89269633119021,73.58984207910996,38.85334634615385,39.13988747325048,-26.410157920890047
2016-12-28,39.685001,39.711498,39.16,39.252499,39.252499,23076000,727300676.8859959,12876297,12.459396616184678,31.999999999999996,0.27258093254707205,51.75168319563748,47.96759303623894,38.90048092307693,39.14822906782452,-52.03240696376106
2016-12-29,39.1665,39.296501,38.945999,39.1395,39.1395,14886000,728850850.6367874,-2009703,11.897632887780087,32.00000000000001,0.22994906856806807,50.05796441041354,15.200356951240279,38.926615576923076,39.147582470207894,-84.79964304875972
2016-12-30,39.137501,39.139,38.5205,38.591,38.591,35400000,701521020.4023495,-37409703,12.167772084078722,32.0,0.1501725475752025,42.74506612068703,4.150716337101898,38.933442423076926,39.10635413908138,-95.8492836628981
2017-01-03,38.940498,39.481499,38.790001,39.306999,39.306999,33146000,717938188.2148376,-4263703,11.662554765872267,32.0,0.14307493656853154,52.500113574374375,46.305450332116,38.98180776923077,39.12121672137165,-53.694549667884
2017-01-04,39.417999,39.567001,39.158001,39.345001,39.345001,21460000,716101757.8969897,17196297,11.013193848478272,32.0,0.13891514519215775,52.95823311398553,49.09202197557513,39.03030780769231,39.13779333460339,-50.90797802442487
2017-01-05,39.304001,39.723999,39.250999,39.701,39.701,26704000,740208864.4678143,43900297,10.374930589275605,32.0,0.16247175143355008,57.12953346429749,72.44544652292544,39.079884769230766,39.179512346854985,-27.55455347707456
2017-01-06,39.763,40.395,39.610199,40.307499,40.307499,32804000,765697932.9017228,76704297,10.989553138000431,96.0,0.2274579386433757,63.12812218886723,95.33203520938902,39.14778857692308,39.26306691375461,-4.667964790610986
2017-01-09,40.32,40.498299,40.141499,40.3325,40.3325,25492000,767498519.7402878,102196297,11.721275392081163,100.0,0.27777531108818465,63.355741335888005,91.61699444685736,39.24126934615385,39.34228417940242,-8.383005553142631
2017-01-10,40.393002,40.456501,40.175499,40.239498,40.239498,23536000,754683300.830813,78660297,12.400731770870413,96.0,0.3066132603131635,61.82673446931147,86.91469658949141,39.35063465384615,39.40874446240965,-13.08530341050859
2017-01-11,40.25,40.407501,40.068501,40.3955,40.3955,21318000,774491936.1228478,99978297,12.751608899722267,92.0,0.3381575309559537,63.42141228894575,94.80235352530747,39.46103842307692,39.48183746519412,-5.197646474692539
2017-01-12,40.356998,40.369499,39.9585,40.318001,40.318001,27062000,794772221.9288965,72916297,12.787768338818335,84.0,0.35283579962530354,62.03497300972334,90.88390680751684,39.54534619230769,39.543775504809375,-9.116093192483165
2017-01-13,40.374001,40.561199,40.334499,40.394001,40.394001,21984000,784328512.7802422,94900297,13.198810163394555,100.0,0.366377624940327,62.89169177044405,91.80682697448282,39.63913461538462,39.60675517111979,-8.193173025517178
2017-01-17,40.354,40.356998,40.018501,40.230499,40.230499,27242000,791209412.0437517,67658297,12.754132267204664,96.0,0.3597691789627433,59.76697949938328,83.79476836123311,39.70340373076923,39.65295841770351,-16.205231638766893
2017-01-18,40.290501,40.310249,40.0495,40.303501,40.303501,25888000,815757485.7238038,93546297,12.341217077885478,35.99999999999999,0.356315209277021,60.70571347294983,87.37207202042023,39.76042303846154,39.70114675713288,-12.627927979579763
2017-01-19,40.256001,40.473999,40.09,40.108749,40.108749,18386000,799166902.4514514,75160297,12.325938176836003,36.0,0.33401276340613606,56.89204206461365,77.82867537054715,39.785201846153846,39.73133951586378,-22.171324629452855
2017-01-20,40.345501,40.345501,40.084499,40.250999,40.250999,33400000,808380369.0149262,108560297,12.295729425114844,36.0,0.32408050224341167,58.92195985695598,84.79932611325819,39.81549023076923,39.76983281098498,-15.20067388674181
2017-01-23,40.362499,41.043499,40.187,40.9655,40.9655,39272000,840499583.7157024,147832297,13.618494765383458,56.0,0.36960282181969717,67.26108561517378,96.53875885401281,39.860124846153845,39.85840075091202,-3.461241145987188
2017-01-24,41.115002,41.294998,40.891048,41.193501,41.193501,29480000,855165217.7793239,177312297,15.226764852816173,60.0,0.4192445728060221,69.39612468347799,95.25048467545804,39.91166334615385,39.957297065659276,-4.7495153245419575
2017-01-25,41.480999,41.788502,41.252998,41.783501,41.783501,29890000,884496940.3808358,207202297,17.357794540546244,64.0,0.5004254936892494,74.10261719342047,99.80291648916277,39.98439407692308,40.092571431166,-0.1970835108372298
2017-01-26,41.890499,41.900002,41.350498,41.607498,41.607498,59478000,880654007.6414924,147724297,19.46567880744462,68.0,0.5442857992964605,70.61391436969681,87.22580064747923,40.063913192307695,40.204788214042594,-12.774199352520768
2017-01-27,41.7355,42.0975,41.021999,41.165501,41.165501,59316000,837166843.9363911,88408297,20.431685514378024,72.0,0.5371875794810705,62.63845997435396,56.428284244974314,40.11989403846154,40.275952124113516,-43.571715755025686
2017-01-30,40.733002,40.792,39.990002,40.116001,40.116001,64932000,792637306.4562477,23476297,19.02748174936941,72.0,0.44178370265156985,48.601761670987436,7.363300607760479,40.131240269230766,40.2641038926977,-92.63669939223952
2017-01-31,39.842999,40.0625,39.526001,39.8395,39.8395,43212000,799926495.7893127,-19735703,18.368852917927978,72.0,0.33994544356689715,45.69637090757025,12.19129387178454,40.135528692307695,40.232651752497866,-87.80870612821546
2017-02-01,39.984001,40.059502,39.559502,39.784752,39.784752,40594000,795907689.789312,-60329703,17.757269003018074,72.0,0.2519162497704528,45.12120980013956,10.062263294677425,40.14405761538462,40.19947399305358,-89.93773670532258
2017-02-02,39.689999,40.134998,39.599998,39.926498,39.926498,30642000,802666112.2192186,-29687703,17.037007278497615,72.0,0.19138404095818373,46.981838439902994,15.574456766267538,40.1606345,40.179253549123686,-84.42554323373245
2017-02-03,40.149502,40.299999,40.018501,40.074501,40.074501,29268000,785043012.0053623,-419703,16.031921874495918,72.0,0.15358401364420615,48.92887880336461,21.329971351340134,40.17974996153846,40.17149410104045,-78.67002864865987
2017-02-06,39.985001,40.0835,39.762501,40.067001,40.067001,23690000,806297731.4593165,-24109703,15.570497032411447,72.0,0.12162007186095991,48.83101513936058,21.038312672880593,40.21107696153846,40.16375387133375,-78.9616873271194
2017-02-07,40.199501,40.525002,40.089001,40.348499,40.348499,24824000,811023105.6671733,714297,14.653149801991033,72.0,0.11764679471612993,52.65836525025588,31.98515729541397,40.25757692307692,40.1774386956794,-68.01484270458603
2017-02-08,40.349998,40.591999,40.1595,40.418999,40.418999,23106000,815644262.9276522,23820297,13.926487516267288,68.0,0.11881705570275614,53.59454430205622,34.72674887293365,40.327884576923076,40.195332051555,-65.27325112706635
2017-02-09,40.475498,40.533001,40.227001,40.478001,40.478001,19794000,828322772.7315738,43614297,13.25172967952381,64.0,0.1230865985760019,54.407140524671775,37.021208252462856,40.372923115384616,40.216270492180556,-62.978791747537144
2017-02-10,40.584999,40.762501,40.488998,40.683498,40.683498,22700000,837908707.4379572,66314297,13.080837937008601,60.0,0.14142190882056127,57.217096092896426,45.01253937878262,40.42440376923077,40.25087993720422,-54.98746062121738
2017-02-13,40.799999,41.047951,40.774502,40.962002,40.962002,24266000,846920393.5878426,90580297,13.444973636566463,-7.999999999999993,0.1763923779999601,60.747919052398096,55.842953856874914,40.47290384615384,40.30355564555946,-44.157046143125086
2017-02-14,40.950001,41.150002,40.799999,41.022499,41.022499,21094000,852645677.9939766,111674297,13.962200458096193,-8.0,0.2066066956989232,61.491367509156326,58.195550532977265,40.50040384615385,40.356810708851356,-41.804449467022735
2017-02-15,40.967999,41.150002,40.9235,40.949001,40.949001,26272000,832289407.4091706,85402297,14.442482506659514,-8.000000000000007,0.22206130135253943,60.0044128204592,55.33737325972144,40.52411542307693,40.40067665634385,-44.66262674027856
2017-02-16,40.996498,41.220001,40.949001,41.208,41.208,25752000,855760597.4313099,111154297,15.023281696289976,-8.0,0.25229988639338075,63.36621833457967,99.29155844155815,40.5613655,40.46047838550356,-0.7084415584418546
2017-02-17,41.151001,41.4035,41.082748,41.4035,41.4035,32220000,887980597.4313099,143374297,15.91076465877174,-8.0,0.28871131471434097,65.70921309478918,100.0,40.600134730769234,40.53033183842923,-0.0
2017-02-21,41.432999,41.672501,41.4175,41.583,41.583,25246000,895504766.9600571,168620297,17.203350914064405,-8.0,0.3282677179320288,67.74878057705564,95.7642668075092,40.64878853846154,40.60830725780484,-4.235733192490802
2017-02-22,41.432999,41.662498,41.431999,41.537998,41.537998,19658000,893926917.7806686,148962297,18.403609579693306,-8.0,0.3519283561460895,66.67801273131292,93.51011795881621,40.69278842307692,40.677173238708185,-6.489882041183791
2017-02-23,41.506001,41.623001,41.144001,41.566502,41.566502,29456000,916434130.5405848,178418297,18.5521169688584,-7.9999999999999964,0.36872913701299126,67.0334200853834,94.4503141361258,40.74417315384615,40.74304944324832,-5.549685863874202
2017-02-24,41.386501,41.450001,41.209999,41.431999,41.431999,27844000,940101101.2824945,150574297,18.690016687368843,-8.0,0.36696051647266614,63.5869511901628,87.40827225130892,40.78757692307692,40.79408274374844,-12.591727748691087
2017-02-27,41.227501,41.525002,41.200001,41.464001,41.464001,22030000,953861268.0819817,172604297,18.98607306985247,-8.000000000000004,0.36394582497842265,64.06041401869817,86.83296495105813,40.839701999999996,40.84370631828559,-13.167035048941871
2017-02-28,41.280499,41.426998,41.009998,41.1605,41.1605,45216000,941283629.8661538,127388297,18.605804320112078,-8.0,0.33322545044613605,56.55053025108394,66.15990339728795,40.87468280769231,40.867172516931106,-33.84009660271205
2017-03-01,41.442501,41.812752,41.362999,41.762001,41.762001,29930000,964458911.4762814,157318297,19.1182500507902,-8.0,0.35334232566504653,65.24625837662285,96.79956058675005,40.905317461538466,40.933456108269546,-3.2004394132499527
2017-03-02,41.692501,41.725498,41.481998,41.531502,41.531502,18850000,953273391.1477401,138468297,19.594092514991306,-8.0,0.346689332452911,60.268548508602755,78.75360527711344,40.91831749999999,40.977755803953286,-21.246394722886563
2017-03-03,41.528,41.568001,41.287552,41.453999,41.453999,17928000,956625993.4390662,120540297,19.354682471735977,-8.0,0.3313434223014937,58.64836564819542,65.44637611365293,40.90564434615385,41.013033077734526,-34.55362388634706
2017-03-06,41.3475,41.444,41.119999,41.389,41.389,22180000,971275769.7669171,98360297,18.586523452661133,-8.0,0.3103591744928025,57.258145982057115,58.15840585019261,40.89724057692308,41.040882479383825,-41.84159414980739
2017-03-07,41.369999,41.670502,41.326,41.595501,41.595501,20752000,982991997.8294537,119112297,18.443479930798226,80.0,0.30685468205587796,60.4645235253825,75.56924246445293,40.913779038461534,41.081965332762806,-24.43075753554707
2017-03-08,41.675499,41.907501,41.5895,41.768501,41.768501,19796000,985482115.1435499,138908297,18.844550784979127,100.0,0.314412647445117,62.97072044225531,85.49817423056831,40.977336730769224,41.13281982663223,-14.501825769431694
2017-03-09,41.799999,42.099998,41.710499,41.933998,41.933998,25230000,989206642.7289871,164138297,19.611229293682587,100.0,0.3299531200726449,65.24072941748992,84.7706422018351,41.057894346153844,41.192166357992804,-15.229357798164898
2017-03-10,42.164001,42.245499,41.974998,42.162498,42.162498,34080000,1002372309.1036025,198218297,20.604121734217184,100.0,0.35659647475149825,68.14440930575655,93.28199653419924,41.14934611538461,41.264042775919265,-6.718003465800759
2017-03-13,42.200001,42.43425,42.162498,42.277,42.277,24472000,998522736.4932817,222690297,21.86987421218218,96.0,0.3825411831209564,69.51853200151709,88.9591167855128,41.239750038461544,41.33907664436969,-11.040883214487193
2017-03-14,42.181999,42.362,42.040001,42.280998,42.280998,15598000,1006273077.3639052,238288297,22.569417477021638,96.0,0.3988277189304057,69.56789326518017,89.23982553649196,41.32461530769231,41.408848596638606,-10.760174463508031
2017-03-15,42.379501,42.431499,42.038502,42.360001,42.360001,27630000,1023849617.7191744,265918297,23.358508082607432,92.0,0.413345013722072,70.58169609057062,94.78680739082677,41.412807615384615,41.479304330220934,-5.2131926091732375
2017-03-16,42.4515,42.5425,42.306499,42.438999,42.438999,19552000,1026252100.96289,285470297,24.31342103805894,100.0,0.426310312903901,71.60049720650254,93.24627308806157,41.49321146153846,41.550392824278646,-6.753726911938432
2017-03-17,42.580502,42.669998,42.355499,42.605999,42.605999,34246000,1046560315.7616645,319716297,25.44773413091701,100.0,0.44493201097623114,73.67593532577267,96.1446385542167,41.57732684615385,41.62858587433208,-3.855361445783296
2017-03-20,42.5005,42.511002,42.2575,42.419998,42.419998,24630000,1053506601.076968,295086297,26.066596122092523,96.0,0.43961352358586936,67.7382583164807,83.8709573361015,41.65201903846154,41.68720899475193,-16.129042663898495
2017-03-21,42.57,42.674999,41.451,41.522999,41.522999,49270000,1010032995.8942839,245816297,24.428461548429624,100.0,0.3588813010027039,47.75159952162179,25.916398713826286,41.68430753846154,41.675045291436966,-74.08360128617372
2017-03-22,41.595501,41.7775,41.359001,41.4795,41.4795,28030000,998144429.7806255,217786297,23.135601184367438,96.0,0.28806973856857354,47.02695497392908,23.119035369775027,41.70421130769231,41.66056045503422,-76.88096463022497
2017-03-23,41.049999,41.128502,40.61285,40.879002,40.879002,69742000,1000396614.9442631,148044297,23.431776205479416,-8.0,0.18140477382879538,38.370313541897815,12.906535851676985,41.698692192307696,41.6026672361428,-87.09346414832302
2017-03-24,41.004002,41.0965,40.4445,40.7215,40.7215,39620000,994441461.5700301,108424297,23.974558632924015,-12.0,0.08320380403177552,36.47385468756516,12.418745760477849,41.689942153846154,41.53739558902111,-87.58125423952215
2017-03-27,40.3475,41.081501,40.168499,40.975498,40.975498,37886000,1023530044.5698482,146310297,24.889545696360393,-16.0,0.025579479500976277,41.49571533896943,32.19624975064847,41.680999769230766,41.49577354538992,-67.80375024935154
2017-03-28,41.0205,41.2995,40.701351,41.046001,41.046001,32410000,1028468954.2896665,178720297,25.091808606558,-16.0,-0.014235116407775195,42.846289899660476,35.009056453221575,41.667249807692315,41.46245706054623,-64.99094354677842
2017-03-29,41.25,41.638248,41.118999,41.570499,41.570499,35726000,1054872256.4163918,214446297,24.369044608070276,-16.0,-0.003426368286049808,51.766942156365396,55.93457011769398,41.666769,41.47046016717243,-44.06542988230602
2017-03-30,41.674999,41.683998,41.450001,41.575001,41.575001,21106000,1056315690.8108497,235552297,23.580392301709782,-16.0,0.0054402049521797835,51.836431335009266,56.114183123877986,41.66819219230769,41.47820393256707,-43.885816876122014
2017-03-31,41.448502,41.582001,41.369499,41.478001,41.478001,28038000,1056909694.9896342,207514297,23.01151087217852,-16.0,0.004587061991223607,50.15964485948036,52.24424496309597,41.664788307692305,41.47818890052506,-47.75575503690403
2017-04-03,41.460999,42.0425,41.460999,41.927502,41.927502,33430000,1077117419.7398925,240944297,21.407599533679548,-16.0,0.03972400056037628,57.087105785062995,70.1776580889686,41.68384611538461,41.51147135233802,-29.822341911031398
2017-04-04,41.568001,41.758999,41.451801,41.7285,41.7285,20908000,1093873875.1855652,220036297,19.89670588530631,-16.0,0.05092544245290043,53.53916768463362,62.23822062637136,41.694019153846156,41.52754754846113,-37.76177937362864
2017-04-05,41.775501,42.122501,41.535999,41.570499,41.570499,31106000,1066427392.1181589,188930297,19.30038885026479,-15.999999999999993,0.04651708561709711,50.83763382486589,55.93457011769398,41.70978834615384,41.53072913746401,-44.06542988230602
2017-04-06,41.619999,41.8195,41.323002,41.394001,41.394001,25088000,1048514538.491357,163842297,18.21536394668353,-16.0,0.02845352301790882,47.928287970290505,48.89295830839835,41.6956345,41.52060112728149,-51.10704169160165
2017-04-07,41.397999,41.424252,41.02565,41.233501,41.233501,21146000,1049421700.522656,142696297,17.298273630644324,-16.0,0.0011734836821588601,45.384740698391276,42.48960702174342,41.68417292307693,41.49933445118656,-57.51039297825658
2017-04-10,41.269501,41.467499,41.188499,41.2365,41.2365,19578000,1036580356.9957743,162274297,16.340782291512962,-16.0,-0.019973903075836574,45.44300257518652,54.657108846357424,41.67580757692308,41.479865232580146,-45.342891153642576
2017-04-11,41.2355,41.371349,40.851002,41.1675,41.1675,21594000,1041255203.7922385,140680297,16.177615921939143,-16.000000000000007,-0.04181901916173558,44.272790237510804,51.12589444637203,41.667288346153846,41.45672706720384,-48.87410555362797
2017-04-12,41.0965,41.333,41.050999,41.216,41.216,18010000,1044320788.7015122,158690297,16.02610429304917,-16.0,-0.0545886227143626,45.3383016508035,53.60797993041985,41.65269215384615,41.43889543259615,-46.39202006958015
2017-04-13,41.106998,41.319,41.071999,41.178001,41.178001,22448000,1041140183.5379707,136242297,15.885414923365618,-16.0,-0.06700246455515213,44.61848687381163,51.66330433643381,41.62998061538461,41.41956991907051,-48.33669566356619
2017-04-17,41.2505,41.887501,41.223499,41.858501,41.858501,17900000,1057476634.0305895,154142297,15.229355871561376,-15.999999999999996,-0.021679947882780937,57.60083977509235,81.42349505681995,41.627076884615384,41.4520833324727,-18.57650494318006
2017-04-18,41.710999,41.946499,41.635502,41.841,41.841,16734000,1062857339.5229253,137408297,14.753002374202369,-16.0,0.012680120141247642,57.22928203789748,77.86069827817411,41.61471157692308,41.480891974511756,-22.13930172182589
2017-04-19,41.989498,42.111,41.814499,41.9105,41.9105,19084000,1056131362.4908075,156492297,14.679538772593014,-16.0,0.045000058107191876,58.37752043635094,83.32668763404446,41.60061542307692,41.512714791214584,-16.67331236595554
2017-04-20,42.071999,42.259998,41.966,42.0825,42.0825,19180000,1052151942.0865873,175672297,14.93307960486038,-16.0,0.08352992337272269,61.15677980341637,87.40251924065082,41.59298088461538,41.55492110297647,-12.597480759349189
2017-04-21,42.144001,42.194,42.029999,42.1595,42.1595,26472000,1067486400.2423303,202144297,15.168510377680073,-16.000000000000004,0.11890768193264023,62.368222357252854,92.86740345607782,41.5852693076923,41.59970472497822,-7.13259654392217
2017-04-24,42.560001,43.172501,42.493,43.138,43.138,27450000,1092148906.3313575,229594297,17.04895252179707,76.0,0.22332720579658627,73.62537726613999,98.51384816448343,41.61215396153846,41.71365252312798,-1.4861518355165713
2017-04-25,43.25,43.75,43.140499,43.615002,43.615002,33440000,1110775696.4432683,263034297,19.43505795535972,80.0,0.34064377627920805,77.20514461956304,95.34328757729384,41.65096176923077,41.8544932251185,-4.65671242270616
2017-04-26,43.711498,43.802502,43.387402,43.586498,43.586498,24744000,1109767815.0845594,238290297,21.703005697610145,84.0,0.4264026645344856,76.53663417158066,92.68155175334581,41.69582715384615,41.98278987510973,-7.31844824665419
2017-04-27,43.68,43.77,43.519001,43.712502,43.712502,40536000,1131732116.1694236,278826297,23.808957172556973,84.0,0.4987849882155757,77.46554129805219,96.95070303235656,41.78003880769231,42.11091669917568,-3.0492969676434503
2017-04-28,45.533001,45.842499,45.288502,45.298,45.298,65526000,1068452936.8128568,344352297,27.17117076141097,92.0,0.6762890994960316,85.33364677200605,89.09146895210004,41.92690419230769,42.346996943681184,-10.908531047899963
2017-05-01,45.097,45.784,45.072498,45.628502,45.628502,42320000,1092274955.4719748,386672297,29.764457992916057,92.0,0.8340171057756294,86.3996674915304,95.71276913519132,42.10957726923077,42.590071392297396,-4.28723086480868
2017-05-02,45.480999,46.038502,45.472649,45.821999,45.821999,31744000,1099727589.2266777,418416297,32.30843966258906,100.0,0.9635243687493897,86.99562830865968,95.65909033037167,42.305750307692314,42.8294734373124,-4.340909669628326
2017-05-03,45.743,46.404999,45.627151,46.352001,46.352001,29990000,1125630903.8588426,448406297,34.85558823460599,100.0,1.0962892002103217,88.48414079727164,99.00622538908691,42.51253888461539,43.090401404918886,-0.9937746109130926
2017-05-04,46.303501,46.796501,46.2295,46.583,46.583,28442000,1132653557.3603354,476848297,37.401997182918585,64.0,1.2062411769935508,89.07129103899969,96.16901267934229,42.72550038461538,43.34911241196193,-3.8309873206577127
2017-05-05,46.676998,46.744999,46.259998,46.356499,46.356499,38226000,1109639267.134129,438622297,39.76651977778028,64.0,1.2605710941086912,84.52077076362312,91.47448003768262,42.90957730769231,43.571881788853645,-8.525519962317373
2017-05-08,46.306,46.846249,46.263,46.715,46.715,26596000,1124265427.8236463,465218297,42.01103099404821,72.0,1.3173701563030775,85.7607524681068,97.39158344512353,43.10726957692308,43.804705360049674,-2.60841655487647
2017-05-09,46.8475,46.875,46.476501,46.608501,46.608501,31636000,1113587834.2437372,433582297,44.1097188771468,76.0,1.338362434018869,83.61783855517818,94.57121613363203,43.304596499999995,44.01239392597192,-5.4287838663679615
2017-05-10,46.598999,46.599998,46.257999,46.438999,46.438999,23478000,1114960889.363782,410104297,45.39105066744814,76.0,1.326035854633588,80.18371212354718,91.00101320928526,43.47811561538461,44.192142449974,-8.99898679071474
2017-05-11,46.265999,46.626499,46.151501,46.529999,46.529999,16700000,1124875387.1090353,426804297,46.25883490874691,76.0,1.3085260177404692,80.64333240450566,92.12685988133265,43.66278865384615,44.365317009235184,-7.873140118667358
2017-05-12,46.5765,46.672001,46.392502,46.611,46.611,21012000,1136715597.4997694,447816297,47.10296754731058,76.0,1.286357125385564,81.06434101337094,92.93078245259534,43.85665407692307,44.531663897439984,-7.0692175474046675
2017-05-15,46.647499,46.912498,46.466999,46.854,46.854,22162000,1153057460.1885746,469978297,48.087779483819,92.0,1.273713610003398,82.30756283013243,98.34052746364922,44.06665403846153,44.70368879392591,-1.6594725363507887
2017-05-16,47.0,47.155499,46.879002,47.150002,47.150002,19390000,1171676480.1779418,489368297,49.19237349785435,96.0,1.2729051622253067,83.71053208198728,99.84883808543279,44.29421176923077,44.88489717956103,-0.1511619145672104
2017-05-17,46.783501,46.966648,45.907001,45.980999,45.980999,47242000,1131032552.018847,442126297,47.56957533582836,96.0,1.1645119206644026,62.59849839978337,43.61500546567168,44.4766925,44.966089907000956,-56.38499453432832
2017-05-18,46.049999,46.658501,45.9375,46.512001,46.512001,31938000,1149991604.6942244,474064297,46.0626913282328,92.0,1.1086767835934523,66.70602876088617,69.10716797543533,44.68225023076923,45.0806018398157,-30.89283202456467
2017-05-19,46.573502,46.887749,46.549999,46.7005,46.7005,27860000,1146960370.7045867,501924297,44.97010880662017,88.0,1.0673337698359475,68.04753793974172,72.96259321983538,44.89319253846155,45.200594296125644,-27.03740678016462
2017-05-22,46.75,47.094151,46.75,47.092999,47.092999,22408000,1169218355.0661027,524332297,44.22054783085395,84.0,1.054089633475094,70.695303135519,95.91061721545094,45.12069246153847,45.34077242233856,-4.089382784549065
2017-05-23,47.396,47.573349,47.12875,47.441002,47.441002,25416000,1179502825.9713452,549748297,44.077468797512516,100.0,1.0594616789647375,72.84397665378634,92.05766142486426,45.33540403846154,45.496344983646814,-7.942338575135742
2017-05-24,47.648998,47.754501,47.474998,47.748001,47.748001,20496000,1199045533.8778799,570244297,44.13401350571958,100.0,1.0760868578644391,74.61242764411153,99.64817320703678,45.56259638461539,45.663134318191496,-0.3518267929632217
2017-05-25,47.866501,48.631451,47.773499,48.477001,48.477001,33210000,1220298490.8265204,603454297,44.946753730886435,100.0,1.1350030309868302,78.23674312565419,94.33096588302236,45.815154115384615,45.87156888721435,-5.669034116977637
2017-05-26,48.485001,48.749001,48.251499,48.573502,48.573502,25040000,1227672250.4495971,628494297,45.7875972872434,100.0,1.1759260038777413,78.67082127240546,93.82480647431379,46.06480803846154,46.071712080754025,-6.175193525686212
2017-05-30,48.515499,48.810001,48.474499,48.793999,48.793999,29334000,1254208039.6013756,657828297,46.6145240191125,100.0,1.2121768002580495,79.6686714681481,99.44877712710989,46.31998107692308,46.273362963661135,-0.5512228728901241
2017-05-31,48.750999,48.963501,48.008999,48.243,48.243,48962000,1229252604.2015545,608866297,46.15426513839612,100.0,1.182810104541673,70.76001998124464,76.42725339440541,46.51632723076922,46.419262003389946,-23.572746605594595
2017-06-01,48.447498,48.575001,48.0005,48.3475,48.3475,28210000,1235120421.2984781,637076297,45.705418797932076,96.0,1.1546588745126982,71.41291658039076,79.84619663013237,46.698346384615384,46.562094447583284,-20.153803369867635
2017-06-02,48.473,48.793999,48.299999,48.779999,48.779999,35020000,1268155482.0272226,672096297,45.529781196282116,92.0,1.1539459065468378,74.00045378811468,93.996335678063,46.89809642307693,46.726383673688225,-6.003664321936996
2017-06-05,48.827499,49.345501,48.755001,49.183998,49.183998,25042000,1279499402.0069013,697138297,45.902394373270944,96.0,1.1724647731656432,76.17023699443592,95.30309728079114,47.108538576923074,46.90842917934095,-4.6969027192088495
2017-06-06,49.158001,49.412498,48.757,48.828499,48.828499,36292000,1251124563.334625,660846297,46.308181191342136,100.0,1.1452535401955828,70.58780990412,83.34047925301323,47.244327,47.05065657346384,-16.65952074698677
2017-06-07,49.0,49.199001,48.797001,49.047001,49.047001,29078000,1258213230.0012915,689924297,46.684983236693945,96.0,1.1283132347039952,71.94860857846874,89.48209466595382,47.375807730769225,47.198533938392444,-10.517905334046173
2017-06-08,49.1175,49.2285,48.860001,49.170502,49.170502,29638000,1278521789.6283193,719562297,47.0646248190929,92.0,1.11203457672962,72.71695847702293,91.545988313009,47.50459630769231,47.34460564665967,-8.454011686990995
2017-06-09,49.224998,49.224998,46.781502,47.491501,47.491501,66188000,1250797870.4469495,653374297,44.27693940426227,52.0,0.9526704820006415,51.902741008144616,27.849823736956786,47.54842323076923,47.355486783944144,-72.1501762630432
2017-06-12,46.978001,47.467751,45.76165,47.145,47.145,75270000,1297589523.8895068,578104297,42.82262645533195,-16.0,0.7893148239423198,48.798408306861,37.89119678496616,47.57003861538462,47.339895170318655,-62.10880321503384
2017-06-13,47.595501,47.999001,47.204498,47.669998,47.669998,40266000,1304507292.8620594,618370297,40.69053126101746,-16.0,0.6942147633673699,53.350994678238195,52.27136270806121,47.6205578076923,47.364347231776534,-47.72863729193879
2017-06-14,47.995998,48.057499,47.112499,47.537998,47.537998,29794000,1301543593.827139,588576297,38.811448752688825,-16.0,0.6012649750152832,52.09673854541994,48.65576435940364,47.65221157692307,47.37721025164494,-51.34423564059636
2017-06-15,46.698502,47.16695,46.222,47.115501,47.115501,42662000,1339560020.54178,545914297,37.95023595822446,-16.0,0.4878855798674664,48.19149192194527,37.08319272673089,47.67171157692307,47.357824381152724,-62.91680727326911
2017-06-16,47.0,47.102001,46.57975,46.988998,46.988998,61894000,1374669169.265287,484020297,37.150538363364696,-16.0,0.3834042123884913,47.054132883513645,33.618162136577595,47.69286538461539,47.330503908474746,-66.3818378634224
2017-06-19,47.498001,47.9995,47.452499,47.8685,47.8685,30666000,1390646910.9257224,514686297,35.09974682108408,-16.0,0.36733601607433286,55.004963635382424,57.70851046113113,47.74434619230769,47.37035547080995,-42.29148953886887
2017-06-20,47.875999,48.081001,47.5005,47.531502,47.531502,22520000,1370532298.8234177,492166297,33.087515143422884,-16.0,0.32367777661367114,51.79539429722899,48.477833095215196,47.77975011538462,47.38229225074995,-51.522166904784804
2017-06-21,47.681999,48.005001,47.537998,47.9725,47.9725,24044000,1391229622.0611696,516210297,31.219014299880346,-15.999999999999993,0.3209632952514596,55.45814343967743,60.557163705528026,47.822769346153855,47.42601134328699,-39.442836294471974
2017-06-22,47.935001,48.035999,47.727501,47.8545,47.8545,18828000,1387903422.2154663,497382297,29.43732172419076,-16.0,0.3057657580559834,54.269893822060546,57.32503790900088,47.84986542307692,47.457751243784244,-42.67496209099912
2017-06-23,47.841499,48.299999,47.709999,48.279499,48.279499,30558000,1416337900.1815681,527940297,27.38015078439389,-16.0,0.32427739976258607,57.77873851257039,68.96614156491864,47.93826926923077,47.51862144794838,-31.033858435081363
2017-06-26,48.494999,48.665501,47.539501,47.613499,47.613499,31968000,1388571619.655813,495972297,25.90586893914252,-16.0,0.28195714868072486,51.15475896202898,53.415896274716175,47.98063457692308,47.52564941476702,-46.584103725283825
2017-06-27,47.123001,47.414501,46.342499,46.366501,46.366501,51598000,1339284166.0838983,444374297,25.140233211813932,-16.000000000000007,0.1461114459962971,41.54978989466536,17.44670233785706,47.96778846153846,47.439786569228716,-82.55329766214294
2017-06-28,46.450001,47.137501,45.799999,47.024502,47.024502,54428000,1384515455.2423444,498802297,24.981340179814783,-16.0,0.09050464821223869,47.1850302381544,36.46332970293475,47.96515396153846,47.40902474928585,-63.53667029706525
2017-06-29,46.495998,46.563,45.530998,45.8895,45.8895,65984000,1364375157.0336199,432818297,25.08929526625431,-68.0,-0.04463479333609399,40.01803825824501,11.437283677827113,47.90548080769231,47.29646736044986,-88.5627163221729
2017-06-30,46.302502,46.302502,45.415501,45.436501,45.436501,41804000,1324550600.123312,391014297,25.299828973789797,-72.0,-0.18614128693281629,37.56554578241103,0.6461538461538706,47.81657696153846,47.15869207449062,-99.35384615384613
2017-07-03,45.609001,45.696999,44.739498,44.935001,44.935001,34196000,1304318910.5271654,356818297,26.096328212862293,-76.0,-0.3348926276489621,35.007702809273,4.979695634465948,47.68034619230769,46.99397421712094,-95.02030436553406
2017-07-05,45.088001,45.725498,44.924999,45.585499,45.585499,36278000,1327907616.1695209,393096297,26.784470004309753,-76.0,-0.3957276823108984,40.65247595707011,21.548659030571315,47.565423,46.88964271955643,-78.45134096942868
2017-07-06,45.206001,45.7472,44.985001,45.334499,45.334499,28490000,1325545170.837003,364606297,27.381657687330136,-76.0,-0.4589035492704241,39.23640110471988,15.155388317329438,47.43236530769231,46.774446888478174,-84.84461168267056
2017-07-07,45.442501,46.077,45.442501,45.929501,45.929501,32756000,1343071904.1431236,397362297,27.29992870379909,-76.0,-0.4557060940475921,44.19859500027283,30.310802105856872,47.34338457692308,46.71185830414646,-69.68919789414312
2017-07-10,46.088501,46.519001,45.9795,46.439999,46.439999,23856000,1359941182.2946005,421218297,26.4407625910126,-76.0,-0.4072842462912689,48.113698600817685,43.31379777346075,47.27001915384616,46.69172057791339,-56.68620222653925
2017-07-11,46.477001,46.571499,46.099998,46.504501,46.504501,22264000,1375877969.9578288,443482297,25.55248527004404,-76.0,-0.35956002658143404,48.60436708351149,44.956740990773554,47.1825,46.677852461030916,-55.043259009226446
2017-07-12,46.933998,47.314999,46.723499,47.191502,47.191502,30642000,1393724720.341599,474124297,23.895872663052693,-76.0,-0.263268207417525,53.633662143974696,62.45547952968965,47.10586553846154,46.71590057502863,-37.54452047031035
2017-07-13,47.314499,47.7225,47.150501,47.358002,47.358002,25894000,1386617574.493442,500018297,22.902342035087457,-68.0,-0.17154364018178114,54.78837127911501,66.69643400680032,47.04930796153846,46.76346364354502,-33.30356599319968
2017-07-14,47.599998,47.845501,47.400249,47.7995,47.7995,21076000,1403338660.5301137,521094297,22.138982081717693,-68.0,-0.06250553604914444,57.79017662774913,77.94191700821428,47.00132715384616,46.8402070773565,-22.058082991785714
2017-07-17,47.849998,48.036999,47.462051,47.671001,47.671001,23310000,1396971495.3603935,497784297,21.68009015034467,-64.0,0.013384859337385535,56.6120367792319,88.90074635307148,46.94365403846154,46.90174736792269,-11.099253646928515
2017-07-18,47.650002,48.402,47.529999,48.27,48.27,23080000,1413063980.437819,520864297,21.709313320139795,-20.0,0.12047400832298649,60.64019730431547,96.39590640496586,46.973596307692304,47.003099414743225,-3.6040935950341533
2017-07-19,48.391998,48.652,48.2015,48.544498,48.544498,24490000,1425865971.6475854,545354297,22.030506276952018,-20.000000000000007,0.22490011640774554,62.36457387737836,97.25234645247457,47.02742315384615,47.117277087725206,-2.7476535475254367
2017-07-20,48.75,48.794998,48.0755,48.407501,48.407501,32490000,1423359967.4057393,512864297,22.49491406574759,48.0,0.2932239433526931,60.92985793996554,90.44514856367904,47.05578865384616,47.21284922937519,-9.554851436320947
2017-07-21,48.112499,48.661499,48.0075,48.646,48.646,34220000,1455958020.644353,547084297,22.780295692834432,48.0,0.3624379850519759,62.545311015160664,96.3260263839231,47.098404115384625,47.31900854571777,-3.6739736160769025
2017-07-24,48.611,49.310001,48.538502,49.016998,49.016998,64966000,1471577921.9507709,612050297,23.78183616029119,56.0,0.44213044524313005,64.97158338633629,93.31806462117922,47.17153861538462,47.444785542331275,-6.68193537882078
2017-07-25,47.690498,47.985001,47.27,47.535,47.535,93220000,1447457965.1674926,518830297,22.483017497969378,56.0,0.3813069716579278,50.81174746020908,58.959514450867005,47.19253869230769,47.45146809475118,-41.040485549132995
2017-07-26,47.734001,47.75,47.113949,47.389999,47.389999,41766000,1441945360.885761,477064297,21.055727795669444,56.0,0.3177408431036213,49.671112391945556,50.35547511312225,47.17413480769231,47.44691482847331,-49.64452488687775
2017-07-27,47.589001,47.589001,46.0,46.704498,46.704498,64260000,1434665868.1101115,412804297,20.720256754557965,56.0,0.20963350200718622,44.57650857096354,21.768436640613523,47.142326961538465,47.39192098932714,-78.23156335938648
2017-07-28,46.470001,47.191502,46.375,47.0765,47.0765,36928000,1461191459.1607153,449732297,20.408747930668735,56.0,0.15222040568369266,47.710806935461214,32.52264878469834,47.107865423076916,47.368556471599206,-67.47735121530165
2017-07-31,47.094501,47.179501,46.301998,46.525002,46.525002,39402000,1441816293.5031621,410330297,20.20188719544197,56.0,0.061509787131853955,43.75982217896036,15.86108282142515,47.056730884615384,47.306070955184445,-84.13891717857484
2017-08-01,46.618999,46.872349,46.463001,46.5415,46.5415,25554000,1426063066.6643844,435884297,20.00980222701711,56.0,-0.008944672270665421,43.90946305105041,16.35951167386352,46.98988476923077,47.24943606961523,-83.64048832613648
2017-08-02,46.4305,46.630001,45.834,46.519501,46.519501,36488000,1452420617.079522,399396297,20.545103820679554,56.0,-0.06579700744619288,43.74233021451136,19.720966708582527,46.94780792307692,47.195366805199285,-80.27903329141748
2017-08-03,46.516998,46.612,46.112,46.182499,46.182499,24050000,1435152620.8795216,375346297,21.042169586223253,56.0,-0.1364729622709433,41.157864850365506,10.02586017667996,46.94073092307693,47.120339560369715,-89.97413982332003
2017-08-04,46.337502,46.51535,46.151501,46.397999,46.397999,21646000,1442835797.0377629,396992297,21.503730654228118,56.0,-0.17309973072599405,43.458438185117394,16.22551316872452,46.91663465384616,47.06683285219418,-83.77448683127548
2017-08-07,46.452999,46.584999,46.325001,46.467999,46.467999,20644000,1444900054.116663,417636297,21.782273522363216,56.0,-0.19423922474945243,44.22130973669571,18.239321565212332,46.938884615384616,47.02247478906869,-81.76067843478768
2017-08-08,46.3545,46.790699,46.280499,46.3395,46.3395,21232000,1428578713.591379,396404297,21.59491256998489,56.00000000000001,-0.21883858645159648,43.07244336061999,14.54257349177973,46.973615346153856,46.97188406395249,-85.45742650822027
2017-08-09,46.030499,46.299,45.862499,46.145,46.145,23842000,1435597531.055715,372562297,21.98831280678633,52.0,-0.251133373124766,41.32248045914977,8.947063018681533,47.020153769230774,46.9106333925486,-91.05293698131845
2017-08-10,45.877499,45.963001,45.306499,45.362,45.362,36480000,1405285605.1209884,336082297,22.996074124660332,48.0,-0.3360351760952014,35.134003076003125,1.3863112844704364,47.011557653846154,46.79591980791537,-98.61368871552958
2017-08-11,45.398499,45.889,45.278999,45.719501,45.719501,24136000,1416008420.9983394,360218297,23.961655041601357,-56.0,-0.3702056237091327,39.582949034078034,16.278701937397035,47.02636542307692,46.71618508140312,-83.72129806260297
2017-08-14,46.126499,46.233398,45.9095,46.133499,46.133499,21290000,1424165584.6733234,381508297,24.069096754440952,-56.0,-0.3597329929370332,44.343544144140935,34.58112724357461,47.034211500000005,46.67302314944733,-65.41887275642539
2017-08-15,46.211498,46.327499,45.991001,46.111,46.111,17668000,1419098802.701365,363840297,23.9604078526277,-56.0,-0.34922321107357135,44.13998829192535,36.01732812352529,47.021557692307695,46.631391805043826,-63.98267187647471
2017-08-16,46.2645,46.634998,46.172249,46.348,46.348,20134000,1414258495.9735274,383974297,23.197177129321258,-56.0,-0.3181033168948062,46.904876890349094,55.895389445140715,47.015538423076926,46.610399819485025,-44.104610554859285
2017-08-17,46.289001,46.342999,45.549,45.549,45.549,25544000,1388714495.9735274,358430297,23.366508851018583,-56.0,-0.3538344161348732,39.759841610459816,14.206825354564224,46.95236526923077,46.531777610634286,-85.79317464543577
2017-08-18,45.515499,45.763748,45.3577,45.533501,45.533501,26854000,1385113707.682488,331576297,23.76169605432027,-56.0,-0.37903295353225275,39.63371904797514,15.972761791194783,46.88219215384615,46.45783119503175,-84.02723820880522
2017-08-21,45.5,45.650002,45.169998,45.333,45.333,18868000,1379060274.7944286,312708297,24.357991264122855,-80.0,-0.410450315270559,37.956344428843586,10.05749981026723,46.787326769230766,46.374510365770135,-89.94250018973277
2017-08-22,45.636002,46.292999,45.57375,46.234501,46.234501,23334000,1398598670.401513,336042297,23.564164658302353,-80.0,-0.3584729512162994,48.50837804404551,65.68164022851865,46.732076769230765,46.364139301639014,-34.31835977148135
2017-08-23,46.0965,46.496498,45.967999,46.349998,46.349998,21804000,1408314526.431515,357846297,22.45161882992163,-80.0,-0.30445134745622227,49.68894702736814,72.80800098229112,46.65823053846154,46.3630917978139,-27.19199901770888
2017-08-24,46.432999,46.542,45.775002,46.063999,46.063999,25406000,1402053968.2240622,332440297,21.715983168909485,-80.0,-0.2814719331432727,46.825956267466424,55.161377700143625,46.56282673076923,46.34093677575361,-44.838622299856375
2017-08-25,46.1745,46.277748,45.775002,45.794498,45.794498,21068000,1382619961.2463834,311372297,21.032892912255345,-80.0,-0.28175911642351537,44.239242443742924,38.53270899444122,46.46232661538462,46.3004598294015,-61.46729100555878
2017-08-28,45.799999,45.96225,45.593498,45.690498,45.690498,21730000,1372322089.072131,289642297,20.69376270368519,-80.0,-0.2870694837636023,43.246424590160785,35.52901023890766,46.348653461538454,46.25527747166805,-64.47098976109234
2017-08-29,45.255001,46.1665,45.25,46.064499,46.064499,23712000,1390756079.8806415,313354297,20.901982426715396,-76.0,-0.25812374326066845,47.78463206680603,61.0580887372011,46.23509580769231,46.241145733025974,-38.9419112627989
2017-08-30,46.002499,46.540951,45.982498,46.4785,46.4785,26024000,1410959626.5067673,339378297,20.27299249851851,-72.0,-0.1994781546243516,52.32885867246692,89.31754266211564,46.19446119230769,46.258727530579606,-10.68245733788436
2017-08-31,46.588001,47.098999,46.588001,46.966499,46.966499,31652000,1426197119.9920647,371030297,19.002150271685384,-68.0,-0.11232880564006109,57.071394729522424,93.13115960022829,46.178172730769234,46.311155046832965,-6.868840399771711
2017-09-01,47.056499,47.124001,46.7575,46.867001,46.867001,18948000,1418571462.6214166,352082297,17.865515404632248,-64.0,-0.050706463209174046,55.851368925354286,86.84751251661343,46.18442284615384,46.35232882114163,-13.15248748338656
2017-09-05,46.653999,46.849998,46.098,46.422501,46.422501,26528000,1414938104.7029114,325554297,17.47676069043229,-60.0,-0.03730768821963437,50.64288784908372,64.09933863970511,46.15926903846154,46.357526760316325,-35.90066136029488
2017-09-06,46.5075,46.54575,45.963501,46.390499,46.390499,30554000,1429198254.291833,295000297,17.31589434555261,35.99999999999999,-0.028937779743834824,50.279343909389226,62.46157247455601,46.154095846153844,46.35996914844104,-37.53842752544399
2017-09-07,46.586498,46.820499,46.181,46.797501,46.797501,24254000,1451707784.0362108,319254297,16.625376885781083,36.0,0.010417012135988557,54.7302706893775,83.29071142674792,46.163942038461535,46.39237891522318,-16.70928857325208
2017-09-08,46.824501,46.849499,46.243999,46.325001,46.325001,20230000,1436890403.226962,299024297,15.927141123633929,36.0,0.003439518456232804,49.22145776910898,59.109581715074164,46.15646126923077,46.38738795853999,-40.890418284925836
2017-09-11,46.712502,46.918999,46.346001,46.453999,46.453999,25340000,1421102510.9830103,324364297,15.13539943523641,36.0,0.008224063083709154,50.68097999764235,64.24751107390036,46.166903576923076,46.39232210975925,-35.75248892609965
2017-09-12,46.629501,46.674,46.19305,46.6035,46.6035,22688000,1437139075.2828333,347052297,14.6899378182702,36.0,0.023804922115679972,52.38896446292218,72.22514822564112,46.17480746153846,46.407964916443746,-27.774851774358876
2017-09-13,46.533001,46.862499,46.493,46.754501,46.754501,22052000,1446300258.820542,369104297,13.859797383067194,36.0,0.047786530506932934,54.117341396267655,80.28282802410446,46.18582676923077,46.43363425596643,-19.717171975895543
2017-09-14,46.5625,46.6385,46.200001,46.255501,46.255501,27952000,1425423923.759345,341152297,13.658484991919748,36.0,0.026224696277779458,47.92571376873985,53.65530754786163,46.18259603846153,46.42043919996892,-46.34469245213837
2017-09-15,46.233002,46.324501,45.818001,46.0145,46.0145,50108000,1414195180.9834313,291044297,14.129442211391222,36.0,-0.010192486622877084,45.23395626394657,40.79506894606771,46.177576807692304,46.39036962960085,-59.20493105393229
2017-09-18,46.0005,46.104,45.529999,45.75,45.75,26138000,1408093334.7113867,264906297,15.008480437065874,36.0,-0.05970802893394733,42.41810250938181,26.68088224072453,46.19249988461539,46.342934842223,-73.31911775927547
2017-09-19,45.870998,46.120998,45.627499,46.0905,46.0905,18734000,1424511830.3962815,283640297,15.780435717153054,36.00000000000001,-0.07065943069979141,46.99274306074288,35.16313028465466,46.206769076923074,46.3242359650213,-64.83686971534534
2017-09-20,46.148998,46.694,46.099998,46.578999,46.578999,33396000,1444976650.3800528,317036297,15.138961196777473,36.0,-0.03946577190436784,52.78778550344236,65.80920224692343,46.223903692307694,46.34310730094565,-34.190797753076566
2017-09-21,46.650002,46.8265,46.191502,46.622501,46.622501,25812000,1454203961.3322132,342848297,14.266595536942607,36.0,-0.01110629823953957,53.27765025969785,68.53830798204777,46.24357680769231,46.36380313050523,-31.461692017952238
2017-09-22,46.387501,46.7365,46.324001,46.426498,46.426498,21054000,1443612880.4568655,321794297,13.456541709953088,36.0,-0.004396336841288928,50.7239323853279,64.54276457883397,46.24659596153845,46.36844719491226,-35.45723542116603
2017-09-25,46.272499,46.32,45.485001,46.0485,46.0485,37136000,1456599332.9723773,284658297,14.162864832573211,36.0,-0.029242830482637316,46.13155649312065,39.29566150022519,46.2658075,46.344747402696534,-60.70433849977481
2017-09-26,46.186001,46.541,46.056999,46.243,46.243,33338000,1448884839.2791831,317996297,14.322630854152962,36.0,-0.03286053540981726,48.70499828340225,52.85913927355574,46.293095923076926,46.33721055805234,-47.14086072644426
2017-09-27,46.387001,47.494999,46.387001,47.224499,47.224499,44788000,1471804290.7799983,362784297,13.853085487264426,80.0,0.04297577594820723,59.277336285245305,86.54227516644305,46.36584588461539,46.40293562782624,-13.457724833556949
2017-09-28,47.068001,47.5345,47.0275,47.474998,47.474998,20406000,1487420555.8214183,383190297,13.477477971628945,84.0,0.12188476318370789,61.4605788812526,97.09675388960903,46.41355730769231,46.48234765539467,-2.9032461103909695
2017-09-29,47.599998,47.9893,47.5755,47.955502,47.955502,31620000,1513875293.569123,414810297,13.79501027376285,88.0,0.22064984704989143,65.3032268427948,98.65040077083458,46.47530746153846,46.591470199439506,-1.3495992291654186
2017-10-02,47.999001,48.126999,47.391998,47.663502,47.663502,25668000,1507170436.9444382,389142297,13.73220658859495,92.0,0.2722219230470486,61.30306011177063,82.45657263934353,46.5368268076923,46.67087996244398,-17.543427360656462
2017-10-03,47.700001,47.900002,47.457001,47.8895,47.8895,17766000,1524094097.8436234,406908297,13.673888880939044,92.0,0.32755348204142365,63.18281185586715,91.01062907693345,46.617403807692305,46.76114811337406,-8.989370923066543
2017-10-04,47.849998,48.019501,47.5345,47.584,47.584,19048000,1508934238.2804475,387860297,13.81301800465283,92.0,0.342801244990973,59.009892433421975,79.44741063392196,46.69023080769231,46.82210010497598,-20.55258936607804
2017-10-05,47.774502,48.545502,47.758999,48.498001,48.498001,24276000,1530277930.8995476,412136297,14.715981756175665,32.0,0.4237526918033936,66.20194560289858,98.4479338513532,46.78382703846153,46.9462409120148,-1.5520661486468024
2017-10-06,48.334999,48.973,48.167999,48.9445,48.9445,23478000,1552093515.5733554,435614297,16.085115254881064,36.0,0.5179652533595203,69.05808574254829,99.18291260977995,46.878673192307694,47.09426010371741,-0.8170873902200392
2017-10-09,49.0,49.271252,48.8055,48.849998,48.849998,17828000,1537672093.941242,417786297,17.689601137423793,40.0,0.5783371548253271,67.75305162503449,88.87411320591272,46.951115461538464,47.224314762701304,-11.125886794087279
2017-10-10,49.0,49.078499,48.304001,48.630001,48.630001,19368000,1534608766.128904,398418297,18.058517576948336,39.99999999999999,0.6014967225854235,64.68831195212216,83.06369546023238,47.01892315384616,47.32843966916788,-16.93630453976762
2017-10-11,48.686001,49.5355,48.612499,49.462502,49.462502,33866000,1563117999.9542196,432284297,18.952343853500878,48.0,0.6791973557583191,70.18447789749773,98.19780229547031,47.13584626923077,47.486518360340625,-1.8021977045296964
2017-10-12,49.372501,49.706001,49.25,49.391499,49.391499,25248000,1553539118.0131714,407036297,19.973953957584456,52.0,0.7266697224236012,69.19525470859503,92.54911158493255,47.25126934615385,47.62762803735243,-7.4508884150674515
2017-10-13,49.599998,49.8605,49.450001,49.484001,49.484001,23396000,1534018713.3252184,430432297,21.09583412146254,56.0,0.7629611125753328,69.79260030198759,90.10125145228035,47.35459626923077,47.7651371456967,-9.898748547719645
2017-10-16,49.605,49.695351,49.200001,49.599998,49.599998,18210000,1545218001.1822891,448642297,21.560435205348863,56.0,0.7919531463115845,70.5634596206979,92.50030012963867,47.48055769230769,47.90105276453398,-7.499699870361332
2017-10-17,49.5145,49.821999,49.429501,49.609001,49.609001,25804000,1543015741.8281012,474446297,22.15457862087286,56.0,0.8063607836113675,70.62611355862671,91.12252029650539,47.601903923076925,48.02756744864257,-8.877479703494625
2017-10-18,49.588501,49.835999,49.348751,49.640499,49.640499,21152000,1547193978.9804342,495598297,22.51007920549352,56.0,0.8109721828221836,70.85980055013097,91.08767179447278,47.718711576923084,48.14704385985423,-8.912328205527213
2017-10-19,49.299999,49.444,48.919498,49.2225,49.2225,26272000,1551276366.7387264,469326297,21.859466685054116,56.0,0.7719986046218565,63.62572832918739,74.15436568412726,47.81363461538461,48.2267072776428,-25.845634315872744
2017-10-20,49.472,49.549999,49.229,49.41,49.41,23664000,1554298954.5474107,492990297,21.4280206672656,56.0,0.7476233099677856,65.33527659399039,81.25649313771278,47.9349615,48.31435859041,-18.743506862287212
2017-10-23,49.476002,49.476002,48.306,48.422501,48.422501,29568000,1530619323.2305412,463422297,20.48398801404891,56.0,0.6412310841280657,51.58452161535457,38.177171109200145,48.02757692307693,48.322369139268524,-61.822828890799855
2017-10-24,48.5,48.6115,48.049999,48.527,48.527,24244000,1547566388.7638173,487666297,19.989997645367804,56.0,0.5589039774544702,52.71856485309675,36.5453549629526,48.13438461538462,48.337526980804185,-63.4546450370474
2017-10-25,48.418499,48.804501,48.026001,48.6665,48.6665,24226000,1563203532.691884,511892297,19.164327496254337,56.0,0.49916161208393106,54.25884346049005,34.9141100649277,48.23346153846153,48.36189535259647,-65.0858899350723
2017-10-26,49.0,49.380001,48.610001,48.627998,48.627998,40842000,1524270710.5464296,471050297,18.175649521304067,56.0,0.44359507953340227,53.73850256587309,32.81533541310172,48.312269192307696,48.38160665981155,-67.18466458689828
2017-10-27,50.459499,52.419498,50.41,50.963501,50.963501,103354000,1477852863.1118968,574404297,20.091761420276537,96.0,0.5813127639506988,71.55709011837472,66.86017994322069,48.47923073076923,48.57285809241811,-33.13982005677932
2017-10-30,50.700001,51.248501,50.375,50.855499,50.855499,41702000,1482030076.2965415,532702297,21.817459093996945,96.0,0.6739710436058388,70.21032875869385,64.40195589071764,48.64957692307693,48.741942604090845,-35.59804410928235
2017-10-31,50.761002,51.200001,50.521,50.832001,50.832001,26614000,1479795953.834277,506088297,23.419892648165895,92.0,0.7370114958301741,69.90207256369679,63.86711997299645,48.83355773076923,48.896761744528554,-36.13288002700355
2017-11-01,50.8605,51.483501,50.8475,51.275002,51.275002,27468000,1489254389.2832782,533556297,25.092313243525023,88.0,0.8133422832329416,72.36540174933641,73.95022689215452,49.02709626923077,49.07292768937829,-26.04977310784547
2017-11-02,51.088001,51.404499,50.650501,51.278999,51.278999,20980000,1503250312.4024377,554536297,26.293908594659797,84.0,0.8641955977709159,72.38736051425713,74.0412022587019,49.183038576923074,49.23634037905397,-25.95879774129809
2017-11-03,51.105499,51.6325,51.015499,51.624001,51.624001,21528000,1524185229.1756682,576064297,27.575975808296935,76.0,0.9217110824058423,74.28662719132332,81.89376253130483,49.34261561538461,49.41320412875368,-18.106237468695166
2017-11-06,51.449501,51.7435,51.25,51.294998,51.294998,22504000,1505785119.7207544,553560297,28.848438756779682,76.0,0.9300239882320014,69.38535555325456,74.40535409492715,49.47105776923077,49.552596267364514,-25.59464590507285
2017-11-07,51.363499,51.698502,51.2565,51.6665,51.6665,22246000,1524809792.7041347,575806297,30.03001149465652,72.0,0.955573871848145,71.65917803090858,82.8610785440391,49.62501923076923,49.70918172904122,-17.138921455960904
2017-11-08,51.526001,52.176102,51.422501,51.9925,51.9925,21774000,1535974067.0057876,597580297,31.490501377827847,68.0,0.9907075542043913,73.51792580180614,90.28113596071654,49.78282692307693,49.87831641577891,-9.718864039283465
2017-11-09,51.699501,51.699501,50.983299,51.563,51.563,24904000,1551385156.0560837,572676297,31.938953162361894,64.0,0.9726817206749132,67.25914670415017,80.5053241188057,49.93586538461538,50.00310779238788,-19.49467588119431
2017-11-10,51.323002,51.537998,51.264,51.4035,51.4035,14400000,1551648036.8070378,558276297,32.35537267657208,8.0,0.9347505779304441,65.04457542269787,76.87495860359078,50.047615346153854,50.1068405485073,-23.125041396409216
2017-11-13,51.171001,51.578999,51.128502,51.287498,51.287498,17716000,1546437217.2455313,540560297,32.45341809998107,8.000000000000007,0.885126297114347,63.409337320692615,74.23464725251891,50.137730653846155,50.19429665602528,-25.76535274748108
2017-11-14,51.129501,51.3405,50.7075,51.299999,51.299999,19184000,1563166331.9880273,559744297,31.690790003394227,8.0,0.8371571962229467,63.51578565616499,70.61294443859656,50.23196146153846,50.276200533356736,-29.387055561403447
2017-11-15,50.960499,51.204498,50.771,51.045502,51.045502,17080000,1567717316.0294762,542664297,30.98263534227787,8.0,0.7697325593852611,59.707577767722114,32.79543438046894,50.32486534615384,50.33318582718216,-67.20456561953105
2017-11-16,51.125999,51.796001,51.125999,51.625,51.625,22594000,1578778226.2954159,565258297,31.035300906414708,8.0,0.7543628688784096,64.87225518159309,69.40195502531228,50.408038346153845,50.42887576590941,-30.598044974687728
2017-11-17,51.7005,51.721001,50.887501,50.954498,50.954498,27942000,1555328200.3182113,537316297,30.592053953057675,8.0,0.6802370216849738,55.93797825700998,26.191618401766195,50.468153692307695,50.467810746212415,-73.80838159823381
2017-11-20,51.013,51.130501,50.875,50.918999,50.918999,19070000,1542826166.236153,518246297,30.154217502675404,7.9999999999999964,0.6115773975683396,55.50215441966401,17.59949029923294,50.523345923076924,50.50123209834483,-82.40050970076706
2017-11-21,51.165501,51.755501,51.132751,51.724499,51.724499,21940000,1562581713.7913516,540186297,30.48588927586399,8.0,0.6150711120345846,62.619023346162464,70.39835448456063,50.6050575,50.5918444614304,-29.601645515439365
2017-11-22,51.75,51.985298,51.571499,51.798,51.798,14926000,1563995791.5875764,555112297,31.03321828321618,8.000000000000004,0.6166623229465031,63.19743948850593,74.2542908153469,50.68924976923077,50.68118931613925,-25.7457091846531
2017-11-24,51.793499,52.158901,51.75,52.030499,52.030499,10740000,1567990699.3525364,565852297,31.71875913585333,8.0,0.6294284360775322,65.04020938239537,90.08560522183672,50.78117284615384,50.781138181610416,-9.914394778163285
2017-11-27,52.0,52.772999,51.922001,52.710499,52.710499,26158000,1590306445.9042323,592010297,32.91769357808247,88.0,0.6865024171792982,69.802695834119,96.97409681631412,50.91532665384615,50.92405379778742,-3.0259031836858856
2017-11-28,52.754501,53.118752,52.0,52.370499,52.370499,28488000,1580687284.5959175,563522297,34.304739829520834,92.0,0.6962726027470154,65.03235817801439,68.96827871993474,51.029192,51.031197886840204,-31.031721280065256
2017-11-29,52.133999,52.203999,50.782501,51.083,51.083,49188000,1552295578.1003752,514334297,33.197708293338415,92.0,0.5932861030892838,50.85837096076587,15.572822749343315,51.13151888461538,51.035035080407596,-84.42717725065668
2017-11-30,51.1185,51.4245,50.75,51.070499,51.070499,34480000,1550582977.714904,479854297,32.11639049019401,92.0,0.5048403486213786,50.74272808449372,15.054378389317888,51.22934576923077,51.03766203741444,-84.94562161068211
2017-12-01,50.790001,51.1245,50.101002,50.508499,50.508499,38192000,1542802615.8890872,441662297,30.107860550288734,88.0,0.3849601666465645,45.71062172596281,13.503338580067911,51.30019188461539,50.998464775383745,-86.49666141993208
2017-12-04,50.632999,50.805,49.7785,49.933998,49.933998,38128000,1516226155.5754,403534297,28.1169300120838,-16.0,0.24082079710338178,41.21144550336077,4.655277506008574,51.35042265384615,50.91961538461457,-95.34472249399143
2017-12-05,49.797001,51.030499,49.414001,50.2575,50.2575,41346000,1518029370.3025448,444880297,26.742914051705508,-20.0,0.15095312242306846,44.52276831892423,22.768034882776224,51.32326876923077,50.87056980056905,-77.23196511722378
2017-12-06,50.075001,51.248501,50.056999,50.918999,50.918999,25440000,1529398842.7163553,470320297,25.140808290609378,-20.0,0.13159286308751206,50.64458666320377,40.62345890452556,51.32571107692308,50.874157148675046,-59.37654109547444
2017-12-07,51.0215,51.712002,50.903549,51.546501,51.546501,29164000,1546622331.235787,499484297,23.68986026496857,-20.0,0.1649820745700552,55.644720020935516,57.561223412855526,51.35319184615385,50.92396039692134,-42.438776587144474
2017-12-08,51.8745,52.102501,51.626099,51.852501,51.852501,25816000,1545343566.73018,525300297,22.843235389560114,-20.0,0.21367183200430162,57.88535412947415,65.82088782754892,51.375403346153846,50.99274118233457,-34.17911217245109
2017-12-11,51.775002,52.189999,51.602501,52.055,52.055,23856000,1558236002.1086833,549156297,22.16704770573785,-20.0,0.2655378376065798,59.34882753161775,71.28681522725817,51.40524953846154,51.071427020680154,-28.713184772741823
2017-12-12,51.981499,52.515499,51.684502,52.023998,52.023998,25590000,1553555109.2173731,523566297,21.943708149174068,-20.0,0.30067443074105427,59.010736053054956,70.44999785410675,51.42063403846154,51.14198783396311,-29.55000214589324
2017-12-13,52.306,52.333248,51.918999,52.030499,52.030499,25654000,1541711262.0481584,549220297,21.73632141807912,-19.999999999999993,0.32529520962714287,59.06339946511514,70.62547523436795,51.44892253846154,51.207803475891765,-29.374524765632053
2017-12-14,52.25,52.924999,52.155499,52.4575,52.4575,31174000,1535006603.6310048,580394297,22.244356631700935,-20.0,0.37494068357348453,62.47381068608107,82.15124309299067,51.47934561538462,51.30037358878867,-17.848756907009328
2017-12-15,52.730499,53.381001,52.474998,53.209499,53.209499,65518000,1575720120.564172,645912297,23.18039918806283,32.0,0.4695524060833165,67.59407571313824,95.67678346357458,51.52615326923077,51.44179028591544,-4.323216536425429
2017-12-18,53.304001,53.9245,53.099998,53.856998,53.856998,31092000,1601721114.880741,677004297,24.53425547274188,36.0,0.5899797168122802,71.23364010613649,98.50344717956916,51.614383961538465,51.62069456103281,-1.4965528204308343
2017-12-19,53.759998,53.841999,53.177502,53.534,53.534,26774000,1603675242.9294755,650230297,25.79140773708671,36.0,0.6518419606391035,67.18030614297365,91.34242131524688,51.69632626923077,51.7624208898452,-8.65757868475312
2017-12-20,53.589001,53.668999,53.076,53.247501,53.247501,25372000,1592978894.5646384,624858297,26.733102469905013,35.99999999999999,0.6700265110944414,63.71700267008832,84.99059638412508,51.771710999999996,51.872426823930745,-15.009403615874911
2017-12-21,53.247501,53.466499,53.089699,53.181499,53.181499,19914000,1582768213.035976,604944297,27.60753329323629,36.0,0.6713729194444085,62.9123597145532,83.52729930768194,51.844076384615384,51.96939513326921,-16.472700692318057
2017-12-22,53.0555,53.209999,52.972,53.006001,53.006001,15102000,1571981215.216657,589842297,28.1313868635204,36.0,0.6507769838844766,60.71674508158368,79.63642160213308,51.91948019230769,52.046180753027045,-20.363578397866924
2017-12-26,52.9035,53.006001,52.509998,52.837002,52.837002,15212000,1576827097.3181765,574630297,27.564469913775678,36.0,0.6137429035012332,58.596017483568716,71.8811190999045,51.96609565384615,52.10476010465467,-28.118880900095498
2017-12-27,52.869499,52.918499,52.4025,52.468498,52.468498,25438000,1557896308.0840883,549192297,26.80921259258532,36.0,0.5483370467508166,54.15428888356147,51.803190452277995,52.024326423076914,52.13170365245803,-48.196809547722005
2017-12-28,52.580002,52.737499,52.238499,52.407001,52.407001,16742000,1552461163.731383,532450297,25.757307499032517,36.0,0.4859385430660126,53.4264477011964,34.646871079617284,52.081557269230764,52.15209604857225,-65.35312892038272
2017-12-29,52.335999,52.485001,52.244999,52.32,52.32,17750000,1545804969.199671,514700297,24.78053848359063,36.0,0.42457281461704355,52.3544052195547,30.90005637384004,52.10446115384615,52.16453337830764,-69.09994362615996
2018-01-02,52.417,53.347,52.261501,53.25,53.25,24752000,1566133300.4537761,539452297,25.152495601779066,36.0,0.44584384999614457,61.294995718457834,69.88836597175525,52.16030730769231,52.244938313247815,-30.11163402824475
2018-01-03,53.2155,54.314499,53.1605,54.124001,54.124001,28604000,1585293609.788533,568056297,26.48576479681469,76.0,0.5271492270026101,67.47243718922088,92.04767271968281,52.24082661538462,52.38412814189613,-7.952327280317186
2018-01-04,54.400002,54.678501,54.2001,54.32,54.32,20092000,1575272787.7333953,588148297,28.02118986869547,80.0,0.6004778702184765,68.67967917461937,85.79069695545239,52.3027305,52.52752605731123,-14.20930304454761
2018-01-05,54.700001,55.212502,54.599998,55.1115,55.1115,25582000,1592417836.5820558,613730297,29.836367945312503,84.0,0.7142256349007781,73.03245210853515,96.6038366471049,52.40815361538461,52.71893153454743,-3.396163352895106
2018-01-08,55.1115,55.563499,55.081001,55.347,55.347,20952000,1594567325.2845998,634682297,31.751614314201838,88.0,0.8139912552655275,74.18215208933577,93.4887518796993,52.572153615384615,52.913603272729105,-6.511248120300713
2018-01-09,55.470001,55.5285,55.06155,55.313,55.313,18050000,1595956976.2108233,616632297,33.48412689501615,88.0,0.8801666985112462,73.6936730223287,92.46619548872187,52.73532673076923,53.091336363638064,-7.533804511278123
2018-01-10,54.855,55.23,54.8055,55.130501,55.130501,20856000,1607036056.8044634,595776297,34.480090451015414,88.0,0.90742484124209,70.99146413722498,86.97750375939857,52.91309603846154,53.242385595961174,-13.022496240601425
2018-01-11,55.314999,55.326248,54.9795,55.276001,55.276001,19566000,1620931467.200486,615342297,35.48668887917759,88.0,0.9300467497492519,71.87686439314534,91.35344360902258,53.11855769230769,53.39302377403813,-8.646556390977418
2018-01-12,55.120499,56.2145,55.057499,56.112999,56.112999,34410000,1649304049.0651517,649752297,37.074970334715275,100.0,1.0039407151067223,76.34895226792432,97.44715858974888,53.34376919230769,53.59450342040567,-2.552841410251126
2018-01-16,56.6255,56.995499,55.891602,56.088001,56.088001,31506000,1629008781.3961573,618246297,38.98520772375865,100.0,1.048399785228888,75.96044458422834,80.92289257935667,53.542576961538465,53.77920694482006,-19.077107420643326
2018-01-17,56.311001,56.630001,55.850498,56.598999,56.598999,24052000,1651147613.3801265,642298297,40.66415094979822,92.0,1.112048187344783,78.38208148791497,91.66491486230812,53.7369038076923,53.98808043038895,-8.33508513769188
2018-01-18,56.570499,56.6255,55.875,56.489498,56.489498,23964000,1666426331.759873,618334297,42.2231696596921,92.0,1.140507132736495,76.60133337688052,89.36302291360093,53.915249846153856,54.17337062073051,-10.636977086399082
2018-01-19,56.591499,56.893002,56.415001,56.8755,56.8755,35564000,1699385981.024205,653898297,43.825296371627914,88.0,1.1805989773284509,78.45915726605591,97.47397116093043,54.10065369230769,54.37352835252825,-2.5260288390695695
2018-01-22,56.8745,57.993999,56.755501,57.790501,57.790501,32360000,1721111817.254865,686258297,45.82686042275932,100.0,1.2715473800448933,82.08943197417928,96.45009906675932,54.32244226923077,54.626637437526156,-3.54990093324068
2018-01-23,57.9925,58.581348,57.9375,58.498501,58.498501,26662000,1740912363.2657247,712920297,47.895976223046475,100.0,1.384791315164101,84.29495838976753,98.47169667919113,54.57121157692307,54.91344214585755,-1.5283033208088663
2018-01-24,58.866501,58.993,58.052502,58.212002,58.212002,28332000,1722190067.9115613,684588297,49.94914162456347,68.0,1.4348794772641824,80.00179730401442,83.70510546850542,54.79253857692307,55.15777991283106,-16.294894531494574
2018-01-25,58.626499,58.797001,58.138,58.518501,58.518501,29610000,1726773140.7900546,714198297,51.85565235454352,68.0,1.482220499111662,81.11019036837982,89.19875292567585,54.996730961538454,55.40672221558431,-10.801247074324147
2018-01-26,58.754002,58.792,57.905499,58.792,58.792,40376000,1767149140.7900546,754574297,53.048461233837784,68.0,1.524237225640455,82.06541503511046,95.19999999999999,55.18653873076923,55.65748353294844,-4.800000000000012
2018-01-29,58.824001,59.344501,58.598999,58.778999,58.778999,27578000,1752888449.1272554,726996297,54.391583586256914,80.0,1.5387489717739555,81.85351989007299,87.54126734054472,55.388269461538464,55.888706900878184,-12.458732659455292
2018-01-30,58.391499,58.826,58.175999,58.184502,58.184502,31126000,1722576799.8067164,695870297,54.66197980645838,80.0,1.4851587105193005,72.61986071754937,74.44373772995425,55.57815411538461,56.05876579710943,-25.556262270045753
2018-01-31,58.5285,58.650002,57.956501,58.497002,58.497002,30774000,1739772096.9641829,726644297,54.43203546247808,80.0,1.4511759279349477,74.26337368394607,80.58421979742963,55.78259653846154,56.239375886212436,-19.41578020257038
2018-02-01,58.130501,58.700001,57.875999,58.384998,58.384998,48242000,1751129781.8144627,678402297,54.039623095668055,80.0,1.3990788312898346,72.58173374155511,77.61832161496548,55.98948103846154,56.39831085760411,-22.381678385034522
2018-02-02,56.099998,56.1535,55.363899,55.595001,55.595001,97158000,1710844577.355502,581244297,50.48440176459758,80.0,1.1197542361258286,45.153232675340014,5.805704765259126,56.095557923076925,56.33880642370751,-94.19429523474088
2018-02-05,54.529999,55.5,52.601501,52.790001,52.790001,75966000,1644759271.4664881,505278297,49.215940527853036,80.0,0.6643887642893418,32.04275750152827,2.795491620940199,56.107923423076926,56.07593194787733,-97.2045083790598
2018-02-06,51.359001,54.085499,51.156849,54.029999,54.029999,68960000,1711105589.3945436,574238297,48.72723398892358,-24.0,0.39896678191843193,40.29568627920336,35.091256931779654,56.17034642307692,55.92438135914568,-64.90874306822035
2018-02-07,54.077,54.089001,52.412998,52.429001,52.429001,47384000,1664626463.8512123,526854297,48.269629029935345,-24.0,0.058753516164372854,34.474347295909624,15.537445900240977,56.17453876923077,55.66546429550526,-84.46255409975903
2018-02-08,52.7705,52.931,50.033001,50.076,50.076,57182000,1609141337.327014,469672297,48.73057133413413,-32.0,-0.39616867798668665,28.05861097963087,0.46178381571177335,56.05246184615385,55.25142990324561,-99.53821618428823
2018-02-09,50.862499,52.198502,49.627998,51.889,51.889,70118000,1662374196.3305404,539790297,49.281194039176,-36.0,-0.6034476770738522,37.68192887011484,23.26970927709284,55.96650026923077,55.00236102152371,-76.73029072290716
2018-02-12,52.400002,53.075001,52.046398,52.597,52.597,41154000,1665278933.6820745,580944297,48.88533223103889,-36.0,-0.7024902241982787,41.00095833411219,30.556281411120878,55.90023103846154,54.82418613104047,-69.44371858887912
2018-02-13,52.25,52.918499,52.20435,52.605,52.605,25302000,1668366657.1151395,606246297,48.51774626634015,-35.99999999999999,-0.7714438981653089,41.03917053941571,30.638615559527928,55.80382719230769,54.65980197318562,-69.36138444047208
2018-02-14,52.447498,53.585999,52.337502,53.485001,53.485001,31116000,1694448357.8448968,637362297,47.48949759916877,-36.0,-0.7464765384737788,45.24056955620886,39.6953821760771,55.73221184615385,54.57277967887558,-60.30461782392289
2018-02-15,53.953499,54.573952,53.216999,54.476002,54.476002,36868000,1725993814.4701447,674230297,45.61149937746858,-36.0,-0.6393541508126219,49.59636811116973,49.8945351017748,55.70001961538461,54.565610961921834,-50.1054648982252
2018-02-16,54.420502,55.233501,54.415649,54.740002,54.740002,33590000,1719046818.9990814,707820297,43.306737752825725,-36.0,-0.52708043796342,50.72093638871391,55.57733081597501,55.68500042307692,54.57852881659429,-44.42266918402499
2018-02-20,54.5285,55.697498,54.425999,55.123001,55.123001,28462000,1721789044.7578118,736282297,40.78777666594082,-36.0,-0.4025574613668823,52.38084463269571,60.571000693011264,55.679115807692305,54.61886008943916,-39.428999306988736
2018-02-21,55.323502,56.698502,55.316502,55.567001,55.567001,30258000,1702500073.3279998,766540297,38.05667012812268,-36.0,-0.2649903718810904,54.3025364613053,65.46517896874592,55.658115884615384,54.68909274948071,-34.53482103125409
2018-02-22,55.809502,56.140999,55.129501,55.331501,55.331501,26344000,1686678067.4397037,740196297,35.37893964144294,-36.0,-0.1729763801542532,53.0789986323994,80.66614487453802,55.62901973076923,54.736678545815465,-19.333855125461987
2018-02-23,55.632,56.363998,55.235699,56.3395,56.3395,25220000,1710802897.5246367,765416297,33.064640354155344,-36.0,-0.01850422845767241,57.493728828546146,94.92254017535387,55.619039,54.85540606094024,-5.077459824646118
2018-02-26,56.389999,57.198002,56.334751,57.1875,57.1875,31182000,1741226199.6163805,796598297,31.53207205073246,-36.0,0.17037855966309223,60.83247539407472,99.86126823711055,55.645885230769224,55.028153760129854,-0.1387317628894575
2018-02-27,57.062,57.202,55.900002,55.914501,55.914501,35482000,1706534452.0100093,761116297,29.72982929119297,-36.00000000000001,0.21487223628576402,53.97814135267157,83.00107393686989,55.608923730769234,55.093809111231344,-16.998926063130124
2018-02-28,56.151501,56.376499,55.161999,55.2365,55.2365,37652000,1673501820.7247066,723464297,27.763571846352935,-36.0,0.19319771812648412,50.701438826732144,74.04938630858561,55.51069292307693,55.104378806695685,-25.950613691414375
2018-03-01,55.393501,55.506001,53.350052,53.476002,53.476002,50318000,1629062950.61136,673146297,27.157261424540998,-36.0,0.03357598773813919,43.343836307554525,50.805426246256644,55.317519884615386,54.98375830249601,-49.19457375374336
2018-03-02,52.653999,54.099949,52.40575,53.945999,53.945999,45432000,1666238238.855539,718578297,27.108795095416163,-36.0,-0.05437376669988225,45.612947581162764,36.845377125697425,55.15344284615385,54.906887243051855,-63.154622874302575
2018-03-05,53.757,54.855,53.450001,54.546501,54.546501,24044000,1679723441.367427,742622297,26.419138401268356,-36.0,-0.07475733195246903,48.453556157846606,46.86504657188881,55.00067361538462,54.880191965788754,-53.13495342811118
2018-03-06,54.960999,55.092499,54.48875,54.752998,54.752998,30656000,1675902389.9569898,773278297,25.58073990181712,-36.0,-0.07340273114521523,49.431645806587824,49.655606806704384,54.84532738461538,54.870770190545144,-50.344393193295616
2018-03-07,54.459499,55.611,54.274101,55.481998,55.481998,25850000,1696763678.4686873,799128297,24.37158355398135,-32.0,-0.01335108970198462,52.83420418674477,64.13860828772476,54.71851965384615,54.91604632457884,-35.86139171227523
2018-03-08,55.765999,56.380001,55.639999,56.299999,56.299999,27102000,1718005655.9173968,826230297,22.647608378919916,-24.000000000000004,0.09910370732279716,56.380828358306815,81.19362001563725,54.64603876923077,55.018561337573004,-18.80637998436275
2018-03-09,56.799999,58.040001,56.623051,58.001999,58.001999,42560000,1758282773.500939,868790297,22.105636337689493,-24.0,0.32185201032145017,62.67053231477804,99.32551815671685,54.62700019230769,55.239556719975,-0.6744818432831403
2018-03-12,58.192501,58.852501,57.870998,58.224998,58.224998,43446000,1746176227.3793275,912236297,22.054063466306523,80.0,0.5104911763708557,63.414895916947344,90.26636828380688,54.62084634615384,55.46070051849537,-9.733631716193123
2018-03-13,58.5,58.838001,56.6665,56.908501,56.908501,38144000,1716534075.7726738,874092297,21.085134266222138,80.0,0.5474481278184484,56.27997929252757,69.8452755504285,54.67136557692307,55.567944998606826,-30.15472444957151
2018-03-14,57.260502,57.929501,57.071999,57.474499,57.474499,25828000,1714952713.0983012,899920297,20.18541429471521,80.0,0.6153151168122122,58.4447088834305,78.62486080197614,54.851538576923076,55.70917122093225,-21.375139198023863
2018-03-15,57.498001,58.054001,56.727001,57.479,57.479,27908000,1718675139.7629583,927828297,19.08582677111517,80.0,0.6618341752339703,58.462322328385405,78.69467891655816,54.98419246153847,55.84026964901134,-21.30532108344184
2018-03-16,57.707001,57.793999,56.598,56.786499,56.786499,61840000,1676328096.1283064,865988297,17.963436108368718,80.0,0.6354962161600355,54.62601350706412,67.95281840418534,55.15178853846154,55.910360712047535,-32.04718159581466
2018-03-19,56.0005,56.099499,54.4505,54.991001,54.991001,56118000,1656998275.03927,809870297,17.881662462181716,80.0,0.4643883312313406,46.167022428421504,40.10161087344618,55.34082703846154,55.842259992636606,-59.89838912655383
2018-03-20,54.950001,55.259998,54.173,54.885502,54.885502,36638000,1668390995.0148356,773232297,17.962953574020236,76.0,0.31662139766918784,45.71903664653106,38.465143139544324,55.456077115384616,55.771389030219076,-61.53485686045567
2018-03-21,54.637001,55.314999,54.2575,54.543999,54.543999,37578000,1651174355.9655316,735654297,17.990689953985868,72.0,0.1699989580102894,44.2231026310071,33.16785462940948,55.53096169230769,55.68047125020285,-66.83214537059052
2018-03-22,54.094002,54.145,52.295502,52.453999,52.453999,53340000,1606976544.797312,682314297,19.051470766037742,-32.0,-0.11353712956303497,36.378118841353164,2.4172186086959013,55.52515396153846,55.44147330574338,-97.58278139130411
2018-03-23,52.351501,53.167999,51.061001,51.078499,51.078499,43134000,1564558975.2182238,639180297,20.551427964260437,-36.0,-0.44411341322232545,32.31511245226437,0.2245780658410235,55.43259619230769,55.11829002383646,-99.77542193415897
2018-03-26,52.299999,52.781502,50.419998,52.6605,52.6605,53302000,1612398652.39006,692482297,22.186728365341686,-40.0,-0.5718512945710827,40.54054980967058,26.569833417195348,55.362769192307695,54.93623150355227,-73.43016658280466
2018-03-27,53.150002,53.241951,49.846001,50.255001,50.255001,61906000,1565404270.0522752,630576297,23.914395508344796,-43.99999999999999,-0.8573056654902373,33.81200275873279,4.541164714372943,55.19026915384616,54.58947368847432,-95.45883528562706
2018-03-28,49.900002,51.211498,49.032001,50.228001,50.228001,67386000,1571974468.2025824,563190297,25.799370444729146,-48.0,-1.0733362334127747,33.74430482525523,12.178605977292383,55.00199992307692,54.26640163747623,-87.82139402270762
2018-03-29,50.581501,52.150002,50.145,51.5895,51.5895,54536000,1596019189.8178227,617726297,26.65427386608721,-48.0,-1.1217495930852692,40.24172313591645,26.042452013644937,54.84901911538462,54.068112627292805,-73.95754798635507
2018-04-02,51.140999,51.740002,49.518501,50.323502,50.323502,53608000,1581262843.3691828,564118297,27.699564400446548,-48.0,-1.2478881102863895,36.6432974574736,13.170518050173333,54.656403769230764,53.790734062308154,-86.82948194982667
2018-04-03,50.695499,51.0495,49.703499,50.670502,50.670502,45502000,1601140542.9474149,609620297,28.670191325208787,-48.0,-1.3048127250703203,38.272575716863116,18.161172688982468,54.43836538461539,53.55960576139643,-81.83882731101754
2018-04-04,49.670502,51.435902,49.650002,51.257,51.257,49694000,1640878379.6818345,659314297,29.179015540272275,-48.0,-1.287755956310498,41.03274277436431,24.6619264021281,54.210269230769235,53.389042371663365,-75.3380735978719
2018-04-05,52.066502,52.1395,51.00655,51.390499,51.390499,27260000,1632094834.4944918,686574297,28.964213503882494,-48.0,-1.2490676166119457,41.67207981178491,26.91735378163745,54.036269153846156,53.241002121910526,-73.08264621836256
2018-04-06,51.0,51.570999,50.151501,50.352001,50.352001,34928000,1607033793.0953493,651646297,29.212276521140637,-48.0,-1.2873649958610898,38.20216181276129,18.677048086890156,53.84840380769231,53.02700203880604,-81.32295191310985
2018-04-09,50.84,51.98,50.703999,50.772499,50.772499,35032000,1575763062.8749185,686678297,29.046399710757402,-48.0,-1.2691552389097254,40.36737621520339,27.701711826105985,53.744422923076925,52.860001813709296,-72.29828817389401
2018-04-10,51.321999,51.813999,50.567001,51.582001,51.582001,39490000,1600559212.4918382,726168297,28.970097295010476,-48.0,-1.1758493696297592,44.4056603725248,40.585720383803995,53.65349992307692,52.76533508676786,-59.414279616196005
2018-04-11,51.399502,51.568199,50.793499,50.998501,50.998501,29678000,1586588065.0954266,696490297,28.8992450518169,-48.0,-1.1358934963234688,42.18792977235776,38.46079375333333,53.51703838461538,52.63445848774802,-61.53920624666667
2018-04-12,51.251999,52.0345,51.071751,51.6255,51.6255,27140000,1590668555.295884,723630297,28.326168678503564,-48.0,-1.0416273677065888,45.34655891647285,61.60403330205827,53.39675,52.559720821988904,-38.39596669794174
2018-04-13,52.043999,52.320999,51.148998,51.463501,51.463501,24460000,1579336092.5249476,699170297,27.488226368831697,-48.00000000000001,-0.9688247385314739,44.66750850869328,57.756030356655074,53.24219242307693,52.478519353693436,-42.243969643344926
2018-04-16,51.849998,52.161999,51.337002,51.898998,51.898998,24224000,1588115342.4858565,723394297,26.710137081279246,-48.0,-0.8660044024138642,46.96664268074853,68.10050000593827,53.072923153846155,52.43559184601244,-31.899499994061728
2018-04-17,52.568501,53.894001,52.412998,53.708,53.708,46406000,1622864968.5203748,769800297,25.273614192888342,-48.0,-0.6312703111261158,55.27916068539003,96.17439325380492,52.90776934615384,52.52984430186337,-3.825606746195073
2018-04-18,53.871498,53.871498,53.311249,53.604,53.604,26882000,1624076663.937948,742918297,23.939700082239646,-44.0,-0.44846416768270814,54.747873054725645,93.37216318135061,52.73003865384616,52.609411390614234,-6.627836818649379
2018-04-19,53.470001,54.708248,53.409,54.384998,54.384998,34954000,1641637709.7059617,777872297,23.370087220863063,-36.0,-0.23782744370075193,58.01149567874776,93.77137266999732,52.632980846153856,52.74093632464281,-6.2286273300026895
2018-04-20,54.099998,54.6175,53.4785,53.647999,53.647999,37794000,1615092252.6488943,740078297,22.84116099244195,-36.0,-0.12888033011145694,54.05000756143608,79.0391965910713,52.48580776923076,52.808126152447045,-20.960803408928697
2018-04-23,53.893002,54.136002,53.035,53.372501,53.372501,46826000,1596974323.7078028,693252297,21.869060705550208,-32.0,-0.06403123165704017,52.6039068815823,73.59268410433185,52.327865499999994,52.84993169671023,-26.407315895668155
2018-04-24,52.599998,52.849998,50.529499,50.999001,50.999001,95206000,1540294009.2711234,598046297,21.684292272339608,-28.000000000000004,-0.20183286413113422,42.14272304112652,18.59879427143964,52.10526942307693,52.71282571917614,-81.40120572856037
2018-04-25,51.276001,51.6245,50.765499,51.058998,51.058998,47822000,1525151154.4129806,645868297,21.512721584358335,-20.0,-0.3027109310081997,42.45425387800935,19.915457232977833,51.95403853846154,52.59031996220013,-80.08454276702217
2018-04-26,51.475498,52.398998,50.9095,52.001999,52.001999,41590000,1544571016.0039325,687458297,20.62428303910454,-20.0,-0.3030716052736153,47.26090931478742,35.2378187826069,51.84313457692307,52.54674063166678,-64.7621812173931
2018-04-27,52.299999,52.474998,51.279499,51.502499,51.502499,32396000,1524260861.3287716,655062297,19.72947850904587,60.0,-0.3397465312049306,45.111471987258305,23.28448059455114,51.726153807692306,52.46938939969146,-76.71551940544886
2018-04-30,51.5005,51.849998,50.842499,50.866501,50.866501,33426000,1492427499.8366015,621636297,19.2437464583235,60.0,-0.4153435753824013,42.463327499828786,8.064662414516846,51.6650961923077,52.35065692564024,-91.93533758548315
2018-05-01,50.682999,51.9235,50.4105,51.865501,51.865501,28558000,1518796028.003158,650194297,19.12238947134412,60.0,-0.3901464609871823,47.660625606992326,33.85496311091305,51.695365499999994,52.31471944966689,-66.14503688908695
2018-05-02,51.404999,52.019451,51.143501,51.219002,51.219002,32062000,1492261085.6251688,618132297,18.904576617662798,60.0,-0.4175315883300996,44.83792115922891,18.812224448711383,51.63992326923077,52.23355519413601,-81.18777555128861
2018-05-03,50.950001,51.483749,50.314499,51.186001,51.186001,36302000,1510074570.9431074,581830297,19.327831505688987,60.0,-0.43686153609642986,44.69241431857732,19.83504292120464,51.675730961538456,52.15595858716297,-80.16495707879535
2018-05-04,50.845001,52.425499,50.845001,52.4105,52.4105,38774000,1548112636.793238,620604297,18.71150392026444,52.00000000000001,-0.34934677111453283,51.041123107977945,47.704158794687665,51.75967323076923,52.174813506632375,-52.295841205312335
2018-05-07,52.461498,53.084,52.355,52.739498,52.739498,29322000,1549721364.7932377,649926297,17.51812238340129,52.0,-0.2505550575690094,52.61496611217291,55.192023941285676,51.80390392307692,52.21664198762257,-44.807976058714324
2018-05-08,52.926998,53.0275,52.35725,52.695499,52.695499,24354000,1549948390.2195709,625572297,16.40998238488551,44.0,-0.17380870584452168,52.37249085841009,54.19062399786607,51.89513457692307,52.25211287742831,-45.80937600213393
2018-05-09,52.904999,54.271999,52.818249,54.138,54.138,40656000,1583109479.3421845,666228297,16.16482209115235,44.0,0.0033722330375667298,59.0375241899746,88.85661425595761,52.028499884615385,52.391808219841025,-11.143385744042387
2018-05-10,54.301498,55.021999,54.282001,54.878502,54.878502,28860000,1600776683.0913837,695088297,16.47812720387112,96.0,0.20122216255444414,61.97898432656167,96.95173659054693,52.16778842307693,52.57600775911206,-3.0482634094530736
2018-05-11,54.68,55.066502,54.545502,54.912998,54.912998,25074000,1611075407.4829385,720162297,16.80043837377364,100.0,0.3566914786995241,62.11546335924986,96.76969900902844,52.30326915384615,52.74911814732598,-3.230300990971555
2018-05-14,55.0,55.537498,54.955502,55.009998,55.009998,30362000,1586399383.1666203,750524297,17.434368196032654,28.0,0.48217095455449765,62.522840417750984,89.90043842627587,52.48242288461539,52.91659072900554,-10.099561573724142
2018-05-15,54.5,54.502499,53.6735,53.961498,53.961498,29898000,1577274783.867948,720626297,16.693766051130574,28.0,0.4913452338761459,55.56723753347581,69.82576485272158,52.60507669230769,52.99399126759773,-30.174235147278413
2018-05-16,53.865501,54.463501,53.813,54.088501,54.088501,21946000,1573917978.7992394,742572297,16.006064059435783,28.0,0.5030649771181785,56.20282078983167,72.25737550399687,52.70148053846154,53.07506606259049,-27.742624496003124
2018-05-17,53.994499,54.343498,53.674999,53.929501,53.929501,20876000,1568937241.9245398,721696297,15.228675257052885,28.0,0.4938304172409218,55.13941477342358,69.21314746566107,52.814211307692304,53.13835753943564,-30.78685253433893
2018-05-18,53.092999,53.497002,53.034,53.318001,53.318001,31304000,1576036390.5243301,690392297,14.400008372118577,27.999999999999993,0.4321870393628373,51.13239782317358,57.50531447545756,52.87930750000001,53.15166446244041,-42.49468552454244
2018-05-21,53.702999,54.400002,53.682499,53.979,53.979,20464000,1572485480.6828382,710856297,13.94224110595492,28.0,0.4316950021151911,54.943944315150745,70.16085968999803,52.97605746153845,53.21294857633371,-29.83914031000197
2018-05-22,54.178001,54.329498,53.334499,53.4865,53.4865,21800000,1557346033.7085195,689056297,13.174195493294617,28.0,0.3871021523956273,51.70781060822609,60.73141120647353,53.03711523076923,53.23321164475344,-39.26858879352646
2018-05-23,53.2565,54.039001,53.085499,53.984501,53.984501,21214000,1576134945.9792857,710270297,12.24951890902763,28.0,0.3874798894826341,54.61848910765058,66.90467782930924,53.047749884615385,53.288862708105036,-33.095322170690764
2018-05-24,53.950001,54.023499,53.307499,53.962002,53.962002,15336000,1588836538.180403,694934297,11.390890652208284,28.0,0.38156532008375876,54.45878980745238,50.49498852787968,53.06151919230769,53.33872487787504,-49.50501147212032
2018-05-25,53.951,54.127998,53.688751,53.783001,53.783001,17988000,1578567971.665435,676946297,10.674517965338726,28.0,0.35830379340278284,53.12783779578261,44.83144081845185,53.03836546153846,53.37163422025466,-55.16855918154815
2018-05-29,53.244499,53.668499,52.761002,53.015999,53.015999,37302000,1562228901.777601,639644297,10.76850489329102,28.0,0.2748103717193615,47.743476732230484,9.184129924912655,53.014057769230774,53.34529087060617,-90.81587007508735
2018-05-30,53.151501,53.460499,52.841499,53.389999,53.389999,22770000,1579812197.4157274,662414297,10.85577846924672,28.000000000000004,0.23609831345777366,50.38402062662456,22.654345621243646,53.01473076923077,53.3486025838946,-77.34565437875635
2018-05-31,53.377998,54.859501,53.377998,54.2495,54.2495,61766000,1590714551.8260794,724180297,10.721686329917441,28.0,0.27164195654675183,55.899190663185344,53.61066610576781,53.139749961538456,53.415335725828335,-46.38933389423219
2018-06-01,54.967499,56.0,54.924999,55.974998,55.974998,48432000,1636893722.5468507,772612297,11.515029631121381,80.0,0.4340404694335973,64.44400977897303,99.22809461444557,53.32882688461538,53.60494033872994,-0.7719053855544405
2018-06-04,56.116501,57.094501,56.10025,56.9645,56.9645,37792000,1664802910.6774132,810404297,12.962653221104532,84.0,0.6352640738955628,68.24389471941149,97.00009161188221,53.51969230769232,53.853796609935124,-2.9999083881177757
2018-06-05,57.0495,57.2869,56.6595,56.983002,56.983002,33560000,1665851540.3235717,843964297,14.421562851884618,88.0,0.7871543614495664,68.31208743464558,93.28535464122251,53.73048088461538,54.08558960179178,-6.714645358777494
2018-06-06,57.108501,57.150002,56.287151,56.844002,56.844002,33964000,1675725670.8096,810000297,15.330746585066207,88.0,0.886097984331478,67.14552330068656,90.21414092849642,53.96038476923077,54.289916446103504,-9.78585907150358
2018-06-07,56.566002,56.791,55.826,56.193001,56.193001,30400000,1668448635.369186,779600297,15.641812894027902,88.0,0.9015882303576959,61.820797984774664,75.8302330277881,54.12682707692307,54.43088567231806,-24.169766972211907
2018-06-08,55.909,56.3335,55.607498,56.043499,56.043499,25816000,1673640268.4500864,753784297,15.682018378254385,88.0,0.8915238677815722,60.6316670277444,72.52697696678086,54.31238465384615,54.55033851140561,-27.47302303321914
2018-06-11,55.93,56.862999,55.93,56.4995,56.4995,21586000,1678406337.4233649,775370297,16.14160558095222,84.0,0.9098550154181453,62.971245714935634,82.60234764459993,54.51675,54.69472084389409,-17.397652355400062
2018-06-12,56.553501,56.989498,56.536751,56.966,56.966,18240000,1694752990.7197978,793610297,16.667538515943377,80.0,0.9510619827639815,65.24664641080282,92.90969438551197,54.69196153846154,54.862963744346374,-7.090305614488028
2018-06-13,57.056,57.325001,56.668999,56.739498,56.739498,30128000,1671100562.0503728,763482297,17.42063800949074,100.0,0.954439794983486,63.215471865961035,87.1712723863436,54.845807692307694,55.0019662818022,-12.82872761365641
2018-06-14,57.192501,57.773499,57.032001,57.605999,57.605999,26868000,1685829918.3857908,790350297,18.458949382378115,48.0,1.0153320091727451,67.3969428416165,96.65835211472438,55.034673076923085,55.19485759426129,-3.3416478852756195
2018-06-15,57.443001,57.671001,57.174252,57.612999,57.612999,42450000,1718366723.1906326,832800297,19.423095657202108,48.0,1.052027253803388,67.42915401839457,96.79800307112406,55.16832688461538,55.37397917987157,-3.201996928875945
2018-06-18,57.182499,58.7155,57.179501,58.673,58.673,28274000,1745076080.2449017,861074297,21.046140574482905,56.0,1.1533466590974513,71.94869433445807,99.27647271425393,55.31426911538461,55.618351092473674,-0.7235272857460677
2018-06-19,57.924999,58.563499,57.7005,58.403,58.403,32420000,1765437253.8036194,828654297,22.553253711957932,56.0,1.198045946332421,69.31050206602737,94.14520125706744,55.44849996153846,55.82462138192007,-5.854798742932554
2018-06-20,58.765499,59.314301,58.458,58.492001,58.492001,32970000,1735085522.3096707,861624297,24.411325663671796,64.0,1.2265136050341,69.70484360813211,81.2658140178097,55.58242315384614,56.022205057333395,-18.734185982190297
2018-06-21,58.7425,58.86475,57.611599,57.882999,57.882999,24762000,1721049136.0625224,836862297,24.87667952626072,64.0,1.1862586070934285,63.67558126847017,61.38715761263811,55.73325011538462,56.160041645679065,-38.61284238736189
2018-06-22,57.957001,58.124851,57.362999,57.773998,57.773998,26220000,1723119128.8170204,810642297,24.970281480007753,64.0,1.1325059379707554,62.63136714654246,58.44659130792758,55.875,56.279593968221356,-41.55340869207242
2018-06-25,57.18,57.195499,55.639,56.240501,56.240501,43146000,1713320226.5613813,767496297,23.234260242907332,64.0,0.9551557278265435,50.16696152009399,17.076790970547993,55.963884615384615,56.276698192797554,-82.92320902945201
2018-06-26,56.400002,56.6605,55.832951,55.923,55.923,31264000,1688860154.6333144,736232297,21.622240522742654,64.0,0.7799934523252219,48.035446656649405,8.511431548965566,56.06407688461539,56.2504983266644,-91.48856845103444
2018-06-27,56.067001,56.591801,55.181,55.199001,55.199001,25878000,1663642531.0832887,710354297,20.73104732332062,64.0,0.5761143310369974,43.49699820965909,0.4355114713398625,56.111,56.17260963580037,-99.56448852866014
2018-06-28,55.1045,56.115501,54.800499,55.710999,55.710999,21448000,1671895480.587548,731802297,20.233972170147087,64.0,0.45065771656859255,47.289759847995484,20.171465208265655,56.196557653846156,56.138416255370714,-79.82853479173434
2018-06-29,56.0,56.41135,55.75,55.782501,55.782501,26302000,1648178620.9882438,758104297,19.440068156300253,64.0,0.35293366002989757,47.81656654577521,21.755540008179395,56.265711499999995,56.11205216238029,-78.2444599918206
2018-07-02,54.950001,56.400002,54.689999,56.373001,56.373001,24346000,1671755772.809615,782450297,19.5875819125647,64.0,0.31945260536248554,52.07639552581064,36.39472508499665,56.358442230769235,56.13138170590767,-63.60527491500335
2018-07-03,56.791,56.791,55.000999,55.144501,55.144501,13580000,1660353153.8948767,768870297,19.278820985002337,64.0,0.19158052429413885,44.02456650994138,9.828553584951804,56.41080761538462,56.058279431395995,-90.17144641504821
2018-07-05,55.526501,56.375,55.424,56.213501,56.213501,21334000,1674441266.0589147,790204297,18.99211440940871,60.0,0.17448894483268873,51.108496316801514,32.94555589146212,56.533788461538464,56.06977732536666,-67.05444410853788
2018-07-06,56.179001,57.046501,56.03685,57.008499,57.008499,19922000,1692863587.7661185,810126297,17.961830438828482,56.00000000000001,0.22252827209414505,55.60790497170101,50.137296396299384,56.67296153846154,56.13931226422839,-49.862703603700616
2018-07-09,57.424,57.733501,57.171001,57.702499,57.702499,18180000,1709039618.486119,828306297,17.045403614535992,-32.0,0.31299181029506684,59.142741880449044,65.14496674308907,56.8057691923077,56.255103874285545,-34.85503325691093
2018-07-10,57.848999,57.9795,57.4795,57.641998,57.641998,15968000,1703450690.742119,812338297,16.428460663961154,-32.0,0.37547465292774973,58.70388957627711,63.836639562035536,56.86988457692308,56.357836772486614,-36.163360437964464
2018-07-11,57.2295,58.2145,57.049999,57.695,57.695,22400000,1705864791.2023163,834738297,15.38341800765221,-32.0,0.4243776133615924,58.99097474910919,71.98036481696751,56.89798073076923,56.456885900450565,-28.01963518303248
2018-07-12,57.994499,59.220501,57.796749,59.174,59.174,25038000,1729267264.7370331,859776297,15.348081602831682,-32.0,0.5758385924665959,66.07772576760735,98.97360160088222,56.982249884615385,56.658153611528306,-1.0263983991177854
2018-07-13,59.25,59.770851,59.0,59.441002,59.441002,24438000,1732791106.5871441,884214297,15.75795569635684,32.0,0.7092416434181956,67.18036268617261,93.50799826485789,57.0821345,56.86429052919287,-6.492001735142116
2018-07-16,59.469501,59.549999,58.964001,59.193001,59.193001,21114000,1728179231.1677742,863100297,16.094414496527957,32.0,0.7858936218740808,65.06484071306133,88.62690745567873,57.197519115384615,57.036787601104514,-11.373092544321267
2018-07-17,58.611,60.152,58.529999,59.939999,59.939999,32208000,1751967842.760492,895308297,16.884996234014334,40.0,0.8965821221244354,68.3026336149005,96.11862026389228,57.347384500000004,57.25184029731899,-3.8813797361077147
2018-07-18,59.827999,60.224998,59.516998,59.793999,59.793999,27872000,1745905367.822639,867436297,17.675671198246157,43.99999999999999,0.9614396978519295,66.9957063763155,92.21320545857371,57.474096,57.44014834936944,-7.7867945414262945
2018-07-19,59.549999,60.0,59.166,59.348,59.348,25534000,1731515703.554054,841902297,17.922758239868536,44.0,0.965719192249793,63.02822626873133,84.15540815815865,57.56571138461538,57.581470693860595,-15.844591841841353
2018-07-20,59.348,59.842999,59.210999,59.245499,59.245499,24948000,1709291456.718611,816954297,18.152196207089315,44.0,0.9498900076071024,62.1177628633763,82.30353790488495,57.662096038461534,57.70473204987092,-17.696462095115052
2018-07-23,59.050499,60.324501,59.049999,60.275002,60.275002,52384000,1757606486.068114,869338297,18.805570668999554,56.0,1.0087888628573367,67.23689826793361,99.07017974258302,57.76475,57.895122416547146,-0.9298202574169657
2018-07-24,63.129501,63.299999,61.778,62.403999,62.403999,66364000,1745833583.2186377,935702297,21.189221714696657,60.0,1.2132730387615638,74.81600119688869,88.62366539152683,57.94901923076923,58.22911327458069,-11.37633460847317
2018-07-25,61.956501,63.292999,61.956501,63.185001,63.185001,42556000,1781511962.91842,978258297,23.402611971415393,60.0,1.4219571191564881,76.92482181017849,98.41669226392023,58.12255773076923,58.59621606905619,-1.5833077360797632
2018-07-26,62.549999,63.488548,62.451,63.4165,63.4165,48112000,1822942106.5108128,1026370297,25.544730904836292,68.0,1.5877185597034256,77.52556032643204,98.88099011128125,58.31538465384615,58.953274138015,-1.1190098887187518
2018-07-27,63.549999,63.6945,61.549999,61.924999,61.924999,42612000,1795232874.1010354,983758297,26.30670974380929,72.0,1.5805148386538406,65.66434607500594,73.36894072256143,58.447423038461544,59.17340190556944,-26.63105927743857
2018-07-30,61.400501,61.7458,60.573502,60.987,60.987,36998000,1784335061.9440584,946760297,25.889451462503906,72.0,1.4820332014935786,59.49900059438595,59.25201907562364,58.566807692307684,59.30774250515689,-40.747980924376364
2018-07-31,61.0005,61.379398,60.279999,60.862999,60.862999,32894000,1786327762.768782,913866297,25.191616515020602,72.0,1.37809413874416,58.71416591432324,51.99015692591979,58.685615423076925,59.422946689960085,-48.00984307408021
2018-08-01,61.400002,61.6735,60.510502,61.0005,61.0005,31344000,1781395669.4307024,945210297,24.768107678142776,72.0,1.2919243643536547,59.3544125015129,47.83619947019093,58.86869230769231,59.539802490703785,-52.163800529809066
2018-08-02,60.294998,61.493999,60.239498,61.307499,61.307499,30626000,1802915659.9496417,975836297,24.06947579266741,72.0,1.2341795967901135,60.81550026407711,53.78060726486456,59.07578842307692,59.670742972873875,-46.21939273513544
2018-08-03,61.480999,61.5,60.752998,61.185501,61.185501,21792000,1806358144.9336178,954044297,23.425932671079256,72.0,1.1651412108438564,59.894102000546226,51.41836549165166,59.306038423076934,59.782947271179516,-48.58163450834834
2018-08-06,61.25,61.304401,60.789848,61.238499,61.238499,21634000,1822450543.3182352,975678297,22.828356915318825,72.0,1.1020011054917376,60.17637242535393,47.120239612393206,59.51863457692308,59.89076591775881,-52.879760387606794
2018-08-07,61.849998,62.558498,61.808498,62.111,62.111,29880000,1816673902.6782348,1005558297,23.314026421793496,72.0,1.1095751641988656,64.59432587561876,65.90591755712829,59.76203838461539,60.055227701628525,-34.094082442871716
2018-08-08,62.023499,62.825001,61.900398,62.280499,62.280499,27406000,1811800920.6459463,1032964297,23.954847109283723,68.0,1.1163858123118615,65.39743489362363,69.55537311758575,59.98924984615384,60.220062612619,-30.44462688241427
2018-08-09,62.494999,62.7771,62.300499,62.455002,62.455002,16972000,1805832778.8669739,1049936297,24.549894890524648,64.0,1.1229199119751954,66.24630911339425,73.31256899288,60.27042296153846,60.38561367835093,-26.68743100711999
2018-08-10,62.150002,62.284752,61.599998,61.880501,61.880501,22174000,1801825517.6432354,1027762297,24.126882317123833,60.0,1.0694132731134047,60.94542023211242,47.496441391351,60.4883845,60.49634607254716,-52.503558608649
2018-08-13,61.848999,62.46365,61.682049,61.7505,61.7505,19946000,1785373176.5459237,1007816297,23.894571260286106,48.00000000000001,1.0049346213201176,59.77973423069195,43.733751818378245,60.67076915384616,60.58924636346959,-56.266248181621755
2018-08-14,61.759499,62.293499,61.255501,62.105,62.105,26962000,1802542652.787689,1034778297,23.107249965119557,48.0,0.9712441149712987,61.918712433486526,53.994237919399154,60.84009611538461,60.701524410619996,-46.005762080600846
2018-08-15,61.463001,61.762001,60.475498,60.719002,60.719002,36576000,1779812562.6751904,998202297,21.467198990905846,48.0,0.8232161670914948,50.59049877553834,13.878544788107378,60.95844242307692,60.70281904687037,-86.12145521189261
2018-08-16,61.2365,61.299999,60.127499,60.324501,60.324501,26864000,1761975874.7911818,971338297,20.318797633042777,44.0,0.6663883085863276,47.90403025582727,7.303127115382961,61.05957707692308,60.674795487842935,-92.69687288461704
2018-08-17,60.101501,60.451,59.411999,60.048,60.048,27792000,1768208365.2238185,943546297,19.956277312248552,32.0,0.5138662506852967,46.05794958126404,18.63465066823871,61.093192461538464,60.62836619244716,-81.3653493317613
2018-08-20,60.250999,60.549999,59.7313,60.3885,60.3885,17416000,1778753301.2943401,960962297,19.493852441762762,32.0,0.41567527938750004,48.68074294888084,28.611205032988533,61.12963469230769,60.61059832633996,-71.38879496701146
2018-08-21,60.400002,60.862999,60.0177,60.081001,60.081001,24112000,1758252600.2832189,936850297,18.6635386536528,32.0,0.3094781562409423,46.48268514660767,19.601570699343252,61.163788538461546,60.57136889475922,-80.39842930065674
2018-08-22,60.0,60.591999,59.950001,60.366501,60.366501,17748000,1763532840.2465832,954598297,17.967484457994995,16.000000000000004,0.2455233941604007,48.79446211116011,27.966640511784004,61.18019246153846,60.556193495147426,-72.03335948821599
2018-08-23,60.356998,61.063999,60.212002,60.269001,60.269001,19852000,1746337056.5196455,934746297,16.708251629282106,16.0,0.18484062165671844,48.031399725259156,25.109917896327094,61.19846176923076,60.53491997698836,-74.89008210367291
2018-08-24,60.441002,61.0825,60.317951,61.032501,61.032501,18932000,1762792874.959013,953678297,15.51520943929218,16.0,0.19609667600105496,54.0864714363763,47.48025345429046,61.26325026923077,60.57177783054478,-52.51974654570954
2018-08-27,61.380001,62.154499,61.285801,62.091,62.091,23126000,1782538004.1063116,976804297,15.630759514607778,16.0,0.2871194687095695,60.88997289503189,78.49397685673786,61.372692615384615,60.684312806059985,-21.506023143262134
2018-08-28,62.064499,62.127251,61.434502,61.557499,61.557499,26080000,1765718968.0629537,950724297,15.738056013115122,-60.0,0.31260312147311,56.35713500210404,63.757373107077655,61.42201942307692,60.74899326487036,-36.242626892922345
2018-08-29,61.872501,62.533001,61.817951,62.465,62.465,25978000,1786755970.9914205,976702297,16.251818533370788,-60.0,0.40139975971835895,61.59451641683192,97.82118050549164,61.424365615384616,60.87610487487996,-2.178819494508346
2018-08-30,62.211498,62.681751,61.629501,61.956001,61.956001,26628000,1776652640.984293,950074297,16.43199124167428,-60.0,0.42579151036954954,57.43152246908467,77.80412704082761,61.37709638461539,60.95609718044441,-22.195872959172394
2018-08-31,61.749001,61.932999,60.564251,60.9095,60.9095,36328000,1758651178.333754,913746297,15.365416536906038,-60.0,0.3565679701632902,49.95574191057589,45.798611026157374,61.28067330769231,60.952645537448525,-54.201388973842626
2018-09-04,60.213501,60.649502,59.625,59.849998,59.849998,36620000,1738115923.42942,877126297,15.356338402734588,-28.000000000000004,0.21375087205110788,43.74702878155152,13.395480758173655,61.20086557692308,60.87096794208197,-86.60451924182634
2018-09-05,59.689999,59.9505,58.099998,59.324001,59.324001,41226000,1751427284.294742,835900297,16.534950917044277,-76.0,0.05746135219624193,41.02124626903189,26.7147312393314,61.13690407692308,60.75637779822405,-73.2852687606686
2018-09-06,59.314999,59.314999,57.599998,58.571999,58.571999,37770000,1756470644.4852026,798130297,17.944516116174132,-80.0,-0.12563129557831587,37.43047011320553,19.12727753592115,61.04878869230769,60.594571961318564,-80.87272246407885
2018-09-07,57.933498,58.763,57.860748,58.241501,58.241501,28026000,1752098753.4880087,770104297,19.25339808679471,-80.0,-0.2940127683865583,35.94142025314687,12.62365565583373,60.942673346153846,60.420270408628305,-87.37634434416627
2018-09-10,58.609501,58.727001,58.005501,58.231998,58.231998,22308000,1743796838.2447653,747796297,20.468788488085245,-80.0,-0.4233430759327703,35.897200011636286,12.436653257251937,60.82438484615385,60.258176156137324,-87.56334674274807
2018-09-11,58.081501,58.933998,57.812,58.868,58.868,24186000,1765137507.6327677,771982297,21.28206502378069,-80.0,-0.4691106151677431,41.118594198513,24.95205886630072,60.73525019230769,60.155200144571594,-75.04794113369928
2018-09-12,58.636002,58.9305,57.917999,58.140999,58.140999,25910000,1750640691.4222157,746072297,22.037250378355026,-80.0,-0.5576167656775652,37.37136974250689,10.645952292447143,60.61611557692308,60.00600005978852,-89.35404770755285
2018-09-13,58.536999,58.9305,58.142502,58.766499,58.766499,28624000,1767350030.156578,774696297,22.738493921888338,-80.0,-0.5707071483769681,42.247954840451314,22.95469693233819,60.48748092307692,59.91418516647085,-77.0453030676618
2018-09-14,58.955002,59.021252,58.4165,58.626499,58.626499,18880000,1761582119.4758365,755816297,23.225501453502847,-76.0,-0.5856274522197822,41.46963427816982,20.19974209687097,60.34694246153846,59.81880100599153,-79.80025790312904
2018-09-17,58.507,58.862,57.7015,57.802502,57.802502,26130000,1740000473.219912,729686297,24.325935314846955,-15.999999999999993,-0.6563752862593759,37.13351560249141,3.9849241000103235,60.16800015384616,59.669445524066234,-96.01507589998968
2018-09-18,57.8545,58.804001,57.8545,58.061001,58.061001,24072000,1726399008.9476256,753758297,25.347766757523626,-16.0,-0.6837034378714861,39.27853448476073,9.071731742963465,60.02109630769231,59.550301485246514,-90.92826825703654
2018-09-19,58.249001,58.6605,57.729,58.554501,58.554501,23828000,1744804047.7624407,777586297,26.4086279425109,-16.0,-0.6579553693297271,43.258897550305576,18.782947537985468,59.89817326923076,59.476538486339365,-81.21705246201454
2018-09-20,58.9995,59.494499,58.667999,59.343498,59.343498,24508000,1760356857.1804683,802094297,25.84541941494708,-16.0,-0.5673443826451035,49.01341898252844,40.23770130678475,59.79196165384615,59.466683635499415,-59.76229869321526
2018-09-21,59.599998,59.6105,58.301998,58.304501,58.304501,88112000,1672581951.5616775,713982297,25.71872797294972,-16.000000000000007,-0.5727703573777205,42.85044413927186,23.10221596692455,59.69909623076923,59.38059603286983,-76.89778403307545
2018-09-24,57.858501,58.900002,57.345501,58.668499,58.668499,25420000,1690430639.2756126,739402297,26.47329934531748,-64.0,-0.5414573021696256,45.438826812677505,50.78689089707899,59.63540384615385,59.32784810450911,-49.21310910292101
2018-09-25,58.807499,59.344002,58.400002,59.232498,59.232498,19554000,1705365255.343409,758956297,26.449601134476552,-64.0,-0.4657624549020838,49.27256579225869,83.31116260978474,59.60403838461538,59.320785133804726,-16.688837390215255
2018-09-26,59.2575,59.711498,58.738251,59.024502,59.024502,29246000,1693322897.8843057,729710297,25.867139257629372,-64.0,-0.41774181439444646,47.93488688265526,70.96378397774805,59.55157692307692,59.298838235004375,-29.036216022251953
2018-09-27,59.336498,60.105,59.181499,59.731998,59.731998,25216000,1698169416.027762,754926297,24.76076575408111,-64.0,-0.31891978762185147,52.64435782104011,86.48298114983916,59.53815373076923,59.330924143522566,-13.51701885016084
2018-09-28,59.593498,59.7705,59.224998,59.6735,59.6735,27612000,1715961602.3515515,727314297,23.733418929357722,-64.0,-0.24252721635988905,52.22373296804653,84.36310359235499,59.511499846153846,59.35630013289126,-15.636896407645013
2018-10-01,59.994499,60.494999,59.514999,59.765499,59.765499,27152000,1702690369.6984901,754466297,22.28273882706555,-64.0,-0.17257269225025595,52.86162108588713,76.83757856013875,59.49213438461539,59.3866111600845,-23.16242143986125
2018-10-02,59.548,60.498001,59.331501,60.005501,60.005501,33758000,1707942900.3457255,788224297,20.692032444540292,-64.0,-0.09665291760880734,54.565862158927246,84.3774781919112,59.45263438461538,59.43245485193009,-15.622521808088793
2018-10-03,60.25,60.320499,59.691502,60.147499,60.147499,25124000,1719246637.292007,813348297,19.21494794648112,-64.0,-0.024742679156290137,55.58891903536143,88.88177636796198,59.377884346153856,59.48542108512045,-11.118223632038013
2018-10-04,59.766499,59.8755,57.778801,58.4095,58.4095,44190000,1701641844.6202881,769158297,19.877889277334813,-64.0,-0.10676457576293785,42.86609800309709,33.750959555908054,59.256807461538465,59.40572322696338,-66.24904044409195
2018-10-05,58.375,58.674999,57.256001,57.8675,57.8675,23686000,1698370200.8265688,745472297,20.888851964412485,-100.0,-0.2130465223833795,39.806373983937505,18.86178285009257,59.079980538461534,59.29178076570683,-81.13821714990743
2018-10-08,57.505501,58.400002,56.368198,57.448502,57.448502,38648000,1700820248.6618915,706824297,22.411961516623673,-100.0,-0.32731231506454606,37.57358207116981,26.158729605261982,58.90661519230769,59.155241597876696,-73.84127039473802
2018-10-09,57.307499,57.717499,56.878601,56.941002,56.941002,26174000,1678540127.9511492,680650297,23.826277529391206,-96.0,-0.4535910721217036,35.01192823902271,13.870007842989061,58.75398065384615,58.99122384988583,-86.12999215701095
2018-10-10,56.554001,56.608501,54.056499,54.061001,54.061001,53514000,1625214936.602553,627136297,26.43462039103907,-24.0,-0.7771019607320468,24.71446366953154,0.0698905317423657,58.53132692307692,58.62602215730169,-99.93010946825764
2018-10-11,53.646999,55.32,53.413502,53.966,53.966,58980000,1600419427.79006,568156297,29.059133104101875,-28.0,-1.0292874721990373,24.458916128654522,7.798688375847041,58.32524996153847,58.2808353308349,-92.20131162415296
2018-10-12,55.400002,55.75,54.320099,55.504002,55.504002,42026000,1627985249.1511192,610182297,30.925533490607418,-28.0,-1.0924493233803219,35.9970126543777,29.5080851871106,58.207250076923074,58.07514397299528,-70.4919148128894
2018-10-15,55.445499,55.672298,54.450001,54.612499,54.612499,27448000,1607835385.5353205,582734297,32.658619563791135,-28.0,-1.2006025877145987,32.86360598706561,16.924231339435554,58.06767307692308,57.818651752773405,-83.07576866056445
2018-10-16,55.2295,56.210999,55.125,56.063999,56.063999,38570000,1635963773.710632,621304297,33.53175539818479,-28.0,-1.1558667966635099,41.7535438255069,37.4126243789434,57.9842885,57.68867747479019,-62.5873756210566
2018-10-17,56.323002,56.449501,55.109501,55.7845,55.7845,29344000,1636182714.988244,591960297,34.02489722671465,-27.999999999999993,-1.1299413330575234,40.637664189618604,33.46740538745224,57.86569234615384,57.5476272914724,-66.53259461254777
2018-10-18,56.091999,56.091999,53.8545,54.398499,54.398499,41890000,1614661991.676189,550070297,35.11316660044558,-28.0,-1.207316718174674,35.56215059539892,13.903551966059982,57.72175003846154,57.31435852914111,-86.09644803394002
2018-10-19,54.668499,55.518002,54.387501,54.823002,54.823002,25352000,1608842608.369142,575422297,36.12370244748145,-28.0,-1.2203163763926739,38.11169031855951,19.895549424172422,57.57007707692307,57.12981360105658,-80.10445057582758
2018-10-22,55.153,55.6115,54.549999,55.057999,55.057999,30284000,1607544491.5666144,605706297,36.92730177836771,-28.0,-1.1978483550376353,39.53785774748935,23.809146000787347,57.432827076923076,56.97634585283017,-76.19085399921265
2018-10-23,54.044498,55.394501,53.5,55.184502,55.184502,36974000,1636321606.976952,642680297,38.17191970539037,-28.0,-1.1565031034912252,40.33494366750995,27.406384217389117,57.33213476923076,56.843616678546454,-72.59361578261088
2018-10-24,55.212502,55.306,52.437,52.5355,52.5355,39648000,1599396038.486189,603032297,39.7394558026099,-64.0,-1.3222469764563982,31.09157173186732,1.579031994073762,57.1196155,56.52449692458005,-98.42096800592624
2018-10-25,53.5895,55.549,53.477501,54.7785,54.7785,50916000,1612435333.7424262,653948297,40.85013323584929,-64.0,-1.2581061706432735,43.00229226461095,39.26713423876098,56.974384692307694,56.3951638190556,-60.73286576123901
2018-10-26,51.851501,55.3265,51.704498,53.573502,53.573502,83752000,1615117754.8211553,570196297,42.493255205135725,-72.0,-1.2896412068792316,39.092932196164284,31.082715602408815,56.75246176923076,56.18615183245889,-68.91728439759119
2018-10-29,54.123501,54.852001,49.7915,51.004002,51.004002,77614000,1574696566.453047,492582297,44.48906985511616,-76.0,-1.5046257371851297,32.34117469420835,17.786443041448887,56.47167334615385,55.80228888190638,-82.21355695855112
2018-10-30,50.423,51.8745,50.037498,51.810501,51.810501,64254000,1634473498.1145263,556836297,46.34232631581228,-76.0,-1.5915780758899203,36.07317458228137,30.324432213212393,56.20790419230769,55.50660089065405,-69.67556778678761
2018-10-31,52.990501,54.597,52.849998,53.838501,53.838501,50596000,1641134785.4994292,607432297,45.25026391958534,-76.0,-1.4797877079134452,44.38102969477617,60.78402511504582,56.00044276923077,55.38303793579079,-39.215974884954164
2018-11-01,53.790001,54.19875,53.123001,53.5,53.5,29640000,1632269613.7539756,577792297,44.23620598023176,-76.0,-1.4023419129699022,43.36793234027115,55.69990151698688,55.78796192307693,55.24355364425073,-44.30009848301312
2018-11-02,53.686501,54.14875,52.730499,52.8895,52.8895,36780000,1603736471.0169,541012297,43.47776841912531,-76.0,-1.3743847583791435,41.526768895320444,46.530482647869825,55.524788923076926,55.06917930023216,-53.469517352130175
2018-11-05,52.75,52.9235,51.062,52.004501,52.004501,48828000,1604352939.2715335,492184297,43.46344293587402,-76.0,-1.4074167112396196,38.94555876315823,33.238219699876865,55.22982742307693,54.84216609280755,-66.76178030012312
2018-11-06,51.973999,53.217251,51.9035,52.790501,52.790501,24666000,1612994265.646166,516850297,43.175378963928345,-76.0,-1.3545566548056343,42.3716271462279,47.59942029988416,54.961558269230764,54.69019090074773,-52.40057970011584
2018-11-07,53.450001,54.772999,53.294998,54.669498,54.669498,41168000,1648396465.5310104,558018297,41.585364108097174,-72.0,-1.147814039026244,49.6460791537219,83.8143986254295,54.75632738461539,54.688658093284936,-16.185601374570485
2018-11-08,54.569,54.663502,53.610249,54.119999,54.119999,29764000,1647442635.5471413,528254297,40.10892174196823,-68.0,-1.0165903823440843,47.74787265624657,74.3728350515464,54.52450046153846,54.64653519748605,-25.627164948453597
2018-11-09,53.699501,53.778,52.655499,53.307499,53.307499,26864000,1651786319.1037707,501390297,39.22573569527851,-64.0,-0.9670095643470162,45.007649216878676,61.068154580981336,54.32826965384615,54.547347331005604,-38.931845419018664
2018-11-12,53.0695,53.105999,51.549999,51.931499,51.931499,29436000,1636784553.0369327,471954297,38.90734976545031,-60.0,-1.0269105238724237,40.743165454233605,37.168892748588846,54.099961923076926,54.35358078796815,-62.831107251411154
2018-11-13,52.164501,52.83025,51.557499,51.802502,51.802502,30274000,1618165968.4669735,441680297,38.611705687752696,-56.00000000000001,-1.072429150009171,40.35711320424355,34.92838905775072,53.88280807692308,54.1646119888594,-65.07161094224928
2018-11-14,52.5,52.728199,51.549999,52.182999,52.182999,31318000,1620499800.0745108,472998297,38.34074014060176,-52.0,-1.0655174394324405,42.099832541627364,43.20684733514005,53.69980796153846,54.01782584153648,-56.79315266485995
2018-11-15,52.2355,53.592499,51.589001,53.2355,53.2355,36722000,1644134971.659409,509720297,37.25485910880879,-32.0,-0.9639994389585596,46.73599431934126,68.0565027059574,53.66805792307692,53.95987577920044,-31.9434972940426
2018-11-16,52.970501,53.349998,52.449001,53.074501,53.074501,33162000,1657017144.9474442,476558297,36.24654100785817,-32.0,-0.8863200204795021,46.12754494643644,64.13266516045502,53.6337695,53.89429246222263,-35.86733483954498
2018-11-19,52.860001,53.039501,50.813,51.0,51.0,37172000,1626089169.989427,439386297,36.187532872309745,-32.0,-0.9808468234320387,39.069478692299974,4.722223414702826,53.46053865384616,53.67990042798392,-95.27777658529718
2018-11-20,50.0,51.587002,49.800999,51.287998,51.287998,48982000,1658670510.0487666,488368297,36.576530269835054,-32.0,-1.0207543434269652,40.43217058445262,29.90746178600169,53.33267323076923,53.50272247035548,-70.09253821399831
2018-11-21,51.838001,52.428001,51.6735,51.880501,51.880501,30686000,1644822215.1969378,519054297,36.13573577108933,-32.0,-0.993123194210149,43.244440201401986,41.824255832663006,53.17176946153847,53.382557916995815,-58.175744167336994
2018-11-23,51.5,51.879501,51.119949,51.194,51.194,13830000,1633688871.4627368,505224297,35.99090526654598,-28.000000000000004,-1.0149208272259287,40.83868081708371,28.016914722445794,52.99521176923077,53.22044251573687,-71.98308527755421
2018-11-26,51.9175,52.4655,51.695499,52.431,52.431,38856000,1669062974.6859794,544080297,35.3086224275407,-20.0,-0.9217546328397006,46.60304737896101,52.89623893805308,52.91953873076923,53.16196529234896,-47.10376106194692
2018-11-27,52.049999,52.879002,51.9245,52.220501,52.220501,36064000,1655366617.8423057,508016297,34.298945185461285,-20.0,-0.8550487924192609,45.78551148063943,48.66255028157685,52.819442538461544,53.092227196619405,-51.33744971842315
2018-11-28,52.438,54.341999,51.787998,54.311501,54.311501,49508000,1703692241.6537294,557524297,32.176035244159365,-8.0,-0.6262388172474829,54.352001858603366,92.76090935059575,52.79073107692307,53.1825437746476,-7.239090649404249
2018-11-29,53.804001,54.71225,53.799999,54.415001,54.415001,29378000,1713925113.5650783,586902297,29.935976906542077,-8.0,-0.4315787077283062,54.73327624417745,93.94759094984148,52.761134884615394,53.27383690245148,-6.052409050158519
2018-11-30,54.453499,54.7785,53.894001,54.7215,54.7215,51604000,1758878053.4734328,638506297,27.806336277488924,-8.0,-0.24969888736168144,55.90777168775524,98.85484704071376,52.8452118076923,53.38107120597359,-1.1451529592862386
2018-12-03,56.157001,56.232498,55.18325,55.321499,55.321499,39824000,1729548480.2934031,678330297,26.812533947412987,96.0,-0.056491713144389166,58.19448639371155,85.83535502376667,52.86609638461539,53.524806598123696,-14.164644976233324
2018-12-04,55.155998,55.221001,52.499001,52.541,52.541,46904000,1684091887.4175766,631426297,25.67602277849644,96.0,-0.1262809787787731,46.229197436134235,42.60283644606022,52.82638476923077,53.45193203529972,-57.39716355393978
2018-12-06,51.713001,53.560001,51.538502,53.436501,53.436501,55384000,1732708707.2210987,686810297,25.113267449481558,32.0,-0.10808410166861648,49.80850869576808,56.52651116015102,52.91994242307692,53.45078899564788,-43.47348883984898
2018-12-07,53.0005,53.763,51.424999,51.828999,51.828999,42024000,1705207965.337755,644786297,24.445050304617762,31.999999999999993,-0.2208293392413765,44.129736904483195,31.532306854125377,52.92065388461538,53.330656403377674,-68.46769314587462
2018-12-10,51.752499,52.422501,51.164501,51.977501,51.977501,36154000,1715784016.2121587,680940297,23.96515330684486,32.0,-0.2947996155249655,44.756348915544194,33.841286455925726,52.849076961538465,53.23042266979414,-66.15871354407427
2018-12-11,52.824501,53.029999,51.992001,52.587502,52.587502,27894000,1719895674.9783607,708834297,23.053451786151005,32.0,-0.3007329474790623,47.36763131802254,43.325871620286385,52.81398088461538,53.18279891647605,-56.674128379713615
2018-12-12,53.400002,54.0825,53.1395,53.183998,53.183998,30476000,1692295859.597661,739310297,21.462443640248868,32.0,-0.2543706867880573,49.863310710933014,40.372209635545865,52.82530773076923,53.18288773747782,-59.62779036445413
2018-12-13,53.4035,53.987999,52.696499,53.095001,53.095001,26596000,1682112649.6743162,712714297,20.273889528787844,32.0,-0.22224764280749554,49.48628303836833,38.6314537034267,52.867250038461535,53.17637760877576,-61.3685462965733
2018-12-14,52.499001,53.130001,52.039501,52.105,52.105,33732000,1652432758.3730779,678982297,19.585668083090663,32.0,-0.2735217178334679,45.37607336137587,18.55760767024913,52.84088461538462,53.097016304422,-81.44239232975087
2018-12-17,51.8755,52.657501,50.395,50.8265,50.8265,47708000,1622922321.1586854,631274297,19.849322910494084,32.0,-0.41256526131155624,40.67733350416532,7.391865487577041,52.693077,52.92882991150185,-92.60813451242296
2018-12-18,51.304501,52.473999,51.071999,51.435501,51.435501,43850000,1601810641.7007685,675124297,20.094145250225836,31.999999999999996,-0.4682196357025248,43.66959353619217,17.82443437239721,52.58982707692307,52.81821295509431,-82.1755656276028
2018-12-19,51.699501,53.099998,50.4025,51.150501,51.150501,49586000,1579724478.6504157,625538297,20.664517752681693,32.00000000000001,-0.5292226967130773,42.58699556743768,12.942205718956918,52.50686561538461,52.69467873619843,-87.05779428104309
2018-12-20,50.906502,51.710999,49.818001,50.470501,50.470501,53470000,1563115769.576238,572068297,21.479679424090563,32.0,-0.6252311040949934,40.036674869604276,10.172270717407718,52.450673384615385,52.52992482981337,-89.82772928259229
2018-12-21,50.764999,51.201,48.684502,48.977001,48.977001,91920000,1492563963.0578144,480148297,22.74121174649722,-52.0,-0.8124658266409881,35.069310499048996,3.8751875332207315,52.342000269230766,52.26674528686423,-96.12481246677926
2018-12-24,48.695,50.176998,48.505501,48.811001,48.811001,31806000,1472384347.0716653,448342297,23.988188063363925,-56.0,-0.9631429930044817,34.55611775605638,4.54917727644993,52.21230803846154,52.01076422857799,-95.45082272355006
2018-12-26,49.4505,52.0,49.150002,51.973,51.973,47466000,1518950990.6510642,495808297,23.54278600212509,-56.0,-0.8179796789815299,49.665785066998325,62.17499770037607,52.16375034615385,52.007966878312956,-37.82500229962393
2018-12-27,50.857498,52.1945,49.849998,52.194,52.194,42196000,1561128992.7990685,538004297,22.977268385657364,-56.0,-0.677296402422435,50.525554521296925,66.13770237362424,52.12988492307692,52.02174710954903,-33.86229762637577
2018-12-28,52.480999,52.778,51.654999,51.854,51.854,28296000,1542861358.3944688,509708297,21.996737685883996,-56.0,-0.5864784917003902,49.13502186491494,60.04123364555017,52.16273107692307,52.00932139773059,-39.958766354449835
2018-12-31,52.548,52.634998,51.179501,51.780499,51.780499,29866000,1537659656.9371657,479842297,21.385445633409194,-56.0,-0.514504670004186,48.822207613060215,58.7233026220732,52.18167342307692,51.99237159049128,-41.2766973779268
2019-01-02,50.828499,52.616001,50.7855,52.2925,52.2925,30652000,1557477516.281684,510494297,21.06240984006746,-56.0,-0.41140823796295933,51.15500844396509,67.90388522572792,52.197519538461535,52.01460332452896,-32.09611477427208
2019-01-03,52.049999,52.848999,50.703499,50.803001,50.803001,36822000,1524070909.0982769,473672297,20.557317758689898,-56.0,-0.4447667001760891,44.76258723564919,41.90608003869768,52.18248111538461,51.92485500419348,-58.093919961302326
2019-01-04,51.629501,53.542,51.370899,53.5355,53.5355,41878000,1565698154.296911,515550297,19.494169782176748,-56.0,-0.2478565529051835,55.69941076912294,99.87094209688114,52.224961884615375,52.04416204091989,-0.12905790311886522
2019-01-07,53.575001,53.700001,52.737999,53.419498,53.419498,39638000,1582220655.7553277,475912297,18.374106259166698,-56.0,-0.1000113656940016,55.199738730851564,94.59999999999994,52.27107715384615,52.14603877862953,-5.400000000000061
2019-01-08,53.8055,54.228001,53.026501,53.813999,53.813999,35298000,1593193324.7590733,511210297,17.231016053536354,-56.0,0.048431654094741816,56.6248308621724,92.76536478811713,52.25194246153846,52.26959138761994,-7.2346352118828605
2019-01-09,54.0825,54.1315,53.32,53.733002,53.733002,23986000,1593622028.3253086,487224297,16.169575148308176,-56.0,0.15771993849794086,56.22934503116893,91.34995194408037,52.22571173076923,52.37799217372217,-8.650048055919621
2019-01-10,53.382999,53.557499,52.885502,53.516499,53.516499,29128000,1619195702.9339752,458096297,15.238612490934552,-56.00000000000001,0.22427638994206944,55.12113561558612,87.56658802970736,52.17936553846154,52.46232601270572,-12.433411970292639
2019-01-11,53.159,53.188751,52.424,52.859501,52.859501,30416000,1623421562.6137927,427680297,14.775203408976937,-52.0,0.22145580472089677,51.78569341627983,76.08562691131502,52.084673307692306,52.49174638213492,-23.914373088684982
2019-01-14,52.346001,52.5765,52.062752,52.234501,52.234501,22886000,1615837413.3810947,404794297,14.64854225893443,36.0,0.1668646817730206,48.762788750772785,65.16382699868942,52.07288488461538,52.47269116864344,-34.83617300131059
2019-01-15,52.508499,54.002499,52.367001,53.857498,53.857498,29272000,1639918982.9776335,434066297,14.007800993465324,36.0,0.2516621132893704,55.953166841552566,92.70375988652223,52.089077076923076,52.575269452447635,-7.296240113477759
2019-01-16,54.0,54.618752,53.966999,54.0485,54.0485,26636000,1619944588.3281264,460702297,13.89412400211622,60.0,0.3304675298530242,56.72288098458027,88.04190780233152,52.174442500000005,52.684397641155215,-11.958092197668476
2019-01-17,53.973499,54.59,53.674999,54.494999,54.494999,24854000,1639637599.7521574,485556297,13.50615095532197,60.0,0.4240618074472948,58.546536718114886,96.8392080920441,52.271269346153844,52.818516260328906,-3.1607919079559017
2019-01-18,55.0,55.417599,54.544998,54.912998,54.912998,39112000,1633514826.2141945,524668297,13.779752497965218,68.0,0.525902693796688,60.2358703614969,89.2959207483931,52.36071150000001,52.9736630558601,-10.704079251606897
2019-01-22,54.400002,54.5755,53.1735,53.526001,53.526001,32270000,1617471940.7220407,492398297,12.797620101335056,68.0,0.48905573359980536,52.5789907462569,59.873613202944334,52.373865461538465,53.01457697764825,-40.126386797055666
2019-01-23,53.8675,54.246498,52.987499,53.7785,53.7785,19340000,1622433722.2802467,511738297,12.032040055671956,68.0,0.47475611824783925,53.73203467813767,65.22986360068728,52.40015388461538,53.07116386819282,-34.77013639931272
2019-01-24,53.824001,53.973751,53.035,53.695,53.695,27226000,1633490845.2809148,484512297,11.321144298984793,68.0,0.4514814211117155,53.27074332377092,57.43200632614224,52.461307730769235,53.117373952030384,-42.56799367385776
2019-01-25,54.25,54.700001,54.091,54.5495,54.5495,22382000,1644810422.1256163,506894297,10.999535317070338,68.0,0.4962664142829851,57.30980463733273,74.1240360588724,52.60450003846154,53.2234573629911,-25.875963941127598
2019-01-28,54.005501,54.150002,53.189999,53.504002,53.504002,25686000,1635927455.1536381,481208297,10.522710031677367,68.0,0.4422973643256256,51.45012551727884,42.96023037712292,52.684057769230776,53.24423844721398,-57.03976962287708
2019-01-29,53.633999,53.7575,52.793251,53.030998,53.030998,20436000,1625568930.3535087,460772297,10.40206547788107,68.0,0.3572409820020539,49.00869518054935,28.86110752591679,52.75638457692308,53.22844285853146,-71.1388924740832
2019-01-30,53.421501,54.549999,53.342499,54.452999,54.452999,25596000,1647052612.3410864,486368297,9.74374224641549,68.0,0.3999662211274355,55.79927776942419,71.24757105167525,52.90955757692307,53.31915072086246,-28.752428948324752
2019-01-31,55.150002,55.866501,54.7705,55.818501,55.818501,30766000,1675123782.6830842,517134297,10.130507242851134,100.0,0.5378113261843254,61.14963885487892,98.73808708198143,53.1726921923077,53.504287778576355,-1.2619129180185618
2019-02-01,55.619999,56.25,55.244499,55.537498,55.537498,29244000,1662922953.7112584,487890297,10.747055352702972,100.0,0.617264530132779,59.552090409027855,82.98400285820183,53.43140361538462,53.654895943126256,-17.015997141798174
2019-02-04,55.632999,56.639999,55.451,56.639999,56.639999,51530000,1714452953.7112584,539420297,11.577499543208658,100.0,0.7604286354470133,63.573099700374364,100.0,53.61090357692308,53.87601468807986,-0.0
2019-02-05,56.242001,57.342499,55.8624,57.2995,57.2995,71044000,1781369093.4046173,610464297,12.788785946038013,88.0,0.9165381580100416,65.7655203124406,99.0548108170846,53.80726896153847,54.12960619266654,-0.9451891829153893
2019-02-06,56.9785,57.349998,55.6385,55.761501,55.761501,42112000,1745310057.6639972,568352297,13.670029089805926,92.0,0.9057119302972083,57.12995420163231,65.13967090997161,53.957557461538464,54.25048728950606,-34.860329090028394
2019-02-07,55.208,55.242001,54.299999,54.935501,54.935501,40896000,1759593324.3576984,527456297,13.184724281839879,92.0,0.8210166016868925,53.09744942570094,47.01270445780737,54.07890369230769,54.30122904583895,-52.98729554219263
2019-02-08,54.349998,54.945499,54.327499,54.752998,54.752998,21516000,1767705274.1441061,505940297,12.734084103014263,92.0,0.7307449043234016,52.22039645674911,43.007588527517534,54.17353823076923,54.33469341281385,-56.99241147248247
2019-02-11,54.8475,55.297249,54.643002,54.7505,54.7505,21304000,1753402108.3611526,484636297,12.598742399545527,88.0,0.6514923675933417,52.20768504726729,42.95276871856181,54.32536511538462,54.36549390075356,-57.04723128143819
2019-02-12,55.34,56.264751,55.2925,56.068501,56.068501,32182000,1772592159.7799735,516818297,13.186087780281627,64.0,0.6871151907524862,58.01476871767963,71.87693325962576,54.422788230769235,54.49164257477182,-28.123066740374245
2019-02-13,56.2495,56.7365,55.924999,56.007999,56.007999,20996000,1755891084.863245,495822297,14.045508474354806,64.0,0.7023680671221584,57.66836992730211,70.54918783070465,54.522345961538456,54.60396527293687,-29.45081216929535
2019-02-14,55.9025,56.411499,55.522251,56.0835,56.0835,18952000,1760862199.7828176,514774297,14.409119174951735,64.0,0.7123370036838992,58.005346308235204,72.20609351364037,54.60963446153846,54.713560437904505,-27.79390648635964
2019-02-15,56.504002,56.5835,55.532501,55.682499,55.682499,28996000,1740142786.1696742,485778297,14.872966103306789,64.0,0.6800409396945639,55.479291268367426,63.40593410167388,54.68461511538462,54.785333664726394,-36.59406589832613
2019-02-19,55.5,56.094501,55.5,55.928001,55.928001,20928000,1749348309.6725783,506706297,15.265452008522862,64.0,0.6665722064870323,56.721907877866926,64.51659750882042,54.77736519230769,54.86997568956147,-35.483402491179575
2019-02-20,55.9995,56.170502,55.264,55.689999,55.689999,21756000,1748040216.5586083,484950297,15.34223770139597,64.0,0.6294376011935299,55.11584763553196,45.57378543402803,54.8862305,54.93071815700136,-54.42621456597197
2019-02-21,55.542,55.597,54.625999,54.848499,54.848499,28302000,1732708738.731088,456648297,14.675916815735397,60.0,0.5260422540126513,49.75196310620638,17.983612453643335,54.98676888461539,54.924627849075335,-82.01638754635667
2019-02-22,55.044998,55.562,54.779999,55.518501,55.518501,20990000,1751363590.7964947,477638297,14.057190279050578,24.000000000000007,0.4924871728423099,53.62205348020479,39.95089834455687,55.05065361538462,54.96861845284753,-60.04910165544313
2019-02-25,55.799999,55.926998,55.363499,55.470001,55.470001,28262000,1733784695.9093704,449376297,13.856040581982954,23.999999999999996,0.4567162440297281,53.30201957223791,38.36073388876534,55.10532673076922,55.00575790078475,-61.63926611123466
2019-02-26,55.287498,55.975498,54.995998,55.7565,55.7565,29426000,1750052482.233005,478802297,13.217324361504112,24.0,0.4463404651135505,55.01019594390677,47.754146804638395,55.153846,55.06136842665255,-52.245853195361605
2019-02-27,55.3475,55.898998,55.049999,55.802502,55.802502,19368000,1765017804.425375,498170297,12.62423072820233,24.0,0.4367944677847717,55.292975924258876,61.66642246401694,55.188057692307694,55.11626720986347,-38.33357753598306
2019-02-28,55.564999,56.3825,55.550499,55.995998,55.995998,30850000,1767205370.846569,529020297,12.615866227867471,24.0,0.43977327366353336,56.5306260910137,69.26103393066252,55.28305757692307,55.18143245357729,-30.738966069337472
2019-03-01,56.244999,57.148499,56.237499,57.0495,57.0495,29006000,1789907166.6885011,558026297,13.357460018555704,24.0,0.5211354802789359,62.60117733438182,96.07536174430132,55.40886526923077,55.31980782738638,-3.924638255698677
2019-03-04,57.349499,57.914001,56.5345,57.389999,57.389999,28920000,1796856703.6877496,586946297,14.674734320132002,92.0,0.6061042463704496,64.33479996771376,84.0632092072938,55.55098061538461,55.47315532165405,-15.93679079270621
2019-03-05,57.502998,58.480499,57.30975,58.101501,58.101501,28864000,1807032841.0083878,615810297,16.304617154311966,96.0,0.7225260403581544,67.70374391710348,90.1673887663769,55.687596038461535,55.66784759412412,-9.832611233623107
2019-03-06,58.1245,58.3783,57.774502,57.893002,57.893002,21986000,1793676684.101608,593824297,17.818079786050504,96.0,0.7888733827660843,65.74391913257645,84.7581528084058,55.85640373076922,55.832673846411225,-15.241847191594209
2019-03-07,57.785999,57.837749,56.745499,57.165001,57.165001,23332000,1788266992.4815574,570492297,17.754536167436033,92.0,0.7737907549345167,59.29033270403238,65.87111168763771,56.015403846153845,55.931364746677055,-34.12888831236229
2019-03-08,56.336498,57.354,56.165001,57.116001,57.116001,24248000,1802807667.6612673,546244297,16.999820340568313,68.0,0.7492469211071011,58.87144364787934,64.59987028148906,56.117827000000005,56.01911558025653,-35.40012971851094
2019-03-11,57.2225,58.809502,57.2225,58.787998,58.787998,34384000,1836259855.9357622,580628297,17.51631498753067,84.0,0.8548576732809821,67.34845802541591,99.4859810068261,56.23203842307692,56.224217981719015,-0.5140189931739066
2019-03-12,58.912998,60.0,58.912998,59.66,59.66,40262000,1851335002.5537074,620890297,18.749411878636874,88.0,0.9974205854026224,70.73610575591196,93.67324271059861,56.39059619230769,56.47872035344353,-6.326757289401387
2019-03-13,60.032249,60.046501,59.597,59.666,59.666,28718000,1831433632.5500805,649608297,19.921554342323805,92.0,1.0982271907924783,70.75858653520375,92.77507157502261,56.506980846153844,56.71481514207734,-7.22492842497738
2019-03-14,59.725498,59.894001,59.223999,59.2775,59.2775,23456000,1811723649.594806,626152297,20.547658793070987,92.0,1.1336998623566998,67.1609244852419,84.77377401815234,56.58305776923077,56.90464365007161,-15.22622598184767
2019-03-15,59.668999,59.828499,59.130501,59.223,59.223,49236000,1775537202.0691679,576916297,21.011734485682904,92.0,1.1442246066037995,66.6489776406012,83.69467358003746,56.716192346153846,57.07637375006631,-16.305326419962533
2019-03-18,59.165001,59.5,58.871052,59.213001,59.213001,25852000,1777795842.5291104,551064297,21.10929280137418,88.0,1.1386332511665813,66.54874876720302,83.31832950332051,56.88071157692308,57.234642435246585,-16.681670496679494
2019-03-19,59.440498,60.0,59.293499,59.942501,59.942501,30414000,1803259319.9226315,581478297,21.592661854521044,56.0,1.1794704142722807,70.08353418599015,97.68683376920207,57.08030784615385,57.43522455115424,-2.3131662307979237
2019-03-20,59.8675,61.356998,59.808498,61.198502,61.198502,44548000,1838687940.1254084,626026297,22.925205758790636,76.0,1.2982178963149522,74.98476020593624,96.947301780028,57.32830792307693,57.713985843661334,-3.0526982199719974
2019-03-21,60.799999,61.5895,60.657501,61.577,61.577,24080000,1862122016.6855762,650106297,24.2935097170799,80.0,1.4066527395527757,76.24763305095411,99.76956397263595,57.54017326923077,58.00013504042716,-0.23043602736405394
2019-03-22,61.316002,61.5,60.141251,60.275002,60.275002,34284000,1834587636.0545695,615822297,24.870433391691652,80.0,1.371715494345338,64.23453665912432,75.76738423216598,57.70428876923077,58.168643704099225,-24.23261576783403
2019-03-25,59.8465,60.319901,59.352001,59.650002,59.650002,29936000,1823085271.6284924,585886297,24.449795588415643,80.0,1.2788533735207608,59.39676082746621,64.2455828639659,57.84146192307692,58.278373948240024,-35.75441713603411
2019-03-26,59.926498,60.141499,58.835999,59.230999,59.230999,38024000,1808070815.864417,547862297,23.494200027342657,80.0,1.1580995822932891,56.33362241302372,56.521311922077935,57.97794269230769,58.348938766888914,-43.47868807792207
2019-03-27,59.275002,59.377949,57.968498,58.651001,58.651001,28004000,1807187750.2026808,519858297,21.87757351776371,80.0,1.0040265483424946,52.31201772409291,45.8291171221527,58.08267346153846,58.371313747119366,-54.170882877847305
2019-03-28,58.577,58.578251,57.97155,58.4245,58.4245,19234000,1816673136.852777,500624297,20.37642033029755,80.0,0.8538037035281505,50.78721244259485,27.52461644149311,58.18784657692307,58.37525346955496,-72.47538355850689
2019-03-29,58.744999,58.949501,58.144001,58.665501,58.665501,25398000,1824161684.3388104,526022297,19.2241385955216,76.0,0.745602936753059,52.37779359979183,19.248898509307683,58.33465434615385,58.396753286624964,-80.75110149069232
2019-04-01,59.205002,59.833,59.099998,59.7215,59.7215,25050000,1841590763.7956195,551072297,18.93963236362357,68.0,0.7365725931343547,58.679684023067544,48.41206936643504,58.49630815384615,58.4948826728009,-51.58793063356496
2019-04-02,59.765999,60.067501,59.2855,60.024502,60.024502,16558000,1856327851.9502382,567630297,18.867866730053002,68.0,0.7452746476423897,60.30293762673279,56.779974161847996,58.67148126923077,58.60818780814898,-43.220025838152004
2019-04-03,60.374001,60.814999,60.025002,60.296001,60.296001,20286000,1849959590.1543071,587916297,19.377858275316978,64.0,0.765257378124268,61.75280975229039,64.27787115279133,58.84607746153846,58.73321100754536,-35.722128847208666
2019-04-04,60.297001,60.783501,60.206501,60.75,60.75,19000000,1866753285.1283104,606916297,19.851421853062096,60.0,0.8084089261870062,64.11316735670535,76.8158095466393,59.036365846153835,58.88260278476422,-23.1841904533607
2019-04-05,60.7495,60.811001,60.251499,60.357498,60.357498,18144000,1855484134.0332294,588772297,20.313249621128886,36.00000000000001,0.8016937809234861,60.629520950049674,65.9762132139115,59.20411584615385,58.99185428218909,-34.023786786088486
2019-04-08,60.394501,60.434502,59.993,60.192001,60.192001,17204000,1853789070.3642082,571568297,20.375830891329834,36.0,0.7740944758774404,59.16963588289837,61.405737969766335,59.32498126923077,59.08075403906397,-38.594262030233665
2019-04-09,59.799999,60.114498,59.653999,59.862499,59.862499,17528000,1852133365.4180522,554040297,19.964580954987188,36.0,0.7173644394353502,56.264785237684514,52.30599154598646,59.42007742307692,59.13866107320738,-47.69400845401354
2019-04-10,60.034,60.189251,59.821751,60.108002,60.108002,14492000,1860217417.075195,568532297,19.66023483498782,36.0,0.684327021260664,57.9223107615659,60.58340049078269,59.49725053846154,59.21046410482165,-39.41659950921731
2019-04-11,60.198002,60.397999,60.0065,60.230999,60.230999,14204000,1862303541.9337513,582736297,19.599340977507747,36.0,0.6604561321350673,58.76547533806738,79.48358352939266,59.5871735,59.28605928224227,-20.516416470607332
2019-04-12,60.5,60.9175,60.405499,60.893501,60.893501,18668000,1879221493.2736905,601404297,20.06371880853744,36.0,0.6870764653599082,63.05928798553754,99.18619926334414,59.730577346153844,59.40512903911322,-0.8138007366558696
2019-04-15,60.900002,61.209999,60.455502,61.055,61.055,23748000,1893212221.205014,625152297,20.76756691645741,32.0,0.7129860316715693,64.04226145387366,95.21829547484317,59.882077307692306,59.527341702882616,-4.781704525156813
2019-04-16,61.25,61.541,61.006001,61.356499,61.356499,17126000,1898525996.785903,642278297,21.717579976738485,-15.999999999999996,0.7492115547741989,65.86824107084854,94.83110843407255,59.98086580769231,59.66283483600242,-5.1688915659274555
2019-04-17,61.650002,62.028,61.390999,61.817001,61.817001,24438000,1906774403.4822817,666716297,23.003715166842145,60.0,0.8057905537318106,68.49943146658516,94.567480578651,60.06382738461538,59.82240270000224,-5.432519421349008
2019-04-18,61.959,62.099998,61.730499,61.818501,61.818501,26636000,1892825968.385028,693352297,24.255992559563804,64.0,0.8410556890549401,68.50794753209732,90.6167666666666,60.146615884615386,59.970261833335414,-9.383233333333388
2019-04-22,61.7995,62.454498,61.415501,62.442001,62.442001,16146000,1908583561.9468956,709498297,25.702036341020655,68.0,0.9088382801023585,71.90763354647416,99.60564822066775,60.26832746153846,60.15335362345871,-0.39435177933224647
2019-04-23,62.5345,63.450001,62.319,63.227501,63.227501,26398000,1924595090.1400623,735896297,27.71003407442374,72.0,1.0142481359930358,75.49652220991801,94.13857000075332,60.42234673076923,60.381068243943254,-5.8614299992466705
2019-04-24,63.206001,63.400501,62.75,62.799999,62.799999,20376000,1907351382.4009504,715520297,29.57460339829803,72.0,1.0511730984601684,70.23736091445852,82.87666866350438,60.56030819230769,60.56024829994746,-17.123331336495617
2019-04-25,63.238499,63.370399,62.601501,63.172501,63.172501,22146000,1918097563.158346,737666297,30.996026493288788,72.0,1.097838991008956,72.0635111654139,92.6896771919508,60.68453896153846,60.75374849995135,-7.310322808049187
2019-04-26,63.450001,63.6535,63.015999,63.609001,63.609001,24828000,1939459462.9577186,762494297,32.51351294729445,84.0,1.1567101149031984,74.07116312649457,98.88738620142858,60.77725046153846,60.96524868514014,-1.1126137985714173
2019-04-29,63.700001,64.463501,63.314751,64.378998,64.378998,49988000,1982093145.718981,812482297,34.41503731386851,88.0,1.2510765952772829,77.18582459761528,98.24299896330227,60.88501961538461,61.21811900475939,-1.7570010366977307
2019-04-30,59.25,59.640499,58.75,59.424,59.424,124140000,2045871065.89632,688342297,33.04080976001028,88.0,0.9154826685586599,42.12126650258429,11.796619970837499,60.85228876923077,61.08522130070314,-88.2033800291625
2019-05-01,59.4025,59.4025,58.359001,58.403999,58.403999,52784000,1997639393.0801506,635558297,32.014951558928516,88.0,0.5607525018297252,38.267360427712106,0.7371283479400391,60.804365576923075,60.886612241391795,-99.26287165205997
2019-05-02,58.388,58.709499,57.750099,58.130501,58.130501,38896000,1989587912.9717498,596662297,31.43860750248276,-12.0,0.25462216035457885,37.28234912332993,5.666307484640484,60.76203873076923,60.68245585314055,-94.33369251535952
2019-05-03,58.682499,59.34,58.450001,59.27,59.27,39614000,2022970490.239814,636276297,30.307044019228222,-12.0,0.10277497930876223,43.77586581225803,22.639803187713255,60.78584638461538,60.57782949364866,-77.36019681228674
2019-05-06,58.313,59.5425,58.313,59.469501,59.469501,31278000,2050534358.1178133,667554297,29.068304813230437,-12.0,-0.0014502249785195431,44.8524116224529,25.611485801088683,60.82603873076923,60.49573108671172,-74.38851419891132
2019-05-07,59.023499,59.521999,58.051998,58.705002,58.705002,31028000,2047072881.0140564,636526297,28.108506194358064,-12.0,-0.14407729699870941,41.56780503691449,14.223831672824037,60.827557999999996,60.363084487696035,-85.77616832717597
2019-05-08,58.600498,59.021198,58.286999,58.313499,58.313499,26186000,2022777183.2345715,610340297,27.217264619690862,-12.0,-0.2854112560230959,39.954179949033566,8.392168381991752,60.773404115384615,60.2112633404593,-91.60783161800825
2019-05-09,57.9515,58.483002,57.5425,58.118999,58.118999,23714000,2028135098.628691,586626297,26.94424891413121,-32.0,-0.40840610989094017,39.14125677181833,8.329705486244052,60.70011553846154,60.05628079672157,-91.67029451375593
2019-05-10,58.179501,58.630001,57.125,58.213501,58.213501,26290000,2039873898.9949367,612916297,26.978816108044306,-36.0,-0.49257677762339824,39.782344122131306,14.83274309017607,60.62001938461538,59.91977858955701,-85.16725690982393
2019-05-13,57.098,57.396999,56.105499,56.601501,56.601501,37212000,2031244518.3120098,575704297,27.64133073070786,-40.0,-0.6815016394921543,33.33223099310287,5.934456584241038,60.460461730769225,59.67398024958983,-94.06554341575897
2019-05-14,56.8605,57.021,55.977501,56.021999,56.021999,36732000,1997645248.7429929,538972297,28.330182503373635,-43.99999999999999,-0.8679813729848576,31.363543974005808,0.5243695498468581,60.29371176923077,59.40346311999059,-99.47563045015313
2019-05-15,55.893501,58.566502,55.833302,58.210499,58.210499,45786000,2031503871.7797263,584758297,27.265560655554946,-48.0,-0.8296110060861537,44.65733033668525,27.545100640205376,60.21750015384615,59.315095407398694,-72.45489935979462
2019-05-16,58.225498,59.408001,58.141998,58.949001,58.949001,30628000,2039922995.4974427,615386297,25.527696217068634,-48.0,-0.7311826558824777,48.296510113849344,36.10228454755218,60.18236561538462,59.28797730314694,-63.89771545244782
2019-05-17,58.4235,59.0075,58.0005,58.115002,58.115002,24172000,2021248001.1459033,591214297,24.028165060439584,-48.0,-0.7122636959692628,44.72011986780669,59.93123024629397,60.105711769230766,59.201090243654576,-40.06876975370603
2019-05-20,57.224998,57.339851,56.572151,56.942501,56.942501,27066000,2020296090.243207,564148297,23.671328009016197,-48.0,-0.7828570271373252,40.21179702221344,29.904011594959304,59.97923107692308,59.033787336717204,-70.0959884050407
2019-05-21,57.4245,57.635399,56.896999,57.481499,57.481499,23196000,2033822901.7274973,587344297,23.061669815599277,-48.0,-0.7862467535266902,43.0538678489458,44.435400860239845,59.84800023076923,58.91880301547889,-55.564599139760155
2019-05-22,57.337502,57.925999,57.294498,57.570999,57.570999,18290000,2031549355.5098352,605634297,22.220054345410173,-48.0,-0.772802843962495,43.53385334378823,46.848321389152055,59.714000192307694,58.81896568099897,-53.151678610847945
2019-05-23,57.025002,57.298649,56.461201,57.038502,57.038502,23978000,2040630180.3634381,581656297,22.032680732296804,-48.0,-0.795941389529446,41.30322771991272,32.492199122290046,59.54792338461538,58.68707948240646,-67.50780087770995
2019-05-24,57.368,57.488251,56.583,56.6735,56.6735,22240000,2022836947.0612931,559416297,21.666852262628556,-48.0,-0.8341162911613296,39.79792860053821,22.77763665597891,59.35009642307693,58.53792544667265,-77.22236334402109
2019-05-28,56.700001,57.57935,56.655998,56.7075,56.7075,27300000,1998582382.821437,586716297,21.23123415528749,-48.0,-0.8518075526545488,40.01722611922799,24.455149930106028,59.153519461538465,58.40233837654875,-75.54485006989398
2019-05-29,56.375999,56.455002,55.410999,55.823002,55.823002,30764000,1992099654.603223,555952297,21.698832145301203,-84.0,-0.9265192640506115,36.311532705256276,10.307800696622255,58.898942576923076,58.21127642273032,-89.69219930337775
2019-05-30,55.777,56.156502,55.605999,55.897499,55.897499,19038000,1993223495.6831083,574990297,22.13303027888537,-84.0,-0.9685526759529424,36.84202285990859,12.171622631162215,58.617019423076925,58.03988550252808,-87.82837736883779
2019-05-31,55.064499,55.48,55.008999,55.181499,55.181499,30156000,1985156238.5944824,544834297,22.920199484805266,-92.0,-1.0475640080592825,33.91784550155285,3.921343977565811,58.32400019230769,57.82815316900748,-96.07865602243419
2019-06-03,53.275002,53.275002,51.25,51.811501,51.811501,102612000,1939449605.2183177,442222297,25.25271967268924,-96.0,-1.366361171298628,24.1871122611266,6.882825829513871,57.887038653846155,57.382475230562484,-93.11717417048612
2019-06-04,52.145,52.802502,51.684502,52.6525,52.6525,56670000,1980912783.5009658,498892297,27.418631275724355,-96.0,-1.5334717217420035,29.614038009828363,17.191711547963816,57.465634769230775,57.032106694965265,-82.80828845203618
2019-06-05,52.577,52.677502,51.524502,52.111,52.111,43368000,1981664896.7082512,455524297,29.481521296523205,-92.0,-1.6901199111578364,28.21362113503858,10.554056073295373,56.993788692307696,56.66758027311598,-89.44594392670463
2019-06-06,52.2495,52.3745,51.685001,52.216999,52.216999,34064000,2000166541.8273888,489588297,31.397062030122136,-76.0,-1.7851335876385335,28.922189465826705,12.465343216242362,56.71659634615385,56.3379075862185,-87.53465678375764
2019-06-07,52.531502,53.546001,52.419998,53.301998,53.301998,36048000,2020591457.0860515,525636297,31.81921846235279,-76.0,-1.7526784727714002,35.89696935606234,30.736942890494717,56.52036553846154,56.113025394646755,-69.26305710950528
2019-06-10,53.648998,54.632999,53.6161,54.019001,54.019001,29284000,2014512422.1494453,554920297,31.149331069268847,-76.0,-1.6500803118610037,40.081382592562015,41.476953486661756,56.36223092307692,55.95791247652477,-58.52304651333824
2019-06-11,54.699001,55.099499,53.88015,53.936001,53.936001,28734000,1988410683.5184216,526186297,30.110506268990378,-76.0,-1.557513885941347,39.75784803387648,40.23369386364496,56.15707711538461,55.80814125604145,-59.76630613635505
2019-06-12,53.900002,54.046501,53.376999,53.851501,53.851501,21220000,1997269555.3963249,504966297,29.458316143871176,-72.0,-1.4739816276174977,39.409079278441546,41.102182688585714,55.9410001923077,55.663204940779124,-58.897817311414286
2019-06-13,54.181999,54.7085,54.0075,54.438499,54.438499,21154000,2002127974.3578084,526120297,28.25492634594584,-44.0,-1.344912563373832,43.14056543466231,50.37640516008755,55.77690392307692,55.5724859822029,-49.62359483991245
2019-06-14,54.320999,54.634499,54.008598,54.267502,54.267502,22230000,1998288857.0053837,503890297,27.137492962158028,-44.0,-1.242104224568969,42.32288039346192,47.67475333170075,55.621288653846165,55.47582050203972,-52.32524666829925
2019-06-17,54.313999,54.959,54.313999,54.625,54.625,18832000,1997617358.5611951,522722297,25.79551594692042,-44.0,-1.1188829879034117,44.68349328637054,64.84147364400629,55.486904076923075,55.41279676114789,-35.15852635599372
2019-06-18,55.484501,55.8195,54.949501,55.18,55.18,27734000,1984579143.8804886,550456297,24.111296324830114,-44.00000000000001,-0.965317825411546,48.22620078282979,80.09779676029883,55.370230961538454,55.39555255661841,-19.902203239701173
2019-06-19,55.279999,55.349998,54.674,55.116501,55.116501,26776000,1992857705.5093691,523680297,22.468252636170437,-44.0,-0.8390679137679342,47.84862114677677,84.61540649961705,55.313115576923074,55.374882070942974,-15.384593500382946
2019-06-20,55.9995,56.006001,55.237,55.570999,55.570999,25240000,1989542604.852803,548920297,21.340242849003353,-44.0,-0.6943358871096237,50.81681290778957,90.85361840756556,55.29576942307692,55.38940925087312,-9.14638159243443
2019-06-21,55.462002,56.205502,55.403999,56.094002,56.094002,38952000,2017657095.8228931,587872297,20.4567630264407,-44.0,-0.5313081524102685,54.057225182530246,97.61803033539843,55.21436569230769,55.441601306364,-2.381969664601568
2019-06-24,55.980499,56.099998,55.550499,55.776001,55.776001,27912000,2012654006.7544873,559960297,19.636388905489664,-40.0,-0.422892677618357,51.821578214266026,90.82458876308478,55.09232723076923,55.46637165404074,-9.17541123691522
2019-06-25,55.632999,55.717499,54.189999,54.317501,54.317501,30938000,1986880860.2746181,529022297,18.860552892322364,-28.0,-0.4494800671390138,43.031401634836655,58.23469566758194,54.9462695,55.3812701241118,-41.765304332418054
2019-06-26,54.325001,54.648499,53.612,53.990002,53.990002,36218000,1977079627.5575578,492804297,18.591972301017467,-28.0,-0.4913136393601647,41.33588358386983,41.47410754287926,54.83271184615384,55.27821322602944,-58.52589245712074
2019-06-27,54.200001,54.355,53.7645,53.800499,53.800499,20086000,1959442656.9021814,472718297,18.34257603766292,-28.000000000000004,-0.5336072627316,40.34527875506978,14.972584437775158,54.69113492307693,55.16875291299022,-85.02741556222485
2019-06-28,53.8195,54.049999,53.668499,54.045502,54.045502,33864000,1992508300.8969388,506582297,18.190927313032006,-16.0,-0.5411178991310805,42.271488479062846,23.634516208750707,54.55553888461539,55.08554914165761,-76.36548379124929
2019-07-01,54.900002,55.379002,54.68515,54.897499,54.897499,28726000,1981365120.7893658,535308297,17.096431883347528,-16.0,-0.4728701424739157,48.4991435230685,53.75635097434943,54.47319261538462,55.071619501534826,-46.24364902565057
2019-07-02,55.112,55.588501,54.908501,55.5625,55.5625,19832000,1999680497.7540717,555140297,16.268306998496765,-16.0,-0.36096233150349377,52.78088957569218,75.20719089478233,54.43046184615385,55.10798101993965,-24.792809105217675
2019-07-03,55.870499,56.338001,55.693001,56.078999,56.078999,15340000,2002700836.7308161,570480297,16.137987219887737,-12.0,-0.22796954135283443,55.85103436466124,90.49882960424462,54.40628873076923,55.17990827772189,-9.50117039575538
2019-07-05,55.889999,56.644001,55.806999,56.579498,56.579498,25286000,2024089539.3336773,595766297,16.26105473294353,92.0,-0.08124912124787897,58.65626865394262,97.87259304993627,54.43538473076923,55.28358159048324,-2.1274069500637354
2019-07-08,56.258499,56.299,55.560501,55.817501,55.817501,24728000,2016572384.5751739,571038297,16.09340751617292,92.0,-0.026157394712676307,53.12202866115788,72.74077416201371,54.43230788461539,55.323131176373366,-27.25922583798629
2019-07-09,55.59,56.401249,55.358501,56.241501,56.241501,26608000,2035027744.082936,597646297,15.704167196542395,92.0,0.05112709068911414,55.63058870666828,86.72493841525768,54.47307719230769,55.39115857071608,-13.27506158474233
2019-07-10,56.561001,57.102501,56.5485,57.023998,57.023998,24190000,2052362205.6633306,621836297,15.961308172824205,96.0,0.17351638163708571,59.895857759446976,97.75095322992321,54.67355784615385,55.51210963955192,-2.2490467700767853
2019-07-11,57.162498,57.6535,56.979,57.210499,57.210499,23910000,2044864781.171114,645746297,16.63695279269645,100.0,0.28230560523863346,60.861573464287154,89.038698503031,54.848865499999995,55.63791625884437,-10.961301496969009
2019-07-12,57.199501,57.367001,56.938999,57.244999,57.244999,17280000,2052293450.75677,663026297,17.211564466927943,96.0,0.3670743062912578,61.04842972176249,89.89234195224542,55.046327000000005,55.7569594248559,-10.107658047754576
2019-07-15,57.342999,57.541,56.970001,57.516998,57.516998,18076000,2068849797.8256793,681102297,17.88960351515832,92.0,0.4510032737109384,62.56584755756055,96.62249164914017,55.25017311538462,55.88733265264435,-3.377508350859833
2019-07-16,57.299999,57.929001,57.25,57.679001,57.679001,24776000,2075381347.5229552,705878297,18.836378919297704,92.0,0.5245432650088517,63.47842585272881,94.208942735941,55.41851938461538,56.02004882652255,-5.791057264059011
2019-07-17,57.5485,57.917999,57.288502,57.317501,57.317501,23400000,2054137280.275613,682478297,19.715527508855704,92.0,0.5473447594444352,59.96546534929958,85.64723124176449,55.54538476923077,56.11615639492829,-14.352768758235511
2019-07-18,57.087002,57.380249,56.636501,57.316502,57.316502,25814000,2075526219.4808278,656664297,19.542696117420046,92.0,0.5588919387379008,59.95559076833479,85.62378330065332,55.67540403846154,56.205070884192864,-14.376216699346681
2019-07-19,57.4095,57.556999,56.480999,56.505001,56.505001,32944000,2044051962.7670734,623720297,19.558880130709962,52.0,0.4968346126716625,52.40625340026698,56.101559535256094,55.777461730769225,56.22728792980821,-43.898440464743906
2019-07-22,56.672501,56.962502,56.212002,56.9035,56.9035,26030000,2065989165.8050482,649750297,19.17417285898162,52.0,0.47434136162066665,55.3776103785658,66.04863433206427,55.872269461538465,56.27737771278538,-33.95136566793574
2019-07-23,57.200001,57.345001,56.59,57.310501,57.310501,21874000,2085864087.6581318,671624297,19.226304633357017,52.0,0.4837801608072638,58.24487421438098,75.93853335926875,55.989307884615386,56.35390536369017,-24.061466640731247
2019-07-24,56.595001,57.200001,56.349499,56.890499,56.890499,31796000,2094518635.6874132,639828297,18.904219062845872,52.0,0.45215763412089416,54.36285521057075,59.59922194125656,56.07644246153847,56.393653040453856,-40.40077805874344
2019-07-25,56.890999,57.084999,56.046001,56.605999,56.605999,44196000,2097964058.6891897,595632297,18.150162776676947,52.0,0.39953420000340856,51.84228014586982,48.53133631589181,56.131288576923076,56.40938237079061,-51.46866368410819
2019-07-26,61.202,63.2775,61.200001,62.5205,62.5205,96116000,2124034477.92116,691748297,21.047745795437113,84.0,0.8255639630167337,76.37067739157932,90.44071100400437,56.416057769230775,56.86205775073205,-9.559288995995635
2019-07-29,62.052502,62.3685,61.411499,61.970501,61.970501,44474000,2131516651.317008,647274297,23.738358598571548,84.0,1.1060652649443625,72.66427413799403,81.92630601207296,56.66219246153847,57.24046095438153,-18.073693987927033
2019-07-30,61.2705,61.7435,61.165001,61.257,61.257,29066000,2111695413.8282657,618208297,25.956275602318183,84.0,1.2563090511845942,68.05031707750186,72.05973477974618,56.86076930769231,57.537982365168084,-27.94026522025383
2019-07-31,61.150002,61.700001,60.388199,60.834,60.834,34510000,2100641076.359654,583698297,27.15926552534634,84.0,1.3259609173137292,65.39904393222054,66.21032513452609,57.05530773076923,57.782131819600075,-33.78967486547392
2019-08-01,60.7015,61.705502,60.285999,60.4505,60.4505,33970000,2074544393.9503882,549728297,28.165589788513675,84.0,1.3348282093828345,63.00246601761484,60.90713695735832,57.29119230769231,57.97978872185192,-39.092863042641675
2019-08-02,60.036999,60.345001,59.446999,59.699501,59.699501,32902000,2060145294.3982713,516826297,28.21645191315037,76.0,1.2666550483613932,58.4827938092281,50.522028696954784,57.510788423076924,58.10717481652955,-49.47797130304522
2019-08-05,58.501999,58.762001,57.007,57.616001,57.616001,51950000,2044249521.0910196,464876297,26.28220978160292,76.0,1.0326030840470324,48.16044148052038,21.710574806136304,57.6575385,58.07079157086069,-78.28942519386369
2019-08-06,58.165501,58.998001,58.0,58.497501,58.497501,34188000,2044146785.9113955,499064297,24.640981342239964,72.0,0.9077805697375254,52.01906797777353,33.90030199824408,57.82876923076923,58.10239967672286,-66.09969800175593
2019-08-07,57.799999,58.922249,57.481201,58.699501,58.699501,28886000,2064102758.9754434,527950297,23.009005866593697,68.0,0.8157540349396157,52.88453136354976,36.69363710068962,57.975000076923074,58.146629404373016,-63.306362899310386
2019-08-08,59.141499,60.2505,58.651001,60.240002,60.240002,29360000,2093077361.6979206,557310297,22.10828962862706,52.0,0.8572460998707214,58.96369174935714,57.99628818312768,58.154903999999995,58.30169404108612,-42.00371181687232
2019-08-09,59.899502,60.194,59.180149,59.400501,59.400501,21314000,2081028199.4857216,535996297,21.27191026480089,52.0,0.8130162008865867,54.813114667309414,46.3873396096715,58.28265407692307,58.383087149153816,-53.6126603903285
2019-08-12,58.960499,59.248001,58.383598,58.7355,58.7355,20060000,2077301215.7293024,515936297,19.888877203882682,52.00000000000001,0.7160494914159727,51.708069618480096,37.19144536976363,58.365577230769226,58.40919180477206,-62.80855463023638
2019-08-13,58.573002,60.238998,58.573002,59.863499,59.863499,25888000,2091519418.0683234,541824297,19.259078580094183,52.0,0.7219011407889653,56.23667837149389,52.789857261959064,58.521192538461534,58.51691826367783,-47.21014273804094
2019-08-14,58.815498,59.115002,58.027,58.2145,58.2145,31574000,2070827980.7842007,510250297,18.25765455284837,4.0,0.5867148929667962,49.00227326138327,19.256837572761377,58.597077115384614,58.494516910812806,-80.74316242723863
2019-08-15,58.174999,58.792,58.105499,58.362999,58.362999,24374000,2064738892.240994,534624297,17.32776081326297,4.0,0.4859596060067872,49.630674623670195,25.291410985731684,58.648577153846155,58.484774843345186,-74.70858901426831
2019-08-16,58.977501,59.136002,58.5905,58.880001,58.880001,26266000,2066351922.0740654,560890297,16.71440338514361,4.0,0.44272460219472975,51.854963539602096,39.54398817692394,58.71278876923077,58.51405085494925,-60.456011823076054
2019-08-19,59.504501,60.349499,59.504501,59.922501,59.922501,24632000,2066089627.0911186,585522297,16.94727665064823,4.0,0.4869681222599951,56.06781716344392,62.05171350358042,58.81576961538462,58.61838049532337,-37.948286496419584
2019-08-20,59.762501,59.803001,59.105499,59.134499,59.134499,18310000,2049302174.6967165,567212297,16.805579855512928,3.9999999999999964,0.4532217961315226,52.33968023952741,45.28036808327416,58.87798119230769,58.656611495669786,-54.71963191672584
2019-08-21,59.657501,59.950001,59.371498,59.5625,59.5625,14814000,2044270331.8436975,582026297,16.77302140589395,4.0000000000000036,0.4557599759894799,54.12397315638298,76.4547723125721,58.95042346153846,58.723714347842396,-23.5452276874279
2019-08-22,59.703499,59.9006,58.929001,59.476501,59.476501,18950000,2046677136.4513597,563076297,16.325646937425105,4.0,0.4456944134737597,53.68903441442123,73.88187700280534,59.03346192307692,58.77947632207629,-26.118122997194664
2019-08-23,59.099499,59.703999,57.387501,57.564499,57.564499,33740000,2018093119.767555,529336297,15.659689826923412,4.0,0.2802047743121676,45.025809697835136,5.975628612848404,59.043000269230774,58.68947800192249,-94.02437138715159
2019-08-26,57.862999,58.473499,57.647999,58.4445,58.4445,24522000,2040892252.4677367,553858297,15.04130108145755,4.0,0.2175539427831481,49.09696066571746,35.685338072476654,59.11759638461539,58.67133148326156,-64.31466192752335
2019-08-27,59.026501,59.119999,58.072498,58.391998,58.391998,21544000,2032490594.0979595,532314297,14.013712113162649,4.0,0.1618010925221398,48.86445753079753,33.91281830710217,59.174846307692306,58.65064011413108,-66.08718169289783
2019-08-28,58.085499,58.820999,57.865002,58.550999,58.550999,16040000,2039470314.620095,548354297,13.13948510619427,4.0,0.12896003784446464,49.64222439154822,39.28085029091838,59.22255776923077,58.643259290862105,-60.71914970908162
2019-08-29,59.056,59.803001,59.056,59.642502,59.642502,21768000,2051884264.9414465,570122297,12.870554036492615,4.0,0.18883170112724912,54.73230552242131,76.13107773874253,59.328404038461535,58.71727726931677,-23.868922261257467
2019-08-30,59.924999,59.924999,59.190151,59.404999,59.404999,22596000,2042501080.1304379,547526297,12.714335191204759,-24.0,0.21464166294565246,53.46592534657336,68.11274011663733,59.43605788461538,58.76821961973775,-31.88725988336267
2019-09-03,58.851501,59.344501,58.16,58.419498,58.419498,29598000,2025871615.9172375,517928297,11.960955644973087,-20.0,0.15380161977835627,48.45590256079125,34.84124567268433,59.27832703846153,58.74238838864606,-65.15875432731566
2019-09-04,58.835499,59.174,58.549999,59.070499,59.070499,21378000,2040157818.3784513,539306297,11.26138892347225,-16.0,0.15631389798314643,51.677152344620644,56.81968725164558,59.1667885,58.766692878375984,-43.18031274835442
2019-09-05,59.5765,60.652,59.5765,60.569,60.569,28162000,2063973103.36218,567468297,11.483772595988977,-8.0,0.2760393934657088,58.15911325839567,97.45749654081688,59.140326961538456,58.9001971096074,-2.542503459183121
2019-09-06,60.406502,60.60075,60.126099,60.246498,60.246498,21442000,2053408970.92382,546026297,11.690271720468795,-8.0,0.34096901649660083,56.40549381189292,87.57843087101578,59.11773073076923,58.999923101488335,-12.421569128984215
2019-09-09,60.200001,61.0,59.631001,60.220501,60.220501,29438000,2049323364.8992722,516588297,11.398553723505115,96.0,0.38588028221600723,56.25823571273045,78.42216703727803,59.10888461538461,59.09033627915586,-21.577832962721963
2019-09-10,59.7575,60.5,59.729,60.299999,60.299999,25202000,2061450331.9498558,541790297,11.127672726324557,96.0,0.4230113960164914,56.63110260023106,80.62280432465171,59.1319806923077,59.17994092514432,-19.377195675348293
2019-09-11,60.170502,61.130001,60.110001,61.008499,61.008499,26140000,2081362758.8518167,567930297,11.406213674873218,48.0,0.503800600321533,59.91093592272042,96.75345357381431,59.262461384615385,59.31538967142993,-3.246546426185693
2019-09-12,61.215,62.092999,61.151001,61.712502,61.712502,34518000,2087995358.9974647,602448297,12.373639283414219,52.0,0.6175154515540129,62.912325271623594,91.91377830784333,59.386115269230764,59.4929535476203,-8.086221692156673
2019-09-13,61.567501,62.043999,61.350498,61.978001,61.978001,26028000,2109069376.3961418,628476297,13.27196306277372,52.0,0.7207504780004896,64.00676136869747,97.41286839145107,59.51221142307692,59.677031136685464,-2.5871316085489298
2019-09-16,61.476002,61.978001,61.280499,61.564999,61.564999,21066000,2105188350.7761436,607410297,14.019114661893978,52.0,0.7604729120767857,60.9916382510852,87.51181706136502,59.563172846153854,59.8168806080421,-12.488182938634973
2019-09-17,61.52,61.75,61.184502,61.4575,61.4575,19102000,2104529591.2332275,588308297,14.587457746497313,52.0,0.7743527004604758,60.196780497955885,84.96926558840994,59.642288192307696,59.93840797040935,-15.030734411590062
2019-09-18,61.3755,61.780499,60.8265,61.620499,61.620499,22702000,2119616656.6263778,611010297,14.645347541313203,52.0,0.7894054155706556,61.02616788236653,87.9862669682856,59.75324969230769,60.06300730593458,-12.01373303171438
2019-09-19,61.603001,62.222,61.601002,61.935501,61.935501,19920000,2121156371.7301302,630930297,15.102991332617957,72.0,0.8173311448954834,62.64606930483991,92.94684884293454,59.83294207692308,60.20171054253202,-7.053151157065456
2019-09-20,61.655998,62.166,61.153999,61.496498,61.496498,45400000,2106486488.7952323,585530297,14.940634214023806,72.0,0.794875780179666,58.967594795772506,82.13929098966032,59.95917276923077,60.297620724566684,-17.860709010339683
2019-09-23,61.299999,61.954498,61.2085,61.7015,61.7015,21248000,2113322381.7815406,606778297,14.789874032472095,72.0,0.7845775681637974,60.14448946114418,85.82516725894142,60.08757665384615,60.401611782006185,-14.174832741058571
2019-09-24,62.0,62.337002,60.534,60.938,60.938,31664000,2095848333.8725533,575114297,13.79366850897553,84.0,0.7066621306224334,53.93934477130179,49.320739488687266,60.166730461538464,60.44134424259832,-50.679260511312734
2019-09-25,60.791,62.415001,60.504501,62.326,62.326,29060000,2122200802.7969189,604174297,12.961104099639924,88.0,0.7482877891798054,61.67953965771668,96.80312500000012,60.25917273076924,60.58094837277622,-3.1968749999998614
2019-09-26,62.098,62.25,61.6134,62.0695,62.0695,30760000,2135517573.139363,573414297,12.188008576685432,88.0,0.7519114499962143,59.68354674764496,87.58976293103453,60.37205738461538,60.691211456274274,-12.410237068965476
2019-09-27,62.150501,62.201,60.7225,61.254501,61.254501,27078000,2127926246.2242463,546336297,12.240581722443071,88.0,0.6811675437982743,53.73353685173961,56.794506033318676,60.43713434615385,60.732936607661365,-43.205493966681324
2019-09-30,61.0485,61.299999,60.615002,60.950001,60.950001,28082000,2127311350.2203224,518254297,12.406342460519898,88.0,0.5936882150813929,51.66128207783803,36.44251626898063,60.49380742307692,60.7490154515383,-63.55748373101937
2019-10-01,60.950001,61.561501,60.179001,60.255001,60.255001,25470000,2104641668.4843369,492784297,13.023416270648008,84.0,0.462943006370665,47.18813925934186,3.3989266547406354,60.597288269230766,60.712421788461384,-96.60107334525937
2019-10-02,59.848999,59.848999,58.564499,58.831501,58.831501,32302000,2085768549.1445162,460482297,14.906671666020818,76.0,0.24167604220846073,39.62101988076739,6.934212733820296,60.612172923076926,60.573094322649425,-93.0657872661797
2019-10-03,59.0,59.452999,58.121498,59.391499,59.391499,32424000,2115197318.949421,492906297,16.933537022865877,76.0,0.11023679630121563,43.4620811856562,29.57959968818008,60.65061526923076,60.485568743193916,-70.42040031181992
2019-10-04,59.594501,60.571999,59.4585,60.450001,60.450001,23248000,2133351089.8499787,516154297,17.293151862594105,-24.0,0.09043997633057899,49.94410453575614,54.2331751020088,60.723653807692315,60.48293409554992,-45.7668248979912
2019-10-07,60.220001,60.910198,60.1875,60.383999,60.383999,16858000,2125660349.5960968,499296297,17.22473858474866,-24.0,0.06863387548370525,49.562534400849735,52.69592218754717,60.75217292307692,60.475605569953636,-47.30407781245283
2019-10-08,59.879501,60.304001,59.4505,59.456501,59.456501,20786000,2105166644.0069997,478510297,17.745572194834704,-24.0,-0.02322127333344781,44.42602411562507,31.09356159760462,60.754153769230776,60.40011634254966,-68.90643840239538
2019-10-09,59.967499,60.4175,59.8815,60.115501,60.115501,17354000,2102965081.8950596,495864297,18.08726889274829,-24.0,-0.04235312755391618,48.50922895409242,46.4423339170836,60.819384653846164,60.37903372458302,-53.5576660829164
2019-10-10,59.929001,60.75,59.867001,60.433498,60.433498,16932000,2107758875.9310665,512796297,17.98503840835748,-23.999999999999993,-0.03149253325310042,50.40291568829851,53.848803645880785,60.87180769230769,60.38306811535465,-46.151196354119215
2019-10-11,61.1105,61.419498,60.687,60.772499,60.772499,25454000,2088246985.1136177,538250297,17.105566753849107,-24.0,0.004418183458405167,52.41218053821381,61.744477644478295,60.87963457692308,60.4119148475506,-38.25552235552171
2019-10-14,60.617001,61.316502,60.588001,60.856998,60.856998,17350000,2083709865.1233912,555600297,16.38844387469061,-24.0,0.03924367166874276,52.92411551473611,63.712544279111924,60.903115346153854,60.44488396995426,-36.28745572088808
2019-10-15,61.02,62.366501,61.02,62.150501,62.150501,27634000,2102478006.1303418,583234297,15.817199375096283,-24.0,0.16926680150113782,60.0152252390959,94.91166437338204,60.97734611538461,60.57122597217987,-5.088335626617961
2019-10-16,62.058498,62.737,61.922501,62.181999,62.181999,21892000,2094535514.2721565,605126297,15.62706332257231,36.0,0.27172046958633445,60.17255049050609,87.97528416193938,61.049730730769234,60.690542492759135,-12.024715838060613
2019-10-17,62.546501,63.166248,62.497002,62.6535,62.6535,19048000,2084395969.1721482,624174297,15.828494624792894,40.0,0.38650652327603296,62.54808905633758,89.83600773080923,61.11299999999999,60.835946752554754,-10.16399226919078
2019-10-18,62.673,62.9445,62.054001,62.274502,62.274502,27056000,2070738917.52807,597118297,15.478902717844903,39.99999999999999,0.4418005251893078,59.47716664013659,82.32328658506358,61.13461538461539,60.942506400513665,-17.676713414936412
2019-10-21,62.612999,62.731449,62.029999,62.307499,62.307499,20544000,2066449704.0417204,617662297,15.125064142253809,40.0,0.482719512156244,59.66285393460389,82.97737251598191,61.147288384615386,61.04361696343858,-17.0226274840181
2019-10-22,62.392502,62.529999,62.069,62.139999,62.139999,20476000,2052280769.8878503,597186297,14.796499750633506,40.0,0.4959156471057682,58.204824122496866,79.65708905297586,61.16940376923076,61.12483044762832,-20.34291094702413
2019-10-23,62.118,62.994499,62.118,62.956501,62.956501,18230000,2068930155.3292487,615416297,14.97989319939864,40.0,0.5657371015863859,62.95703056210484,94.35518770379477,61.22705765384615,61.260509747804,-5.644812296205228
2019-10-24,63.044998,63.200001,62.685749,63.0495,63.0495,20562000,2077456804.715153,635978297,15.357584761654948,60.0,0.6214120975289035,63.46655553097992,95.98610588448975,61.28201923076923,61.393027544262964,-4.01389411551026
2019-10-25,62.551498,63.48,62.5005,63.2565,63.2565,24262000,2090646712.8315392,660240297,15.987528201662482,64.0,0.6744633097627428,64.63266354985718,94.45340612979292,61.332826884615386,61.53106254098422,-5.546593870207081
2019-10-28,63.772499,64.9655,63.626999,64.5,64.5,52264000,2106558267.8202913,712504297,17.757634748735246,68.0,0.807538039464319,70.68586782941475,90.86986189464771,61.448346192307696,61.75098383424465,-9.13013810535229
2019-10-29,63.811501,64.079498,62.8606,63.131001,63.131001,37728000,2085569468.1930869,674776297,18.31132773626381,68.0,0.7933882574417481,58.76189919332867,64.01884162377974,61.503327000000006,61.8532073280043,-35.98115837622027
2019-10-30,62.648499,63.467999,62.599998,63.064499,63.064499,28178000,2087549749.526864,646598297,18.483186444990174,68.0,0.7679557814133204,58.24787380844276,56.57335387169695,61.585115423076914,61.942932637041025,-43.42664612830305
2019-10-31,63.063999,63.383499,62.542149,63.005501,63.005501,29114000,2090503331.69362,617484297,18.56477968168056,68.0,0.7345720263322164,57.765102383035035,55.22559799556779,61.61125007692307,62.02164140466761,-44.77440200443221
2019-11-01,63.25,63.730999,63.025002,63.687,63.687,33402000,2119741986.5292637,650886297,18.957892155050683,68.0,0.7544100640740012,61.71266670628308,67.5959954378404,61.67346161538462,62.14500130061816,-32.40400456215961
2019-11-04,63.822498,64.706497,63.817749,64.568497,64.568497,30020000,2140439298.8832715,680906297,20.0995012777466,68.0,0.8316742695517618,66.1232839638571,86.95356127294123,61.800923,62.32451950057238,-13.046438727058769
2019-11-05,64.644501,64.946503,64.561447,64.601501,64.601501,25654000,2120122420.320153,706560297,21.329423180989476,68.0,0.8853639317403079,66.2799098007041,87.60010642135686,61.94136530769231,62.49318479682628,-12.399893578643159
2019-11-06,64.473,64.686501,64.125,64.589996,64.589996,23060000,2135255790.4477212,683500297,21.81630153034064,68.0,0.9164210866545233,66.16506916195596,87.20818013688276,62.10809588461538,62.648504145209515,-12.791819863117244
2019-11-07,64.713997,66.186996,64.71225,65.443001,65.443001,40600000,2134891180.9488652,724100297,23.28606360291047,100.0,0.9983560531923885,70.27708457297774,82.10258511131958,62.362384346153846,62.85550391223103,-17.897414888680427
2019-11-08,65.264,65.900002,65.218246,65.568497,65.568497,25028000,2135579366.8804886,749128297,24.650842670296743,88.0,1.0611839152583329,70.83859886867164,84.98058278832711,62.599961192307696,63.056466363176874,-15.019417211672893
2019-11-11,65.158997,65.321251,64.870499,64.959503,64.959503,20238000,2123333624.0507288,728890297,25.4035163886001,88.0,1.049734041774279,64.47332233948589,69.83302514920146,62.77340357692307,63.19743203997859,-30.16697485079853
2019-11-12,65.0,65.5,64.788498,64.940002,64.940002,21718000,2110864688.3456993,707172297,26.22855839497245,88.0,1.0272449267451904,64.27415768886107,66.17400371518131,62.94863446153847,63.32651129627647,-33.82599628481869
2019-11-13,64.703499,65.214996,64.675499,64.900002,64.900002,16534000,2108091404.7241037,690638297,26.81652278873014,80.0,0.994727871645523,63.83854254990817,65.08896252701763,63.15799988461538,63.44306616321896,-34.911037472982365
2019-11-14,64.875,65.849998,64.782501,65.572998,65.572998,23870000,2119573566.6318185,714508297,27.82720598302952,80.0,1.0116019068620759,67.79354429262025,83.15435462723136,63.36790361538461,63.60083889186941,-16.84564537276864
2019-11-15,65.946999,66.744003,65.713997,66.7435,66.7435,35652000,2155190745.5608726,750160297,29.31732172259573,96.0,1.1066674568823132,73.26941910072951,99.9880290938236,63.610596,63.83362860358279,-0.01197090617639317
2019-11-18,66.611,66.776451,65.875,66.035004,66.035004,29748000,2136003051.0949504,720412297,30.719646007826068,100.0,1.112019218785548,65.95911683113067,82.48951066787406,63.81300003846153,63.99669344776184,-17.510489332125935
2019-11-19,66.385002,66.385002,65.639999,65.773003,65.773003,25384000,2119682567.7143466,695028297,31.615766027805158,96.0,1.0826392462734447,63.43845037606073,76.3019265040615,64.00207715384614,64.12827193311281,-23.69807349593849
2019-11-20,65.586998,65.75,64.557503,65.152496,65.152496,26172000,2119627458.2323103,668856297,30.818917034863432,92.0,0.9977838461995816,57.80429194210032,56.71126010242981,64.11753850000001,64.20414038251187,-43.28873989757019
2019-11-21,65.073997,65.629501,64.650002,65.067497,65.067497,19910000,2116690064.5341034,648946297,30.078985827131827,80.0,0.9131503920539643,57.05675039123788,42.23973891253684,64.22851919230769,64.26809272454803,-57.76026108746316
2019-11-22,65.280998,65.436501,64.570503,64.766998,64.766998,27714000,2101552681.1775596,621232297,29.276808813528483,80.0,0.8124644277854287,54.37929218785457,24.21308181821962,64.30980757692308,64.3050486708778,-75.78691818178038
2019-11-25,64.959,65.565498,64.906502,65.334503,65.334503,20724000,2107748094.1148152,641956297,28.664330685270567,80.0,0.7695916132982745,58.35395904229385,45.6166453764373,64.42749992307692,64.38130454710907,-54.3833546235627
2019-11-26,65.492996,65.739998,65.254501,65.677498,65.677498,21394000,2123633821.1491737,663350297,28.27800705859451,76.0,0.7545929510841489,60.58887076293456,50.47414360318513,64.55711526923076,64.47731887695284,-49.52585639681487
2019-11-27,65.75,65.917999,65.481499,65.649498,65.649498,19912000,2119049180.0861723,643438297,28.1065774411289,72.0,0.7320088943513241,60.304365484051445,49.21228437980513,64.692096,64.56414696014151,-50.78771562019487
2019-11-29,65.356003,65.510246,65.198502,65.248001,65.248001,11740000,2111037356.153715,631698297,27.450464655324645,64.0,0.6739446003942504,56.22724774596556,31.118259643759384,64.78023061538461,64.61480281494585,-68.88174035624061
2019-12-02,65.050003,65.291496,64.050003,64.496002,64.496002,30218000,2102530630.856029,601480297,25.79083320204813,64.0,0.5607838276313544,49.47962843581735,16.35824339947074,64.83586530769232,64.60600275457949,-83.64175660052926
2019-12-03,63.9785,64.92305,63.950001,64.764,64.764,22876000,2117928224.7325962,624356297,24.372326742965388,48.0,0.4871131614766,51.70403206208713,28.799341930690343,64.89384607692307,64.61770625424028,-71.20065806930965
2019-12-04,65.350502,66.290001,65.2435,66.027,66.027,30750000,2133222375.6698623,655106297,23.786890698577302,48.00000000000001,0.5245949682046103,60.525156625649785,73.48437085389817,64.95257684615385,64.72209838355582,-26.515629146101823
2019-12-05,66.400002,66.467903,65.821999,66.406502,66.406502,24254000,2152865102.619997,679360297,23.413429865911535,48.0,0.5782564296786461,62.728036208023035,86.91117833324516,65.07855765384615,64.84686902181095,-13.088821666754832
2019-12-06,66.671997,67.199997,66.671997,67.030998,67.030998,26296000,2162327777.983633,705656297,23.7173514219018,100.0,0.6635264131163865,66.0822985793298,94.80002436926077,65.2311153076923,65.00865635352865,-5.199975630739227
2019-12-09,66.902,67.972504,66.891998,67.178001,67.178001,27086000,2149580758.5316353,732742297,24.58223167081136,100.0,0.7344985606745382,66.83882804110044,80.24854176615888,65.39159607692308,65.16934854956357,-19.751458233841117
2019-12-10,67.074997,67.498749,66.802002,67.233002,67.233002,21882000,2154770685.6443458,754624297,25.249978671797553,96.0,0.7861207097793681,67.13420232478427,81.61587449406497,65.52798076923077,65.32221176811441,-18.384125505935025
2019-12-11,67.542,67.559998,67.133499,67.250999,67.250999,17008000,2147134055.799961,771632297,25.917797545158123,16.0,0.8190424310463555,67.23703714533073,82.06328248853991,65.63115392307692,65.46508489640223,-17.936717511460092
2019-12-12,67.296997,67.78875,67.025002,67.513496,67.513496,25620000,2154287212.076639,797252297,26.720657655658247,16.0,0.85644191715528,68.7718357078125,88.58899545879774,65.74315373076924,65.61681905222429,-11.41100454120226
2019-12-13,67.397499,67.654648,67.193497,67.391502,67.391502,30992000,2149909362.148959,766260297,27.466170615408355,16.0,0.8662517718884288,67.19635623678815,85.55620716752733,65.85090396153846,65.74827704835582,-14.443792832472665
2019-12-16,67.824997,68.234001,67.633499,68.058502,68.058502,27946000,2161520711.9596176,794206297,28.621047734985304,36.0,0.9172737176549788,71.09526576716532,95.90338468720817,65.95150015384615,65.91940482255168,-4.096615312791826
2019-12-17,68.144501,68.25,67.566147,67.755997,67.755997,37080000,2145028873.4504635,757126297,29.562740915109266,40.0,0.9226634618577805,67.19453113847332,88.51155546780345,66.03563476923077,66.05544868754785,-11.488444532196553
2019-12-18,67.830002,68.023499,67.550003,67.630997,67.630997,30452000,2124994825.39937,726674297,30.40397296633891,39.99999999999999,0.9064000026222772,65.59303610441566,85.60457804757614,66.13838453846154,66.17215596995172,-14.39542195242386
2019-12-19,67.591003,67.904999,67.449249,67.802002,67.802002,29398000,2141105251.9226832,756072297,30.967521247501985,40.0,0.8969700558979099,66.76020442625867,89.58143943754409,66.24846146153845,66.29288530551085,-10.418560562455907
2019-12-20,68.167503,68.181999,67.449997,67.4795,67.4795,66300000,2080149633.2221887,689772297,31.755210161801163,40.0,0.8536333847503528,62.457143042331026,82.08139118171891,66.34767292307693,66.38078269028783,-17.918608818281086
2019-12-23,67.793503,67.989998,67.3255,67.442001,67.442001,17662000,2068680701.2585108,672110297,32.20046215324205,40.0,0.8069607633697871,61.95708225722133,73.12492931980726,66.41955765384616,66.45939145397021,-26.875070680192735
2019-12-24,67.425003,67.513,67.139,67.178001,67.178001,6950000,2063180203.664928,665160297,32.18479682906771,40.0,0.7401379316514607,58.4113429719054,55.84849429633647,66.43626923076923,66.51262179071315,-44.15150570366353
2019-12-26,67.308502,68.066353,67.223503,68.019997,68.019997,13350000,2075061727.4236038,678510297,32.763584959292835,40.0,0.7465170129929248,65.24330047285292,85.42442568233412,66.51261511538462,66.6242792136233,-14.575574317665877
2019-12-27,68.149498,68.226501,67.4655,67.594498,67.594498,20768000,2061334534.108483,657742297,33.45742267278764,40.0,0.7090646121864523,59.889138284319905,54.730462334892785,66.58267261538461,66.69614727187343,-45.269537665107215
2019-12-30,67.5,67.650002,66.700996,66.806999,66.806999,21018000,2045011912.3337,636724297,32.48757096600698,40.0,0.6088206216721375,51.47036192641651,6.843300598320044,66.64630734615385,66.70435851099391,-93.15669940167996
2019-12-31,66.505501,66.900002,66.454247,66.850998,66.850998,19236000,2060018499.5665972,655960297,31.139598157098458,40.0,0.5268536476603884,51.87739297058638,22.093851437252667,66.71490353846153,66.71522069536474,-77.90614856274733
2020-01-02,67.077499,68.406998,67.077499,68.3685,68.3685,28132000,2086521275.7221262,684092297,31.466014700211158,80.0,0.5776847689029125,63.30787400092335,98.0285248861732,66.85342284615385,66.83768582904142,-1.971475113826802
2020-01-03,67.392998,68.625,67.277199,68.032997,68.032997,23728000,2089404882.2486088,660364297,31.945076048481848,84.0,0.5841626471538603,59.91917492756489,72.72821919398457,66.95721107692307,66.92622739726058,-27.27178080601543
2020-01-06,67.5,69.824997,67.5,69.710503,69.710503,34646000,2120638611.9325614,695010297,33.20735805809518,88.0,0.7163989261578365,68.88671777888234,96.60330786916877,67.11232665384615,67.13247003450053,-3.3966921308312217
2020-01-07,69.897003,70.149498,69.518997,69.667,69.667,30054000,2104694287.1337113,664956297,34.563545613727065,92.0,0.8083684333414993,68.458951193103,86.94275436228844,67.26684596153846,67.32021299490789,-13.057245637711556
2020-01-08,69.603996,70.579002,69.542,70.216003,70.216003,30560000,2113859440.3735313,695516297,36.054897229941176,96.0,0.9150072502706763,70.91366341026527,91.1995015461524,67.45792296153846,67.53471595824804,-8.800498453847595
2020-01-09,71.028503,71.366501,70.513496,70.991501,70.991501,30018000,2117484277.379176,725534297,37.8162362574411,100.0,1.0499918361807659,73.99267159410348,92.36602993249129,67.70774984615385,67.79077410948892,-7.633970067508717
2020-01-10,71.377998,71.746452,70.917503,71.486504,71.486504,36414000,2131060330.8420544,761948297,39.614266131639624,100.0,1.1832706902563928,75.75677501409854,95.08809654954771,67.9663076923077,68.06453187915642,-4.911903450452279
2020-01-13,71.806503,72.026001,71.301003,71.961502,71.961502,33046000,2158226496.8176847,794994297,41.39984454557322,100.0,1.3120984569509062,77.34482563733346,98.84239325713234,68.19455776923077,68.35319633255224,-1.1576067428676478
2020-01-14,71.9505,72.089996,71.418503,71.543999,71.543999,31178000,2138702272.1749854,763816297,43.08492732085004,36.0,1.364774120806132,72.82906231458752,90.3118999799317,68.39215380769231,68.58955208569652,-9.688100020068308
2020-01-15,71.510498,72.069748,71.510498,71.959999,71.959999,25654000,2154287426.95013,789470297,44.64964704074995,36.0,1.4236764315667045,74.43095295156388,97.69335007644942,68.58173076923077,68.83921482008938,-2.3066499235505864
2020-01-16,72.372002,72.599503,72.045998,72.584999,72.584999,23474000,2176531205.3767023,812944297,46.33554824171948,43.99999999999999,1.5034582826575758,76.65757066328894,99.76398054043636,68.78969223076923,69.11668031489756,-0.236019459563642
2020-01-17,73.1455,74.064751,72.911003,74.019501,74.019501,47924000,2220696046.5309234,860868297,48.39358697911075,48.0,1.6632652112027557,80.79202753250999,99.4054270255952,69.05071142307693,69.47985221749775,-0.5945729744047932
2020-01-21,73.956001,74.592499,73.559998,74.220001,74.220001,40734000,2232038629.898881,901602297,50.442558343338554,52.0,1.7855097824423893,81.29082579726041,95.42287459272573,69.31874996153846,69.83097434953496,-4.577125407274276
2020-01-22,74.550003,75.160698,74.246498,74.297501,74.297501,32216000,2203417275.814435,933818297,52.48048777236535,56.0,1.8671200900239597,81.49090438683061,89.3210967588451,69.57967323076923,70.16182817549533,-10.678903241154897
2020-01-23,74.382004,74.776001,74.105003,74.332497,74.332497,27024000,2194717616.143319,960842297,54.09564437668808,56.0,1.9125737715762057,81.58666344772263,89.49449984074339,69.84663457692308,70.47076660694012,-10.505500159256604
2020-01-24,74.679497,74.77475,73.262497,73.335503,73.335503,35692000,2162471772.510012,925150297,54.06871874051405,56.0,1.84685763294533,70.41054034448261,76.17456007272452,70.04959615384615,70.68296930272233,-23.825439927275486
2020-01-27,71.550003,71.903503,71.059998,71.695,71.695,35104000,2180221306.770034,890046297,51.23537289282412,56.0,1.6434574829303017,56.65750351125363,38.56998093305539,70.20109626923077,70.75793453955771,-61.43001906694461
2020-01-28,72.150002,72.800003,71.623497,72.627998,72.627998,31548000,2202544681.0732675,921594297,49.22080039355852,56.0,1.539796721717039,61.28864137711897,54.92372076235467,70.39328861538462,70.89645775884973,-45.07627923764533
2020-01-29,72.940002,73.2715,72.336998,72.931503,72.931503,21554000,2208414829.4860053,943148297,47.64708979192348,56.0,1.465244709692783,62.68540321547878,52.03145892948072,70.59057711538462,71.04720185078679,-47.96854107051928
2020-01-30,71.998001,72.863998,71.82,72.792,72.792,26788000,2231508028.492134,916360297,45.64105878440883,56.0,1.379008623808346,61.58547430242999,44.17654621105099,70.79490403846154,71.17644615813592,-55.82345378894901
2020-01-31,73.445,73.5065,71.426498,71.711502,71.711502,48344000,2196412317.076472,868016297,44.20512692150036,56.0,1.2095359682144533,53.722615984022525,15.887628941400303,70.95911561538462,71.21607992419993,-84.11237105859969
2020-02-03,73.099998,74.5,72.949501,74.296997,74.296997,60736000,2241244288.492126,928752297,43.4572776850443,56.0,1.2692246743079636,65.1790050493037,78.93771795059402,71.23292315384616,71.44429600388882,-21.062282049405983
2020-02-04,72.8535,73.474998,71.315002,72.3535,72.3535,78660000,2238221699.561405,850092297,41.20376969426813,56.0,1.1464884335059224,54.297611149218305,31.543443802277725,71.39959634615384,71.5116444480452,-68.45655619772228
2020-02-05,73.121002,73.192001,71.528,72.411499,72.411499,39724000,2240680503.8698163,889816297,39.111226559975975,56.0,1.041888866683749,54.541511883136344,32.957812080864535,71.58486561538462,71.57830034078259,-67.04218791913546
2020-02-06,72.516502,74.099998,72.4785,73.811501,73.811501,33588000,2262316546.80789,923404297,37.76684386451756,56.00000000000001,1.0597453329434785,60.07962309706397,67.09837344843592,71.85426953846154,71.74372261183574,-32.901626551564085
2020-02-07,73.364998,74.292,73.317497,73.961502,73.961502,23446000,2269859350.8033624,946850297,36.639236152042486,52.0,1.0736244636832168,60.63301025164656,70.75630989831005,72.12775046153845,71.90800256651458,-29.243690101689946
2020-02-10,73.716003,75.474998,73.716003,75.433998,75.433998,28398000,2296933506.2216554,975248297,36.27964078303692,100.0,1.1897274582664181,65.66476149117315,99.07134767836926,72.39950038461538,72.16918741343942,-0.9286523216307306
2020-02-11,75.5905,76.481499,75.281898,75.439499,75.439499,26892000,2277107532.4953914,1002140297,36.44184559607515,100.0,1.267572021449638,65.68240869726249,80.78023041958306,72.68436584615384,72.41143271614762,-19.219769580416944
2020-02-12,75.723999,76.034752,75.405502,75.913498,75.913498,23352000,2291459855.3940806,1025492297,36.59246435103922,96.0,1.3519279724171156,67.24461731962893,89.5231781751955,72.92294257692308,72.67084495939595,-10.476821824804508
2020-02-13,75.634499,76.359001,75.230003,75.733002,75.733002,18590000,2289434546.226128,1006902297,36.89277334235005,92.0,1.3882136893014092,66.0123017134308,86.19391567021754,73.15625034615385,72.8976714068481,-13.806084329782463
2020-02-14,75.779999,76.037003,75.366997,76.037003,76.037003,23956000,2313390546.226128,1030858297,37.171631691424395,88.0,1.4250733627657297,67.10569706553113,91.39656908733322,73.38013496153846,73.13021448782231,-8.603430912666775
2020-02-18,75.75,76.581497,75.629501,75.983498,75.983498,22414000,2307645710.294044,1008444297,37.71161913589475,100.0,1.433443666901411,66.69899274678372,88.64521849921053,73.57213484615384,73.3415688220577,-11.354781500789471
2020-02-19,76.253502,76.605301,76.07,76.334503,76.334503,18986000,2307422439.8910375,1027430297,38.22534999670523,64.0,1.4516664559888994,68.06631851753939,94.88123450111233,73.75859634615385,73.56326765005342,-5.118765498887675
2020-02-20,76.099998,76.482002,75.341003,75.907501,75.907501,21932000,2307268608.2084503,1005498297,37.73692731329728,64.0,1.415337524863844,64.59181005313474,86.80981925596262,73.91036553846153,73.73691456486428,-13.19018074403738
2020-02-21,75.401497,75.610748,74.022003,74.255501,74.255501,34634000,2282814932.592791,970864297,35.84000117045881,64.0,1.2389620087417796,53.26370426602175,55.58285079917022,74.01465407692308,73.77532837487432,-44.41714920082978
2020-02-24,71.305496,71.848503,70.569504,71.079498,71.079498,57342000,2271202563.261776,913522297,34.88313667185394,-12.0,0.8333004732188982,39.07520048146679,8.449488940731536,73.98078865384615,73.57563723599473,-91.55051105926846
2020-02-25,71.650002,71.906998,69.120003,69.422501,69.422501,49566000,2232396263.84825,863956297,34.6609936734516,-16.0,0.37379608529390396,33.98822932416479,4.041228552290102,73.85915411538461,73.26799751480995,-95.95877144770989
2020-02-26,69.806999,70.785004,68.949997,69.658997,69.658997,44048000,2222386316.019168,908004297,34.52765354766641,-20.0,0.028391518283797268,35.283205618708664,9.261552513133418,73.69144242307692,73.00066414334255,-90.73844748686658
2020-02-27,68.102997,68.585197,65.858498,65.904503,65.904503,59566000,2164830316.9983745,848438297,35.49189291990392,-24.0,-0.5420519404082711,26.421608711514622,0.4280807976103039,73.37161557692308,72.47502257716903,-99.57191920238968
2020-02-28,63.875,67.056999,63.549999,66.966499,66.966499,75782000,2236701127.377616,924220297,36.95959309494384,-28.0,-0.8980857164159346,31.65078894846424,26.16944441423109,73.08965396153846,72.06698379367504,-73.8305555857689
2020-03-02,67.580498,69.543503,66.340752,69.455498,69.455498,48630000,2282658622.9275355,972850297,36.63162735722416,-28.0,-0.9682423361778802,42.046404956783874,45.23448787320284,72.90207707692308,71.87354040155097,-54.76551212679716
2020-03-03,69.971001,70.5075,66.599998,67.069504,67.069504,48046000,2246158559.5776,924804297,35.7639067028193,-28.0,-1.2025099518183993,36.34035922790216,26.958434205505135,72.66107711538461,71.51768585328793,-73.04156579449487
2020-03-04,67.961502,69.404503,67.155502,69.325996,69.325996,38266000,2281753018.8695254,963070297,34.958166095157644,-28.0,-1.1923440785815558,44.07064148282879,44.24253839551169,72.56996157692308,71.35533845674809,-55.75746160448831
2020-03-05,67.510002,67.945503,65.254997,65.952003,65.952003,51226000,2257068367.8618712,911844297,34.85655042468023,-27.999999999999993,-1.439941835121573,36.86267056830929,18.398685836604972,72.31319253846154,70.95509138587786,-81.60131416339503
2020-03-06,63.853001,65.310997,63.052502,64.920502,64.920502,53212000,2291879601.0326333,858632297,35.379993525090995,-48.0,-1.699804067907948,34.979097743790746,13.783130702373747,72.00507711538461,70.50808476470174,-86.21686929762626
2020-03-09,60.264999,62.737999,60.0,60.778,60.778,67308000,2262822618.655357,791324297,36.53769245960039,-52.0,-2.2144848478071566,28.648135305367745,4.685250812376113,71.54300019230769,69.7873377450942,-95.31474918762389
2020-03-10,63.0,64.057503,60.938499,64.019501,64.019501,52228000,2313777924.900556,843552297,36.850611208243826,-52.0,-2.333907204163424,38.09060897419609,24.387213397984095,71.247154,69.36009057879093,-75.6127866020159
2020-03-11,62.485001,63.048,59.803501,60.7705,60.7705,52170000,2292705692.4326158,791382297,37.399482076019716,-60.0,-2.660054062229875,33.3296007192083,6.1174409433850245,70.72690411538461,68.72382460999161,-93.88255905661497
2020-03-12,56.299999,59.693501,55.665001,55.745499,55.745499,84534000,2211550030.7381887,706848297,38.676843078521664,-64.0,-3.286123001601254,27.5864761386284,0.49561639495442406,70.08813484615385,67.76246715739964,-99.50438360504558
2020-03-13,58.950001,60.987999,55.857151,60.9865,60.9865,74002000,2285508790.713148,780850297,39.18333374188289,-64.0,-3.321098609352603,39.32901362519706,32.76382208419323,69.64871180769231,67.26054366425893,-67.23617791580678
2020-03-16,54.799999,57.61335,53.722,54.216499,54.216499,85048000,2222075989.0129666,695802297,40.033880444413015,-72.0,-3.8507109332677345,32.09011193214869,2.8980770326256597,68.89505788461538,66.29431813357309,-97.10192296737435
2020-03-17,54.655499,56.542999,52.800499,55.990002,55.990002,77230000,2276482764.799206,773032297,40.976099828687595,-76.0,-4.080290595215288,35.44235265457594,18.012666289452387,68.20384634615385,65.53103545701212,-81.98733371054762
2020-03-18,52.8255,55.325001,51.863998,54.84,54.84,84668000,2337421190.067257,688364297,42.0032908267645,-80.0,-4.305399713889678,34.261331251336074,15.962676969165999,67.4117695,64.73910690464085,-84.037323030834
2020-03-19,54.6525,57.898499,53.005402,55.7645,55.7645,73022000,2346749837.9926915,761386297,41.63827611471691,-80.0,-4.358953585057485,36.104637797053414,20.921509274384167,66.65503876923077,64.07432120800078,-79.07849072561584
2020-03-20,56.785999,57.199501,53.274502,53.616001,53.616001,72036000,2287248986.1361685,689350297,41.299333882101294,-80.0,-4.522627295117083,33.7370979048881,9.397392185223547,65.79744273076923,63.299630822222944,-90.60260781477646
2020-03-23,53.066002,53.566002,50.6768,52.831001,52.831001,80882000,2326978895.779039,608468297,41.53515397993805,-92.0,-4.661942853766426,32.88850836530284,11.502750764469086,64.91659653846153,62.52417676131754,-88.49724923553092
2020-03-24,55.188499,56.75,54.530998,56.723,56.723,66890000,2392241109.954601,675358297,40.32013995300014,-92.0,-4.407492811639649,40.83446991254292,35.012473142887444,64.17375026923077,62.0944599641829,-64.98752685711256
2020-03-25,56.323502,57.445,54.300499,55.1245,55.1245,81630000,2353392588.8792377,593728297,38.9107995491003,-92.0,-4.285425196735318,38.80242616947435,30.39251145792282,63.37148111538461,61.57816663350269,-69.60748854207718
2020-03-26,55.59,58.498501,54.676498,58.087502,58.087502,71434000,2409463281.96085,665162297,37.17953456467073,-88.0,-3.904586590223545,44.33227884263366,55.38350264556356,62.66967338461538,61.31959888287286,-44.61649735443644
2020-03-27,56.283501,57.533501,55.295502,55.5355,55.5355,64170000,2359056176.099766,600992297,35.57193136484328,-84.0,-3.765290558452506,40.90397999671909,36.31124612809955,61.88613488461538,60.89114711377116,-63.688753871900445
2020-03-30,56.251999,57.581501,54.824001,57.341,57.341,51482000,2401557960.337662,652474297,34.2305109476974,-76.0,-3.4692177066837218,44.19215579519058,53.8686627004656,61.23557715384615,60.628173253491816,-46.1313372995344
2020-03-31,57.365002,58.765499,56.907001,58.140499,58.140499,49728000,2417839596.661188,702202297,32.45992239855566,-76.0,-3.1339388546519586,45.63468242855581,72.38439487008249,60.73792334615385,60.4439010865665,-27.61560512991751
2020-04-01,56.099998,56.484501,54.872501,55.280998,55.280998,46884000,2394717350.194687,655318297,31.49050185423758,-72.0,-3.0636499323518365,41.50266980073046,44.65240172360165,60.19401938461538,60.06146382089491,-55.34759827639835
2020-04-02,54.912998,56.342999,54.82,56.042,56.042,39298000,2418481973.3480835,694616297,30.607071435413513,-56.0,-2.9129601620898953,42.98231110526701,66.3295790831134,59.67028873076924,59.76372576008788,-33.670420916886606
2020-04-03,55.950748,56.176998,53.990501,54.894001,54.894001,46268000,2410451517.6941314,648348297,30.05753287834466,-56.0,-2.8532805168751025,41.285782014615364,52.13695057758984,59.246807884615386,59.40300540748878,-47.863049422410164
2020-04-06,56.900002,59.733002,56.547001,59.346001,59.346001,53294000,2450798358.3592787,701642297,27.985331585531032,-56.0,-2.4188616436512547,49.59472642172696,95.72667438292567,58.95371180769231,59.39878285878591,-4.273325617074332
2020-04-07,61.049999,61.25,59.1115,59.3255,59.3255,47746000,2412608256.418666,653896297,26.456954443087344,-56.00000000000001,-2.0525750091465156,49.55994574978998,81.79832028146633,58.5640965,59.39335449887584,-18.20167971853367
2020-04-08,60.325001,60.953499,59.408001,60.514,60.514,39502000,2429643595.8367696,693398297,25.037747096532488,-52.0,-1.6473980161966892,51.675754341267826,93.03900427495935,58.31196173076924,59.476365276736885,-6.960995725040641
2020-04-09,61.203999,61.2785,59.83675,60.572498,60.572498,43508000,2430541247.2798076,736906297,23.842864783567006,-48.0,-1.3065113805101163,51.782962508118594,93.34067177905432,57.975288730769236,59.557560293274896,-6.659328220945678
2020-04-13,60.459,61.025501,59.379902,60.877998,60.877998,34796000,2459099379.6243215,771702297,22.52337641565549,-44.0,-1.0001755675874762,52.37716289625761,94.50463700667353,57.78013469230769,59.655370493773056,-5.495362993326468
2020-04-14,62.254501,64.1035,61.8465,63.461498,63.461498,49408000,2480399240.6646404,821110297,22.410145664390708,60.0,-0.5426796962938027,57.18261728311774,93.65171498583162,57.72401915384615,59.93730586460468,-6.348285014168382
2020-04-15,62.280499,64.023003,62.02,63.123501,63.123501,33434000,2483804379.132231,787676297,22.30500282393055,60.0,-0.2050210997384383,56.381047389270755,90.30951155043128,57.81423073076923,60.17332031907841,-9.690488449568717
2020-04-16,63.705002,63.950001,62.131001,63.1735,63.1735,50362000,2491168970.26802,838038297,22.207370186360404,60.0,0.06585118075067697,56.47823636606624,90.80391484266931,57.78169223076923,60.39555585099853,-9.19608515733068
2020-04-17,64.2425,64.721497,63.561501,64.162498,64.162498,38980000,2492580252.7552013,877018297,22.39331335803072,72.0,0.3562170394729094,58.45033261390934,94.79080040659787,57.91215369230769,60.67458860277641,-5.2091995934021424
2020-04-20,63.549999,64.080002,63.068501,63.330502,63.330502,33910000,2476237123.98914,843108297,22.275277951311512,72.0,0.5132821534065997,56.14546078605282,87.0375965101469,58.20388457692308,60.871322928496674,-12.962403489853104
2020-04-21,62.349998,62.713501,60.4855,60.817001,60.817001,43060000,2445990792.439019,800048297,20.825504027346096,72.0,0.4299822950537049,49.761427658883974,63.614784685410356,58.19736538461538,60.86729908194137,-36.385215314589644
2020-04-22,62.277,64.280647,62.099998,63.1605,63.1605,41848000,2444846168.081775,841896297,20.124641859365532,72.0,0.5467645793065259,54.90940728218071,85.45338196007154,58.541365423076925,61.03716581661238,-14.546618039928454
2020-04-23,63.577499,64.665497,63.283501,63.815498,63.815498,31324000,2437638408.690286,873220297,19.62509622558408,72.0,0.6842802882874395,56.25853401798215,91.55717698524907,58.842346038461535,61.24296820056702,-8.442823014750928
2020-04-24,63.058498,64.019997,62.4725,63.9655,63.9655,32792000,2468120787.8974833,906012297,18.747195553748394,72.0,0.796188421668063,56.57894612933226,90.7517601085131,59.19332680769231,61.44463722274725,-9.248239891486898
2020-04-27,64.800003,64.807503,63.450001,63.793999,63.793999,32012000,2452332799.318461,874000297,18.268610641542274,96.0,0.8611113703660749,56.07320847849566,82.20675094447813,59.502153692307694,61.618664021062266,-17.79324905552188
2020-04-28,64.3965,64.402496,61.610001,61.683498,61.683498,59026000,2396413865.8822327,814974297,17.01115776646831,96.0,0.7338046393418267,50.134271329842434,42.44225026858092,59.81244203846154,61.623466538020615,-57.55774973141908
2020-04-29,67.072998,67.999496,66.266998,67.073997,67.073997,75872000,2391224346.471533,890846297,17.13484160119049,68.0,1.0557117687177922,61.38413341908531,89.26284695079619,60.360249576923074,62.02720953520428,-10.73715304920381
2020-04-30,66.244003,67.640999,66.124496,67.432999,67.432999,53378000,2429959943.5221157,944224297,17.180496669014904,68.0,1.32452564194719,61.999016366262154,93.42779949960521,60.77217261538461,62.42763838444841,-6.572200500394784
2020-05-01,66.425003,67.6035,65.550003,66.030502,66.030502,41450000,2407907764.458791,902774297,16.935121393594027,68.0,1.4081603900107211,58.10641020764417,73.79564748237826,61.19163423076923,62.69451717078556,-26.204352517621746
2020-05-04,65.411499,66.383003,64.949997,66.339996,66.339996,30080000,2436182258.3269253,932854297,16.4062582443359,68.0,1.482327757980599,58.72230436878265,77.91454773199246,61.509037846153845,62.96455263961626,-22.085452268007543
2020-05-05,66.896004,68.696999,66.873001,67.555496,67.555496,33030000,2427870278.686597,965884297,16.77693069448938,84.0,1.620506433649524,61.13867488948073,86.09872570160455,61.97134538461538,63.3046225181632,-13.901274298395453
2020-05-06,68.084503,68.556,67.364502,67.364998,67.364998,24308000,2403582516.686157,941576297,17.12112654106047,84.0,1.6951023483912806,60.5405190250673,83.7788325858652,62.35688376923076,63.60539107237333,-16.221167414134797
2020-05-07,68.296997,68.879997,67.763496,68.627998,68.627998,27952000,2418916747.337093,969528297,17.559442235207317,92.0,1.8349811722101208,63.11697369062978,96.99804526703628,62.76024911538462,63.97743602997531,-3.001954732963724
2020-05-08,69.156502,69.938004,68.774002,69.418503,69.418503,27738000,2421895479.332399,997266297,18.346704917217163,96.0,1.9867216048635186,64.6717887531874,94.5040911910748,63.30399930769231,64.38047802775492,-5.495908808925181
2020-05-11,68.914001,70.8265,68.857597,70.163002,70.163002,28242000,2431103011.391622,1025508297,19.37888163514585,100.0,2.1423560907901162,66.1203449606356,92.80097572841932,63.847114769230764,64.8088131368101,-7.199024271580673
2020-05-12,70.356003,70.75,68.738503,68.787003,68.787003,27812000,2404632183.6628213,997696297,20.257184230496467,96.0,2.130111325168045,61.13131487427869,77.87123939361359,64.381461,65.10349386741676,-22.12876060638641
2020-05-13,68.852501,69.274101,66.419998,67.466499,67.466499,36252000,2394964896.444385,961444297,19.657361523779304,92.0,1.9909037244650847,56.709097994426585,63.54362974487386,64.69378784615384,65.27853128464514,-36.45637025512613
2020-05-14,66.750999,67.871002,66.195503,67.806503,67.806503,32062000,2424558417.5757017,993506297,18.976940159335744,80.0,1.8862724051169977,57.560386385019385,67.23270951366685,65.01998026923077,65.4657884487455,-32.767290486333145
2020-05-15,67.5,68.723999,66.949997,68.6595,68.6595,34154000,2456228881.6540956,1027660297,18.72680429683036,80.0,1.8508456631193013,59.70139422524621,76.48781820515576,65.33326873076922,65.70235967476435,-23.512181794844246
2020-05-18,68.087502,69.616249,67.712502,69.196999,69.196999,36448000,2476623462.79119,1064108297,18.87354340049989,80.0,1.8448748235129102,61.03532334469374,72.27090669399827,65.6649803076923,65.96122184700403,-27.729093306001726
2020-05-19,69.349854,69.599998,68.674248,68.674248,68.674248,25612000,2451011462.79119,1038496297,19.0098011396216,56.0,1.7774716662883918,58.99017728994345,63.37529309523044,65.96483607692308,66.16218674722595,-36.62470690476956
2020-05-20,69.478996,70.521004,69.362503,70.335999,70.335999,33108000,2473545202.5359116,1071604297,19.531845514649937,56.0,1.8369681708413879,63.21030005299728,91.65318217313947,66.22923996153847,66.47135802520921,-8.346817826860546
2020-05-21,70.400002,70.774498,69.672501,70.139999,70.139999,27700000,2469347434.574656,1043904297,20.123428256823722,56.0,1.8470128035157671,62.394732524484816,88.31786523379647,66.49910526923077,66.74310920852704,-11.682134766203518
2020-05-22,69.835503,70.638,69.591499,70.521004,70.521004,26188000,2489679938.5015516,1070092297,20.609427736083084,56.0,1.8642275122661687,63.38375279505593,93.40323476780505,66.78170157692308,67.02295326715468,-6.596765232194953
2020-05-26,71.863503,72.050003,70.606499,70.850998,70.850998,41212000,2462428818.1222525,1111304297,21.66206711065603,96.0,1.882794369409467,64.26048156665995,79.51994192501496,67.03895157692308,67.30651213625433,-20.480058074985042
2020-05-27,70.862503,71.086998,69.564499,70.891998,70.891998,33716000,2487508201.6121597,1145020297,21.82857476418878,96.0,1.879155361537002,64.374615159461,80.22025792125712,67.32977834615384,67.57210368171697,-19.779742078742892
2020-05-28,69.843002,72.042,69.800003,70.836502,70.836502,33844000,2484957082.161063,1111176297,22.39830765446456,76.0,1.8504623797390707,64.07633459184126,79.2723375181483,67.71514376923076,67.81391096455275,-20.7276624818517
2020-05-29,70.847,71.628502,70.667503,71.445999,71.445999,36418000,2507542821.6613126,1147594297,22.92734533829207,76.0,1.8555150762821313,65.94277507954476,89.6830813903834,68.0338168076923,68.08295452273403,-10.316918609616588
2020-06-01,70.919502,71.898003,70.900002,71.591003,71.591003,24342000,2516908896.78749,1171936297,23.541004890006064,76.0,1.8498955413653562,66.39017189556094,92.15987701767865,68.33287469230768,68.34280996549447,-7.840122982321343
2020-06-02,71.527496,71.980499,70.941498,71.960999,71.960999,25562000,2541511400.1171308,1197498297,24.149885061850796,76.0,1.8539266916001935,67.56115529905192,98.47973353830382,68.64039388461539,68.61082396805043,-1.5202664616961776
2020-06-03,71.915001,72.327599,71.488853,71.819,71.819,25124000,2536166005.8642817,1172374297,24.884688432779342,100.0,1.8246300749283364,66.60209638077252,91.70595176592141,68.94904776923077,68.84846663708373,-8.294048234078584
2020-06-04,71.519997,71.947998,70.236504,70.609001,70.609001,29686000,2519401986.2416596,1142688297,24.41994392349223,84.0,1.6843592433486236,58.9260129493147,68.04155458139154,69.29233634615385,68.97887658989235,-31.95844541860846
2020-06-05,70.658501,72.252502,70.300003,71.919502,71.919502,34698000,2542264452.395035,1177386297,24.165222919716147,84.0,1.6598068568591344,63.79320910757568,91.15734728869162,69.47870192307693,69.19670069434477,-8.842652711308379
2020-06-08,71.116997,72.399498,71.116997,72.330498,72.330498,28084000,2567326550.657727,1205470297,24.016452207264724,96.0,1.6544414844601363,65.1865086338285,98.14777531709312,69.66706726923077,69.42883382809701,-1.852224682906882
2020-06-09,72.267998,73.400002,72.1605,72.807999,72.807999,28184000,2568588427.81807,1233654297,24.446872772048955,100.0,1.6694750589685015,66.78570174562675,85.33738336529605,69.92774023076923,69.67914235934909,-14.662616634703955
2020-06-10,72.976997,73.712952,72.813499,73.292503,73.292503,30504000,2570574258.8954024,1264158297,25.0127857457825,72.0,1.7008780354754265,68.37321075946416,89.86492073069155,70.19514434615385,69.946798703101,-10.135079269308454
2020-06-11,72.124001,72.723747,70.099998,70.192001,70.192001,39826000,2533541293.959351,1224332297,23.29730679269261,72.0,1.458764788744645,51.43201706635506,15.126168718797256,70.29654838461539,69.96496183620464,-84.87383128120274
2020-06-12,71.4245,71.849998,69.301003,70.658997,70.658997,38928000,2536091594.5695915,1263260297,22.06635278167575,72.0,1.289704065080997,53.30857090223775,30.77991155382809,70.42324065384615,70.01637184833763,-69.22008844617191
2020-06-15,69.540001,71.239998,69.396004,70.9925,70.9925,30078000,2558095550.0293164,1293338297,20.923324057160094,72.0,1.1691558278507301,54.65598835612116,38.33899711896057,70.51418303846154,70.08867763734965,-61.66100288103943
2020-06-16,72.261002,72.750999,71.294998,72.136002,72.136002,34184000,2563401743.6981397,1327522297,20.002785645936793,72.0,1.1526050228657425,59.022479150675004,64.25729309201004,70.61870223076923,70.24033129384227,-35.74270690798996
2020-06-17,72.358002,73.0,71.569,72.556,72.556,30992000,2575161810.7840934,1358514297,19.299400784923705,72.0,1.1600068819474103,60.52603090848214,73.77685009504864,70.71074061538462,70.41186230911322,-26.223149904951352
2020-06-18,72.458,72.570503,71.350502,71.797997,71.797997,31638000,2566733376.694285,1326876297,18.478536274210477,72.0,1.092119131860997,56.49694911084889,56.596166456139834,70.82654807692307,70.5145389528826,-43.403833543860166
2020-06-19,72.199997,72.389999,71.067497,71.585999,71.585999,63158000,2553099005.8698926,1263718297,17.49395474541193,72.0,1.0095734002336343,55.38646321911878,51.79107918065243,70.98499038461539,70.59390636378018,-48.20892081934757
2020-06-22,71.449997,72.637497,71.1605,72.593002,72.593002,30848000,2582088394.4306006,1294566297,16.75992646018124,68.0,1.0137264321468393,59.462419843186275,74.61552706071623,71.1690865,70.74198752201869,-25.384472939283775
2020-06-23,72.781998,73.79705,72.262001,73.220497,73.220497,28596000,2589203504.129379,1323162297,16.859268410838858,100.0,1.0554843753022567,61.80418261155595,87.17644633163302,71.34450946153846,70.92558081668396,-12.82355366836698
2020-06-24,73.0755,73.771004,71.487503,71.598503,71.598503,35120000,2557497840.2737465,1288042297,16.292084818091077,96.0,0.9467825658051794,53.24236330316439,51.100444457097474,71.436875,70.97542690433701,-48.899555542902526
2020-06-25,71.495003,72.144997,71.0,72.066498,72.066498,24610000,2578733402.803604,1312652297,15.374067635161696,28.0,0.88816072000769,55.17199428224526,61.50947710288613,71.56734615384616,71.05624698549724,-38.49052289711387
2020-06-26,71.569504,71.672501,67.599503,67.995003,67.995003,85354000,2509955648.1147976,1227298297,16.0564531577873,-12.0,0.5073188098243833,39.787946708454626,6.381557090248745,71.47730784615385,70.82948817175671,-93.61844290975127
2020-06-29,67.908997,69.779999,67.350502,69.748497,69.748497,36204000,2545220771.954012,1263502297,16.80360704080727,-16.0,0.343036848172801,46.68321187950917,37.19812526021674,71.46225007692307,70.74941475162659,-62.80187473978326
2020-06-30,69.522003,70.932503,69.197998,70.680496,70.680496,40848000,2574199123.9149466,1304350297,16.634884483544866,-16.0,0.28476415630134966,49.96306276407129,51.655459635141206,71.46838438461538,70.74430965891352,-48.344540364858794
2020-07-01,70.555,72.150002,70.490997,71.902,71.902,35504000,2599088251.737949,1339854297,15.677563733052525,-16.0,0.3333056523416644,53.96052706462895,70.60364709919169,71.50880753846154,70.830064498994,-29.396352900808306
2020-07-02,72.347,74.147499,72.320999,73.235001,73.235001,37182000,2599118868.6161313,1377036297,15.414675272125027,12.0,0.4738746460787553,57.91211160421867,86.57498304030442,71.59892303846154,71.00820794351297,-13.425016959695593
2020-07-06,74.002998,75.329498,73.642998,74.785004,74.785004,31280000,2610201095.3341866,1408316297,15.710736933294665,16.0,0.7022537306752952,61.996705878365134,93.175908347366,71.75078850000001,71.28797061436386,-6.824091652633998
2020-07-07,74.5,75.839996,74.177498,74.259003,74.259003,29164000,2583896661.8659964,1379152297,16.206477847302057,20.0,0.8312201276591935,59.87315512041254,81.37706440454527,71.85898096153846,71.50804708737394,-18.62293559545473
2020-07-08,74.716003,75.293999,74.281502,74.800003,74.800003,24994000,2584501580.1719275,1404146297,16.666808696023207,20.0,0.9659462776874932,61.33989285033742,87.7496467987374,71.98240403846154,71.75189567349439,-12.2503532012626
2020-07-09,75.322502,76.136002,74.404251,75.5495,75.5495,28466000,2593686094.6327243,1432612297,17.472623270398024,28.0,1.1202819533200596,63.33918771779438,93.32420465539798,72.1204233076923,72.03319969767999,-6.675795344602016
2020-07-10,75.307503,77.191498,74.827003,77.086998,77.086998,37126000,2627530491.5842934,1469738297,18.656418303498576,32.0,1.3510828849031924,67.09811498131859,98.9381156135009,72.3230386153846,72.40755512748147,-1.0618843864991074
2020-07-13,77.5,78.856598,75.262154,75.567001,75.567001,36928000,2596866264.237867,1432810297,20.347835732230838,36.0,1.3952595477115892,60.49437880049752,71.4099639008748,72.51373092307692,72.64158815507544,-28.5900360991252
2020-07-14,74.515503,76.147499,74.175003,76.028999,76.028999,31700000,2624757435.22123,1464510297,21.092821635272838,36.0,1.450825040821158,61.72734187279681,75.42520938466004,72.67178849999999,72.89250747692171,-24.57479061533996
2020-07-15,76.156502,76.766502,74.900002,75.681999,75.681999,32214000,2619536471.768779,1432296297,22.019121006919924,35.99999999999999,1.450144728689665,60.20744051741859,72.40941671267126,72.80069238461539,73.09913647863122,-27.59058328732874
2020-07-16,75.0,75.934502,74.315498,75.900002,75.900002,30386000,2648627457.05603,1462682297,22.438630631584196,36.0,1.4504764074619771,60.859492113199906,74.3040906316095,72.91961557692308,73.30660799873262,-25.695909368390502
2020-07-17,76.081001,76.171997,74.920998,75.777496,75.777496,29134000,2659386714.735692,1433548297,22.92983365726723,36.0,1.4244340656743475,60.26190323694459,73.23938545271996,73.01519223076923,73.48963673956723,-26.760614547280035
2020-07-20,75.763,78.514503,75.18,78.286003,78.286003,31146000,2686264095.994008,1464694297,24.26100680899722,36.0,1.5879064752062675,67.33486458560958,94.09236328246318,73.3265,73.84492312922892,-5.907636717536818
2020-07-21,79.349503,79.349503,77.713997,77.920998,77.920998,24324000,2668097324.7953696,1440370297,25.757466684850083,60.0,1.6687701410765072,65.50779379369308,83.87419955464273,73.60580773076923,74.14685460113789,-16.125800445357267
2020-07-22,78.025002,78.5,77.305,78.4245,78.4245,18640000,2684381977.5150347,1459010297,26.81660121472655,60.0,1.7532729432132896,66.84426945751548,86.8392619538951,73.89165388461538,74.46371722327582,-13.16073804610489
2020-07-23,78.348503,78.593498,75.369598,75.783997,75.783997,32552000,2660198423.3402777,1426458297,26.397511964055713,60.0,1.588860107927701,54.84290372337363,37.51856872113485,74.03196138461539,74.56151572525539,-62.48143127886515
2020-07-24,74.946503,75.881798,74.419998,75.593498,75.593498,30880000,2678897955.42401,1395578297,25.414587326806615,60.0,1.4267434636677336,54.08840007657034,27.413180017392875,74.14878823076923,74.63795885671796,-72.58681998260712
2020-07-27,75.779999,77.0485,75.760498,76.510002,76.510002,24920000,2682980456.4760265,1420498297,25.022045262868996,60.0,1.3565812442199814,57.14322770448924,45.12511353753983,74.3300191923077,74.7766287191833,-54.87488646246017
2020-07-28,76.259003,76.323997,74.883003,75.016998,75.016998,34044000,2655267816.3290167,1386454297,24.115789234011967,60.0,1.16705119486096,51.17022269018647,16.272006957193895,74.46198069230769,74.79443385109565,-83.7279930428061
2020-07-29,75.316002,76.562599,75.066498,76.100998,76.100998,22130000,2663742013.505544,1408584297,23.388129737395058,60.0,1.0917321967037736,54.85954845701176,37.22089090733409,74.5969036153846,74.89121638064412,-62.77910909266591
2020-07-30,74.849998,76.893501,74.611,76.572502,76.572502,33428000,2687767735.414976,1442012297,22.41918944006022,60.0,1.057893047757787,56.40254235437381,46.332959706251785,74.72582688461537,75.01575605615197,-53.667040293748215
2020-07-31,75.250504,75.447502,72.7015,74.148003,74.148003,68798000,2691450755.744896,1373214297,21.213823898468352,60.0,0.8259178051618505,47.42553016031477,21.758458893595662,74.82388457692308,74.95147805199257,-78.24154110640434
2020-08-03,74.332001,74.523499,73.281998,73.722504,73.722504,46604000,2677918564.18323,1326610297,20.09455589556162,60.0,0.6008157113312649,46.04057692349533,15.358055644680132,74.88757711538462,74.86044293703016,-84.64194435531988
2020-08-04,73.828499,74.278,72.932503,73.248497,73.248497,38070000,2657730271.2104473,1288540297,19.249851016753098,60.0,0.37979424509555315,44.482173790741484,8.227989668476448,75.08963457692309,74.74103953428718,-91.77201033152355
2020-08-05,73.464996,74.120499,73.172997,73.680496,73.680496,39590000,2660550493.901271,1328130297,18.465482200716615,56.00000000000001,0.23676259781578324,46.26726603673114,14.726166639816633,75.2408653076923,74.66248075396962,-85.27383336018337
2020-08-06,73.587502,75.119499,73.300003,75.004997,75.004997,39908000,2695435624.034011,1368038297,17.23086630345378,52.0,0.22766081606876298,51.42431630604476,34.64945788983558,75.40719226923078,74.68785232774965,-65.35054211016441
2020-08-07,75.0,75.842247,74.082001,74.724503,74.724503,31556000,2686915941.812321,1336482297,16.53386064113733,48.0,0.19555977548556314,50.32281920530349,30.43023596710173,75.51575007692307,74.69056719236079,-69.56976403289828
2020-08-10,74.359001,75.203751,73.653999,74.805,74.805,25786000,2699432472.521751,1362268297,15.587090272666812,-32.0,0.1746021992396436,50.64951762729769,35.7009625597295,75.57613465384615,74.69904369663035,-64.29903744027051
2020-08-11,74.622002,75.5,73.900002,74.015999,74.015999,29088000,2674562128.713821,1333180297,14.903216671698571,-32.0,0.09325242640605325,47.36175521502084,22.309902345520104,75.54655753846154,74.64844779317626,-77.6900976544799
2020-08-12,74.278999,75.619301,74.262497,75.331001,75.331001,28740000,2691088512.008682,1361920297,14.349486388399578,-32.0,0.13335458813010348,52.85460740018291,60.490016103059574,75.58778823076923,74.69900728997801,-39.509983896940426
2020-08-13,75.516998,76.862503,75.400253,75.922501,75.922501,29104000,2682773714.664862,1391024297,14.628754428685031,-32.0,0.21043913548506055,55.12307520969874,74.09710144927524,75.63096123076923,74.78963645368334,-25.902898550724757
2020-08-14,75.782997,76.095001,75.143997,75.386497,75.386497,27096000,2669496331.6212583,1363928297,14.669545754211759,-31.999999999999996,0.22567669098555143,52.65080277495855,64.05048567497973,75.62469188461539,74.8338483460031,-35.949514325020274
2020-08-17,75.733498,76.280502,75.398499,75.899002,75.899002,27566000,2673215634.9546933,1391494297,14.827168024678846,-32.00000000000001,0.275926722320861,54.740978539842246,76.27626997226376,75.57899973076923,74.91274861666953,-23.72373002773624
2020-08-18,76.308998,78.123497,76.185501,77.93,77.93,40542000,2705661895.465035,1432036297,16.010144500808597,-32.0,0.47416887539188224,61.91579998313389,96.43125955252292,75.6698843076923,75.13624871913845,-3.5687404474770723
2020-08-19,77.665497,78.683998,77.197502,77.376503,77.376503,33212000,2680448546.2679973,1398824297,17.373700617341502,-32.0,0.5799295608419186,59.16317002377679,78.1446646534608,75.72171138461538,75.30219348068375,-21.855335346539214
2020-08-20,77.172501,79.293503,76.910004,79.087502,79.087502,34138000,2708685589.617292,1432962297,18.916004477826345,-32.0,0.7926715615695343,64.42788853876702,96.76149976418802,75.85269226923077,75.5825867043368,-3.2385002358119857
2020-08-21,78.851501,79.886002,78.400253,79.021004,79.021004,28930000,2703929694.974253,1404032297,20.604053267516296,60.0,0.9450117893581762,64.08210571271503,87.5602484447039,75.9727308076923,75.83728428179334,-12.439751555296104
2020-08-24,79.698997,80.708504,79.028503,79.410004,79.410004,28198000,2688538312.586981,1432230297,22.502594811904864,64.0,1.0846286425902036,65.25680047482035,82.76824638342181,76.11244265384616,76.10193018684569,-17.23175361657819
2020-08-25,79.1035,80.581001,79.1035,80.411003,80.411003,44942000,2723138458.1774063,1477172297,24.265526245979963,64.0,1.2615063977709724,68.14398375579495,95.98432935353574,76.19417342307692,76.42112076559786,-4.015670646464259
2020-08-26,80.400002,82.960999,80.18,82.619003,82.619003,79868000,2783362771.4820857,1557040297,26.70631423076518,72.0,1.5618464464422743,73.3957528818103,96.32538949178044,76.37486592307692,76.88022315333136,-3.674610508219561
2020-08-27,82.683998,82.75,81.287498,81.716499,81.716499,37232000,2767973565.8604865,1519808297,28.97276021663717,72.0,1.7073621603990858,68.42988968408288,86.62834425701084,76.50148126923077,77.23846580864014,-13.371655742989168
2020-08-28,81.6745,82.358498,81.537498,82.220497,82.220497,29980000,2787874954.4597554,1549788297,31.077317203518305,72.0,1.842118048423373,69.6642526440449,91.82758806784722,76.74903896153846,77.60750515614828,-8.17241193215279
2020-08-31,82.394501,82.398247,81.515503,81.709,81.709,36468000,2767394485.6035533,1513320297,33.044684539881594,72.0,1.8859000456113506,66.80927632403197,85.60672860683371,76.98425057692307,77.91131958902619,-14.393271393166286
2020-09-01,81.831497,83.286499,81.611,83.0355,83.0355,36506000,2792962884.931753,1549826297,35.15596078757749,88.0,2.004528105566493,70.21802420670997,96.9174216966725,77.23523126923077,78.29088850835758,-3.0825783033274914
2020-09-02,83.688751,86.658997,83.316498,86.414001,86.414001,50224000,2835824322.3078003,1600050297,37.87072120229083,92.0,2.344136743929454,76.76360738819913,97.87237516283108,77.67357753846154,78.89260054477553,-2.1276248371689137
2020-09-03,85.485703,85.485703,80.752998,82.092003,82.092003,62156000,2808839411.475623,1537894297,38.06933472277848,92.0,2.2387233096676056,58.92251920762278,59.44234437944046,77.90400080769231,79.1295933192366,-40.557655620559544
2020-09-04,81.212997,82.255501,77.380653,79.552002,79.552002,52172000,2803144191.8913407,1485722297,36.14295043753871,92.0,1.9280007579277907,51.36669876148585,32.143049465049685,78.01859696153846,79.160882851145,-67.8569505349503
2020-09-08,76.675499,78.193253,76.400497,76.619499,76.619499,52218000,2763684031.146655,1433504297,33.86449138568902,84.0,1.4286537814031135,44.30313258147548,2.134834527465061,78.1136545,78.97263219550464,-97.86516547253494
2020-09-09,77.876503,78.449997,76.802551,77.848,77.848,35494000,2773238144.1725144,1468998297,31.865797162806896,84.0,1.119146642742436,47.55665977363806,14.110279280596558,78.27232742307692,78.88932610694874,-85.88972071940344
2020-09-10,78.031998,79.204048,76.290253,76.600998,76.600998,32372000,2747770842.0939536,1436626297,30.35497495980718,80.0,0.7644255438744665,44.702169353965964,2.9969396486208684,78.40126976923077,78.71982032124885,-97.00306035137913
2020-09-11,76.800003,78.760002,74.867996,76.036003,76.036003,31942000,2735000693.110627,1404684297,28.205319139570282,76.0,0.43272792460328446,43.4302154635837,9.90591892919006,78.4918661923077,78.52101903819337,-90.09408107080993
2020-09-14,76.950249,78.199997,75.787003,75.963997,75.963997,33932000,2706046542.5441527,1370752297,26.20921016363602,68.0,0.16217543173151228,43.26126834799257,9.295232864453167,78.5287508076923,78.3316099983272,-90.70476713554683
2020-09-15,76.800003,77.9785,76.591751,77.071999,77.071999,26622000,2697863585.5952024,1397374297,24.35568040026849,68.0,0.03674357627093627,46.69735494010929,18.69224673969582,78.61903911538462,78.23830547993259,-81.30775326030418
2020-09-16,77.777,78.099998,75.990997,76.044998,76.044998,26234000,2672973029.4664955,1371140297,22.93725887524808,64.0,-0.1438739808707794,44.035395791950336,9.982205921278458,78.66673134615385,78.07583825919684,-90.01779407872154
2020-09-17,74.800003,75.414902,73.5,74.776497,74.776497,37596000,2685500932.6343865,1333544297,22.812878454337607,-40.0,-0.3849348363992391,40.9317373961509,9.700564564305367,78.69598126923077,77.83144261036745,-90.29943543569463
2020-09-18,74.900497,75.150146,71.856499,72.999496,72.999496,62078000,2666508890.3985305,1271466297,23.319397217705305,-43.99999999999999,-0.7111685227944946,36.99778355836505,7.721649413497601,78.606308,77.47352063922912,-92.2783505865024
2020-09-21,72.002998,72.417999,70.327499,71.557999,71.557999,57776000,2676748549.8101544,1213690297,24.288809515715673,-48.0,-1.0736514449241668,34.13201105139703,7.534520103422187,78.43844253846154,77.03533385113808,-92.46547989657782
2020-09-22,72.504501,73.475998,71.726501,73.273003,73.273003,31664000,2701064570.728167,1245354297,24.512905776645994,-48.0,-1.208603256337156,40.078800731816216,18.03572458570549,78.35715430769231,76.7566426769797,-81.9642754142945
2020-09-23,72.939003,73.047997,70.385002,70.760498,70.760498,33148000,2677264647.917948,1212206297,25.168199537695074,-48.0,-1.5009892253207084,35.08172837944957,2.8565323438053434,78.15951953846154,76.31248381201824,-97.14346765619466
2020-09-24,70.551498,72.185448,70.4925,71.414497,71.414497,29004000,2679852405.0044026,1241210297,25.77668660152636,-48.0,-1.6607904007315142,37.27404382240969,9.11299310647328,77.90892326923077,75.94966997409097,-90.88700689352672
2020-09-25,71.6315,72.5,70.667,72.248001,72.248001,26460000,2699037016.526498,1267670297,26.122825398827505,-48.0,-1.7005740179253763,40.05261560345145,21.635682966432107,77.71167319230769,75.67547227230645,-78.3643170335679
2020-09-28,73.710503,73.839996,72.46505,73.225998,73.225998,40158000,2703328980.0654297,1307828297,25.55643906502654,-48.0,-1.6343469029869482,43.23026317783222,32.65344448613985,77.48623073076922,75.49402973361708,-67.34655551386015
2020-09-29,73.519501,73.833153,72.940247,73.466499,73.466499,19564000,2706825849.0214005,1327392297,25.030508897925646,-48.0,-1.5446492613344844,44.01615409072357,35.36284202340343,77.27259592307692,75.34384227186767,-64.63715797659657
2020-09-30,73.339996,74.487503,72.994003,73.480003,73.480003,34032000,2694942562.781025,1361424297,24.110455650235746,-48.0,-1.4556932485146348,44.06297878470778,37.385151241570796,77.04451896153846,75.20578010358118,-62.614848758429204
2020-10-01,74.213501,74.952003,73.960503,74.504501,74.504501,35590000,2698406297.1632743,1397014297,22.95476183057246,-48.0,-1.28768293364422,47.6409538773549,53.058152571140766,76.8173458076923,75.15383350331591,-46.941847428859234
2020-10-02,73.101501,74.160004,72.545998,72.920998,72.920998,25682000,2684658267.66896,1371332297,22.603854669250968,-48.0,-1.267695798818167,43.05667599148083,33.367633755887205,76.44434561538462,74.98843828084806,-66.63236624411279
2020-10-05,73.310501,74.4105,73.213501,74.301003,74.301003,22266000,2702850646.551482,1393598297,22.10503835278422,-48.0,-1.1275038179850156,47.773282746415035,51.12260548377032,76.15913423076924,74.93751714893338,-48.87739451622968
2020-10-06,73.778999,74.337997,72.429497,72.671997,72.671997,24908000,2684272423.8635077,1368690297,22.03165546208813,-48.00000000000001,-1.134766946187142,43.222145979507474,46.084377431864624,75.79188423076923,74.76970084160499,-53.915622568135376
2020-10-07,73.2145,73.447998,71.800003,73.014503,73.014503,34924000,2700823334.8917575,1403614297,22.262075841574546,-48.0,-1.1002031982408056,44.421025426618534,55.71637318675822,75.4574805,74.63968618667128,-44.28362681324178
2020-10-08,73.254501,74.5,73.254501,74.296501,74.296501,23756000,2716816466.76581,1427370297,21.697449589847874,-48.0,-0.9583177638299532,48.78051455973922,85.8254636605353,75.12136515384614,74.61426506173267,-14.17453633946469
2020-10-09,74.735001,75.825996,74.472504,75.761002,75.761002,28706000,2742765571.6175566,1456076297,20.310199676189985,-44.0,-0.7194066711852116,53.2880587580143,98.8054756171391,74.71163442307693,74.69920853864136,-1.1945243828609005
2020-10-12,77.150002,79.693001,76.628502,78.457497,78.457497,49652000,2752381503.987579,1505728297,20.516928112976785,-40.0,-0.30892223482609893,60.22828640649437,86.7264274523451,74.57184573076924,74.97760027651977,-13.273572547654897
2020-10-13,79.186501,79.5,78.160004,78.584,78.584,32020000,2740624776.2958546,1537748297,20.70889023285024,60.0,0.02629426927093448,60.524604505508115,87.94629770704886,74.53461488461538,75.24474099677755,-12.05370229295115
2020-10-14,78.929497,79.384201,77.526497,78.403999,78.403999,38586000,2738491615.0387325,1499162297,20.489408665435786,60.0,0.27426957852904366,59.84140983680892,85.71901332605661,74.6032495,75.47876010812736,-14.280986673943392
2020-10-15,77.357498,78.755249,77.251503,77.956497,77.956497,30800000,2736571246.5722494,1468362297,20.111751536389672,60.0,0.42972848374802197,58.08595999093304,77.99943696932398,74.60742246153846,75.66229617419201,-22.00056303067603
2020-10-16,78.292503,79.056503,78.150002,78.650497,78.650497,28694000,2739562161.4923654,1497056297,19.905396409956893,60.0,0.6019914039766121,60.04355403132477,86.79204023616889,74.68624934615384,75.88364438351111,-13.20795976383112
2020-10-19,79.023003,79.407501,76.400002,76.730499,76.730499,32142000,2714484392.984379,1464914297,18.627559524478986,60.0,0.5769326958482708,52.7089975626585,62.46670783395607,74.71296073076923,75.94637435510288,-37.53329216604393
2020-10-20,76.352501,78.875,76.283501,77.796501,77.796501,44834000,2722001439.23213,1509748297,17.373849328504082,60.0,0.6357622698691046,55.92793677166581,75.97237450205877,74.78344165384615,76.0834207732434,-24.027625497941226
2020-10-21,78.666496,80.936501,78.581497,79.665497,79.665497,51366000,2717922614.9651647,1561114297,17.265154840253764,88.0,0.8237023603997358,60.947010500726755,86.08871801865438,74.88319157692307,76.34875975300315,-13.911281981345637
2020-10-22,79.652496,81.099503,79.25,80.766502,80.766502,28672000,2736269890.2450643,1589786297,17.23971410231331,92.0,1.0493914072781507,63.57839818518515,96.41915156728861,75.06478788461538,76.67599991944736,-3.580848432711394
2020-10-23,81.303497,82.117996,81.025497,82.050003,82.050003,27516000,2760360906.994736,1617302297,17.678593592777695,96.0,1.3166419778264498,66.41903269310953,99.34102494545208,75.34453811538461,77.07407422171052,-0.658975054547927
2020-10-26,81.250504,81.912003,78.824997,79.522499,79.522499,37066000,2740044864.1584086,1580236297,16.733425096402332,96.0,1.3093976102751128,56.992455861650974,74.84494319777103,75.59542284615385,77.25543902010233,-25.155056802228966
2020-10-27,79.783501,80.342247,79.139,80.212997,80.212997,24580000,2759344211.0589204,1604816297,15.85576863548235,88.0,1.3438823751818916,58.716289861213156,78.50736080970313,75.92830738461538,77.47451738898364,-21.49263919029687
2020-10-28,77.987,78.067497,75.731003,75.831001,75.831001,36680000,2725803895.252417,1568136297,16.017896179605106,88.0,1.006024520049806,46.090548009124525,17.768601418979955,76.02669192307692,77.35277543424411,-82.23139858102003
2020-10-29,76.117996,79.685501,76.112,78.362,78.362,40062000,2736190740.7963247,1608198297,15.328909912636016,84.0,0.9317594595326426,52.45043667018686,41.19304655571083,76.31905738461538,77.42753280948529,-58.80695344428917
2020-10-30,83.605499,84.349998,80.223,81.050499,81.050499,86582000,2684329629.1602154,1694780297,15.572010220982534,100.0,1.0774233983350427,58.10442995915668,61.71828618069743,76.68967284615384,77.69590067544935,-38.281713819302574
2020-11-02,81.407997,83.038498,80.801498,81.301498,81.301498,50708000,2656289487.8995986,1745488297,15.797746221590014,68.0,1.199291949837388,58.599381161785786,64.63044705328167,77.03788426923077,77.96298195874941,-35.36955294671832
2020-11-03,81.588997,83.084999,80.831001,82.510498,82.510498,33234000,2672582065.3836956,1778722297,16.02315452594348,68.0,1.3775503084237073,60.989994220947914,78.65760451189493,77.39498042307693,78.29983499884204,-21.34239548810507
2020-11-04,85.514,88.568253,85.301498,87.456497,87.456497,71418000,2695389508.4193687,1850140297,17.719181572845777,80.0,1.8960654633454652,68.90142962024751,91.33960934000663,77.93305726923077,78.97810625818708,-8.660390659993379
2020-11-05,89.050003,89.681999,87.525497,88.168503,88.168503,41316000,2678711960.779719,1891456297,19.522898135966877,84.0,2.3375001463942056,69.84938894391759,89.15134087917448,78.49799957692309,79.65887638721026,-10.848659120825518
2020-11-06,87.697502,88.621498,87.017502,88.087502,88.087502,33218000,2689812350.60114,1858238297,20.93776408100405,84.0,2.650253734009084,69.58950202704797,88.57073000379324,79.0204226923077,80.28321902519468,-11.429269996206749
2020-11-09,89.544998,90.903,88.000999,88.150002,88.150002,45366000,2649104977.595411,1903604297,22.726710880138324,92.0,2.8700720293311974,69.68323211502258,81.85474199606021,79.60615361538461,80.86594368999506,-18.145258003939787
2020-11-10,86.554497,88.150002,85.864998,87.019501,87.019501,52722000,2649658776.82027,1850882297,23.34989885754667,92.0,2.9194045509729563,65.73649967927972,74.40350798909333,80.09532661538461,81.32176274999543,-25.59649201090667
2020-11-11,87.5,88.210999,87.368248,87.635498,87.635498,25280000,2640412172.212266,1876162297,23.943516777603175,92.0,2.973925181307976,66.83863305063414,78.46359974893215,80.67084588461537,81.78944684258836,-21.53640025106785
2020-11-12,87.3815,88.413498,87.279999,87.491997,87.491997,24950000,2624794955.2142797,1851212297,24.54742085833467,88.0,2.9713025163988362,66.30357563424751,77.51777172115176,81.22767257692308,82.2118579653596,-22.482228278848243
2020-11-13,87.8815,89.052002,87.227501,88.850998,88.850998,29998000,2648183237.8263474,1881210297,25.27890987057538,84.0,3.0437970607988234,68.84701845563534,86.47506982765682,81.78746092307694,82.7036461160737,-13.524930172343174
2020-11-16,88.584999,89.953499,88.384499,89.069,89.069,24936000,2645004684.5261564,1906146297,26.195778225360016,32.0,3.0832981077127783,69.24801141708221,87.91194066278814,82.299307,83.17515381117934,-12.088059337211856
2020-11-17,88.847,89.25,88.349998,88.5075,88.5075,22942000,2630092468.646636,1883204297,27.026456769692125,32.0,3.0343168982270043,66.86084360595865,83.80434047731721,82.68584557692307,83.57014241775865,-16.195659522682785
2020-11-18,88.261497,88.6735,87.306999,87.338997,87.338997,23470000,2607721616.1189027,1859734297,27.168321496085376,32.0,2.868148282268308,62.06579800617325,66.62918539325845,83.02257623076925,83.84931683125801,-33.37081460674155
2020-11-19,86.918999,88.4795,86.85025,88.195999,88.195999,24998000,2624019959.2240124,1884732297,27.03030353549995,32.0,2.7736385770896277,64.09937041819117,73.20199510924213,83.39919161538462,84.17129328820187,-26.798004890757856
2020-11-20,88.260498,88.699997,87.093002,87.109497,87.109497,46270000,2578699836.0437913,1838462297,26.982195795949856,32.0,2.5813115707292553,59.727789617500555,62.33614598254032,83.75123007692308,84.38893800759432,-37.663854017459684
2020-11-23,87.480003,87.695,85.886002,86.742996,86.742996,43232000,2576429257.34774,1795230297,26.204715043281347,31.999999999999996,2.3719748156522655,58.28380696954348,25.73413345206352,84.06248003846153,84.56331267369845,-74.26586654793648
2020-11-24,86.525002,88.580002,86.384499,88.444,88.444,31560000,2604079243.906629,1826790297,25.84384710505725,32.00000000000001,2.3166261122084535,62.78121764642883,51.190968165554516,84.51299930769231,84.85077099416523,-48.809031834445484
2020-11-25,88.644501,88.927002,87.827003,88.571503,88.571503,20916000,2611475927.827251,1847706297,25.648480269603517,32.0,2.257032625325607,63.102329676518394,53.72179288535423,84.92742246153846,85.12638077237521,-46.27820711464577
2020-11-27,88.654503,90.199997,88.622002,89.6595,89.6595,17698000,2617050041.622288,1865404297,25.95733949351804,32.0,2.271413185456396,65.8128304714376,75.31759614228001,85.31180719230768,85.4621673818289,-24.682403857719986
2020-11-30,89.059196,89.403252,87.75,88.037003,88.037003,36476000,2593238440.5499773,1828928297,25.67056293737639,32.0,2.1273649954112273,58.86786964645173,50.103933126628185,85.59144184615386,85.65289594613787,-49.896066873371815
2020-12-01,88.718498,91.241501,88.468498,89.904999,89.904999,34738000,2594491149.3505087,1863666297,26.090106356275438,92.0,2.1392771770520653,63.626878639775065,75.04430492844837,85.89355707692309,85.96786654272026,-24.955695071551638
2020-12-02,89.904999,91.782501,89.473648,91.397499,91.397499,24440000,2610780393.213154,1888106297,26.663160253878743,96.0,2.243290684866949,66.92011150081316,93.47066793363315,86.35028784615385,86.37006153955579,-6.52933206636685
2020-12-03,91.2005,92.360001,91.1325,91.338501,91.338501,24546000,2594473083.928681,1863560297,27.389894948209815,100.0,2.294511790022568,66.66316928873849,84.22149895296548,86.77819184615383,86.73809409218129,-15.77850104703452
2020-12-04,91.225998,91.657997,90.849503,91.399498,91.399498,27564000,2604411062.1251793,1891124297,27.855975300999432,96.0,2.313359860557341,66.80507711138415,85.16368321959882,87.37698019230768,87.08338327053822,-14.83631678040117
2020-12-07,90.949997,91.6185,90.289001,90.973999,90.973999,26418000,2605215763.554816,1864706297,27.87201600603189,92.0,2.267820851881666,64.7349565494873,78.59125403015985,87.86205707692308,87.37157702827612,-21.40874596984016
2020-12-08,90.504997,91.095001,89.810249,90.927498,90.927498,21926000,2621424441.024086,1842780297,27.534393669218947,88.0,2.202588547627144,64.49972667555613,77.8729808268429,88.24194165384614,87.63497858173714,-22.127019173157098
2020-12-09,90.600502,91.713501,88.390503,89.206497,89.206497,30152000,2606080666.0594306,1812628297,26.25706346106435,84.0,1.9890920636940734,56.340026920041666,51.28970517295412,88.54598007692309,87.75138735346032,-48.71029482704588
2020-12-10,88.489998,89.065498,87.015999,88.766502,88.766502,27256000,2625384054.2494226,1785372297,24.49518404341674,80.0,1.7640557066104066,54.4436914411517,44.493364920198495,88.78659561538461,87.82658103098177,-55.506635079801505
2020-12-11,88.153,89.222504,88.0,89.088501,89.088501,24414000,2644445843.9629936,1809786297,22.768770340055152,64.0,1.593328501412529,55.620938724441146,49.46709136037854,88.84936500000002,87.92005658424239,-50.53290863962146
2020-12-14,88.75,89.869499,87.860748,88.002998,88.002998,32004000,2616974579.9765663,1777782297,21.494545797564587,64.0,1.3548174488909837,50.85032661411423,27.08557373087654,88.84299942307692,87.92620039281702,-72.91442626912347
2020-12-15,88.221001,88.570999,87.497498,88.388496,88.388496,29646000,2636540507.5071416,1807428297,20.081255663256375,64.0,1.1832622772699324,52.4113693228324,25.682943232431594,88.85457611538462,87.96044451186762,-74.3170567675684
2020-12-16,88.643997,88.650002,87.804001,88.150002,88.150002,30270000,2631030407.956432,1777158297,18.819034822916528,64.0,1.016343321985417,51.325280137732335,21.220108076306975,88.85457611538462,87.97448580728482,-78.77989192369303
2020-12-17,88.425499,88.589203,86.932999,87.394997,87.394997,32494000,2616664806.4049325,1744664297,17.874228009975678,28.0,0.8137557835489844,47.93854025760259,8.512950612511442,88.86901826923076,87.9315607104489,-91.48704938748855
2020-12-18,87.709,87.755501,86.011002,86.550499,86.550499,80328000,2586020658.348671,1664336297,17.548438887471136,28.000000000000004,0.5783924211438176,44.40872256945998,8.497355252379121,88.82728753846153,87.82925984300824,-91.50264474762089
2020-12-21,85.675499,87.042503,84.949997,86.968498,86.968498,36568000,2620002080.494175,1700904297,17.815766035224623,-48.0,0.42074420933187184,46.508222198598254,27.24021471513376,88.80715296153848,87.76549970648911,-72.75978528486624
2020-12-22,86.721497,86.870247,85.628754,86.175003,86.175003,18734000,2617753761.470226,1682170297,18.06399838671,-48.0,0.22913710082585226,43.17478008625232,16.531785947753974,88.70423007692307,87.64768513563806,-83.46821405224603
2020-12-23,86.405502,87.399498,86.251999,86.619003,86.619003,20676000,2610303349.821937,1702846297,17.856555761008945,-48.0,0.11182512577609316,45.52746737282349,24.676646897821172,88.60999942307693,87.57148645892413,-75.32335310217883
2020-12-24,86.75,87.300003,86.455498,86.942497,86.942497,6936000,2611366888.1645164,1709782297,17.663930465715108,-48.0,0.04444546297899876,47.24136384186175,29.45958189719423,88.54980700000002,87.52489464715197,-70.54041810280577
2020-12-28,87.581749,89.5364,87.31675,88.804497,88.804497,27860000,2620853885.5920386,1737642297,16.95253423486856,-48.0,0.1396842404117109,55.851683811798736,56.9896905509334,88.60617238461539,87.61968000662219,-43.0103094490666
2020-12-29,89.389503,89.622002,87.804497,87.935997,87.935997,25988000,2598626449.6620135,1711654297,16.345468517269094,-48.0,0.14342762170045376,51.61995181961609,44.14871344794067,88.5961723076923,87.64311089502054,-55.85128655205933
2020-12-30,88.100502,88.254753,86.279999,86.975998,86.975998,26122000,2590917766.8427863,1685532297,15.617711776396389,-48.0,0.06814485066796294,47.349417955210875,41.183050642117934,88.59103773076923,87.59369512501902,-58.816949357882066
2020-12-31,86.771004,87.946503,86.771004,87.594002,87.594002,20238000,2599018087.0353174,1705770297,14.941937659871737,-48.0,0.05768550754373791,50.20537847633933,53.74537910544609,88.62376873076923,87.5937178564991,-46.25462089455391
2021-01-04,87.876999,88.032501,85.392502,86.412003,86.412003,38038000,2590358718.64692,1667732297,15.14419615333723,-48.0,-0.04545703772501497,45.15979400028862,29.718577205578935,88.545615,87.50618342268434,-70.28142279442106
2021-01-05,86.25,87.383499,85.900749,87.045998,87.045998,22906000,2602837070.147847,1690638297,15.33200761155519,-48.0,-0.07517359555410508,48.16868772136016,44.86298709012515,88.48694173076923,87.47209561359662,-55.13701290987485
2021-01-06,85.1315,87.400002,84.949997,86.764503,86.764503,52042000,2627881052.6270666,1638596297,16.035565182130618,-48.0,-0.12005456142527748,46.937298366207806,38.83784370949965,88.3755956923077,87.4196813459228,-61.16215629050035
2021-01-07,87.002998,89.419998,86.852501,89.362503,89.362503,45300000,2671152210.1396165,1683896297,15.160647443522326,-48.00000000000001,0.053398295073662894,57.688206671930566,94.44566091003774,88.42657646153846,87.56359406103962,-5.554339089962256
2021-01-08,89.399002,90.491997,88.67675,90.360497,90.360497,41012000,2706222233.0973735,1724908297,14.466954309169243,-48.0,0.26829793711614514,60.96036990765314,97.62721039335976,88.44409561538463,87.77077205651817,-2.3727896066402487
2021-01-11,89.303497,89.715752,88.026001,88.335999,88.335999,24194000,2690905389.094914,1700714297,13.458472837421054,-48.0,0.27211066023072306,52.14986457751868,61.09711295561176,88.32634561538461,87.81264071899831,-38.90288704438824
2021-01-12,87.695999,88.902,86.265503,87.327499,87.327499,27140000,2685629682.0867133,1673574297,13.504712739791453,-32.0,0.19154671782499122,48.397384858017126,42.89971129556128,88.17207630769232,87.7767042953688,-57.10028870443872
2021-01-13,86.929001,88.251747,86.900497,87.720001,87.720001,21882000,2690289604.792356,1695456297,13.547649791992537,-32.0,0.15755465220426856,49.908102520211656,49.98202814868277,88.0305571923077,87.7725040512674,-50.01797185131723
2021-01-14,87.681,88.750504,86.669998,87.009003,87.009003,23590000,2674387280.723115,1671866297,13.233852888310368,-32.0,0.07240940817430896,47.21177225218073,37.152760736196505,87.87805734615384,87.71594841784018,-62.847239263803495
2021-01-15,86.9095,87.800003,86.077499,86.809502,86.809502,26844000,2670358773.206151,1645022297,13.28374916840931,-32.0,-0.01103961672865239,46.45340260902756,33.55295922049798,87.71967288461539,87.64880423874091,-66.44704077950202
2021-01-19,87.612503,90.463753,87.072998,89.542999,89.542999,34692000,2686209660.965367,1679714297,12.99141603830212,48.0,0.14176264144400363,56.71330583782344,82.87625405990612,87.73261526923078,87.78911496179714,-17.12374594009388
2021-01-20,91.572998,95.185501,91.276497,94.345001,94.345001,49806000,2714597446.5045986,1729520297,14.531251992909509,76.0,0.6429296683149488,68.22978951095791,91.78838677606882,87.94717292307692,88.27473614981217,-8.211613223931185
2021-01-21,94.900002,96.742996,94.355499,94.5625,94.5625,41278000,2680477224.946205,1770798297,16.38299800944353,80.0,1.0456054110962896,68.63679986476237,81.51025027645636,88.15771134615383,88.74049643501127,-18.489749723543632
2021-01-22,94.783997,95.547501,94.087997,95.052498,95.052498,25442000,2688661490.365142,1796240297,17.937763641260577,80.0,1.3882645325221858,69.58224060270007,85.66524087723569,88.42884596153846,89.2080521064919,-14.33475912276431
2021-01-25,96.033501,96.478996,93.376503,94.970001,94.970001,38546000,2689711372.7139497,1757694297,19.63769877184588,80.0,1.63432802044818,69.20399521465416,84.96569871667073,88.68198076923076,89.63486313564066,-15.034301283329265
2021-01-26,94.442001,96.25,94.21225,95.862,95.862,26262000,2705972483.4979024,1783956297,21.21620996453223,80.0,1.8796445990745667,71.03726228890434,92.52949991770534,88.97859607692308,90.09613253300061,-7.47050008229467
2021-01-27,94.126503,94.5,90.449997,91.539497,91.539497,54966000,2680579526.7771297,1728990297,20.519135858066967,80.0,1.7056086923109035,54.19956254977009,51.21184694909195,89.13799992307692,90.20304841944501,-48.78815305090806
2021-01-28,92.196999,94.941498,92.132004,93.155502,93.155502,35462000,2670955123.209797,1764452297,20.03811347595634,80.0,1.67873071758369,58.18956624678975,66.36355530361121,89.3920385,90.42174868467131,-33.63644469638879
2021-01-29,92.308502,92.863998,90.510002,91.787003,91.787003,32252000,2673695396.9876623,1732200297,18.825755831542466,40.0,1.5293736294916158,53.906714850743136,53.53247016993201,89.57736561538461,90.52287863395493,-46.46752983006798
2021-02-01,92.678497,96.119598,92.546501,95.067497,95.067497,32044000,2686868638.9623413,1764244297,18.87143163068824,40.0,1.6566190376303922,61.266342475372674,84.29047422731448,89.91938461538462,90.85951703143976,-15.709525772685527
2021-02-02,96.127998,97.788002,95.724503,96.375504,96.375504,45474000,2670087281.3857203,1809718297,19.405101700827498,72.0,1.841776322780376,63.75155248108578,87.93819531065404,90.29463465384615,91.26810865874053,-12.061804689345957
2021-02-03,103.650002,105.824997,100.918999,103.503502,103.503502,82364000,2674502772.568554,1892082297,21.515914224638607,76.0,2.5344688929374257,73.66707942089002,88.2441056583472,90.93159638461537,92.17443409142642,-11.755894341652798
2021-02-04,103.444504,103.927498,102.129501,103.1185,103.1185,37046000,2678211520.1615696,1855036297,23.475954425320346,76.0,3.0175815004059245,72.5132964200153,86.29448145785355,91.48213496153845,92.98510564020964,-13.705518542146452
2021-02-05,103.5,105.125504,102.966499,104.900002,104.900002,30702000,2702500045.061697,1885738297,25.479748695606304,76.0,3.5038142555404335,74.5032524471713,95.06721923353346,92.13459669230768,93.86769055574966,-4.932780766466528
2021-02-08,105.295502,106.177353,103.599998,104.6455,104.6455,24838000,2697813074.8391237,1860900297,27.497901961330022,88.0,3.8245341832892166,73.68256998125372,90.2599457912697,92.81419292307692,94.66604681087932,-9.740054208730305
2021-02-09,103.927002,105.2565,103.927002,104.175499,104.175499,17798000,2686668337.3577585,1843102297,29.37190142235919,88.0,3.9947330875563267,72.10297632688633,87.27151594966125,93.4519428076923,95.37045067674012,-12.72848405033875
2021-02-10,104.710503,105.418503,103.154503,104.768997,104.768997,22710000,2696348053.5591717,1865812297,30.702463746386197,88.0,4.129900353434493,72.89322473825848,91.04518267406169,94.15798103846154,96.06663929327789,-8.954817325938306
2021-02-11,104.975502,105.101501,103.865997,104.794502,104.794502,18914000,2705862522.5402513,1884726297,31.937985904411274,88.0,4.1907708283711145,72.92871468829776,91.20735233563734,94.8406158076923,96.71314764192397,-8.79264766436267
2021-02-12,104.512497,105.441002,104.156502,105.205498,105.205498,17114000,2716701060.561271,1901840297,33.15455243997383,60.0,4.223489304992455,73.53013245228931,93.82060786313993,95.54988484615384,97.34221063141108,-6.179392136860073
2021-02-16,105.218002,107.634003,105.218002,106.095001,106.095001,22676000,2710487660.803572,1924516297,34.70293481322756,80.0,4.271950011120367,74.83326547080566,91.04398590177395,96.19344246153847,97.99056547352878,-8.956014098226046
2021-02-17,105.0,106.682999,104.945999,106.415497,106.415497,21418000,2725308818.159934,1945934297,35.973587279489564,80.0,4.286801242290423,75.30500876672154,92.88422139195153,96.81094246153846,98.61463447548961,-7.115778608048461
2021-02-18,105.519501,106.636749,105.185501,105.860001,105.860001,22432000,2723728366.6202936,1923502297,37.153478855304286,80.0,4.205271315232324,72.7592905486067,89.64025989019734,97.48494253846154,99.15132829212001,-10.359740109802665
2021-02-19,105.963501,106.526497,104.870499,105.056999,105.056999,29148000,2701145715.129169,1894354297,38.032408596466205,80.0,4.029414132320909,69.12164080334595,82.91961121198193,98.16684638461538,99.58878538159261,-17.08038878801807
2021-02-22,103.349998,104.570999,103.107002,103.244003,103.244003,27350000,2678914547.1349726,1867004297,37.705278193193074,80.0,3.7010885772499194,61.62980700019378,63.13867080901803,98.76392338461537,99.85954224221538,-36.86132919098197
2021-02-23,101.250504,104.100502,100.100998,103.542999,103.542999,33348000,2702965589.2901998,1900352297,35.835436708642696,80.0,3.425527340915096,62.354477595842575,45.692270216201756,99.39984630769231,100.13239089094017,-54.307729783798244
2021-02-24,102.091499,105.039001,101.906502,104.758499,104.758499,24966000,2723460390.4601283,1925318297,34.42996091454242,76.0,3.267557399730663,65.22944268858868,61.827929226118854,100.09019234615386,100.47506556568534,-38.172070773881146
2021-02-25,103.372498,104.744003,101.064499,101.568001,101.568001,36568000,2696900294.316735,1888750297,32.72543494295458,52.0,2.852041993962459,53.64803688259566,19.474339921452206,100.55269242307692,100.55602374600494,-80.5256600785478
2021-02-26,102.526001,103.550499,100.803001,101.843002,101.843002,41670000,2686776698.84187,1930420297,31.01751188449916,52.0,2.5159312345262492,54.39956813733646,23.124954782321183,100.84107707692307,100.6513554685231,-76.87504521767882
2021-03-01,102.825996,104.325996,102.305,104.0755,104.0755,28090000,2707903367.2568493,1958510297,29.745333726785496,52.0,2.4020160214690662,60.06090072806552,52.76117565300965,101.2069616923077,100.90499580418806,-47.23882434699035
2021-03-02,103.809502,105.218498,103.563004,103.792,103.792,22692000,2691489103.3670373,1935818297,28.91330448001697,52.0,2.262777424099852,59.05818806333542,48.9977372907624,101.5430963846154,101.1188479668408,-51.0022627092376
2021-03-03,103.360497,104.425903,100.5,101.335503,101.335503,29684000,2674439685.0426416,1906134297,27.009217654051525,52.00000000000001,1.9319408429803673,51.09779238966729,16.387948766793574,101.78792338461538,101.13489648781557,-83.61205123320642
2021-03-04,101.168503,104.461998,101.013496,102.454498,102.454498,42360000,2667481053.3585076,1948494297,25.225197092441373,52.0,1.7399865319268741,54.13079209666629,31.242512118337846,102.04148099999999,101.23264474797737,-68.75748788166216
2021-03-05,103.655998,105.905502,102.320747,105.427002,105.427002,43904000,2699664272.4404254,1992398297,23.90434052716447,44.0,1.80688889754677,61.04288647368126,70.70224963344636,102.5756158076923,101.54333787775683,-29.297750366553647
2021-03-08,105.056503,106.440498,101.080498,101.208504,101.208504,32948000,2668289982.0255,1959450297,22.277372306136233,44.0,1.5021955954250643,49.61594999502347,16.826281247906255,102.88534665384616,101.51853536829337,-83.17371875209375
2021-03-09,103.5,103.902,102.391502,102.635002,102.635002,33946000,2645288519.5224047,1993396297,20.766616100895725,40.0,1.3601514459516437,52.83142758322488,38.77142810367163,103.30257738461539,101.60123660027165,-61.22857189632837
2021-03-10,103.587997,103.75,101.668503,102.751503,102.751503,25372000,2646318552.2901673,2018768297,19.698713245857785,36.0,1.2426565203419813,53.09470731830966,41.24979242857239,103.59811607692308,101.68644151877004,-58.75020757142761
2021-03-11,103.703003,106.285004,103.619003,105.738503,105.738503,24782000,2660940475.244435,2043550297,19.024191178683566,-20.0,1.374719965857551,59.35834137013516,88.92665036674799,103.95823142307692,101.98659422108338,-11.073349633252002
2021-03-12,104.25,104.513,102.377502,103.096001,103.096001,34516000,2649650637.464207,2009034297,17.813784153348927,-19.999999999999996,1.2517242725622708,52.65886573650111,47.24352078239603,103.94255830769231,102.06877250100312,-52.75647921760397
2021-03-15,103.114998,103.352997,102.175499,103.324501,103.324501,25962000,2674356052.4814725,2034996297,16.596297728656122,-20.0,1.1593233815467414,53.1512594931359,47.54653566081489,103.95048142307692,102.16178942685475,-52.45346433918511
2021-03-16,103.949501,106.178001,103.5,104.625999,104.625999,29832000,2669610527.1825647,2064828297,16.613470784509254,-20.0,1.1775410608759103,55.96092154024034,69.45543959445807,103.93994284615384,102.34432346930996,-30.544560405541933
2021-03-17,103.801498,105.488998,102.699997,104.554001,104.554001,25980000,2678171227.540865,2038848297,16.236697558635928,-20.0,1.1726514699130064,55.76169200607214,68.24345366331234,103.93642365384615,102.50800328639811,-31.756546336687666
2021-03-18,103.050003,103.775002,101.677498,101.810997,101.810997,27228000,2654409166.8401465,2011620297,15.403056013326777,-20.0,0.9366419103846653,48.65472105041892,22.06880635259871,103.84548126923076,102.45637319110936,-77.93119364740129
2021-03-19,102.102501,102.654999,100.884003,102.160004,102.160004,46298000,2674826500.243497,2057918297,14.338059898905906,-20.000000000000004,0.7689011681856925,49.536018453173114,27.943852518761883,103.7451353846154,102.43441991769386,-72.05614748123811
2021-03-22,102.092003,102.899498,101.303497,101.929497,101.929497,39096000,2666399774.260243,2018822297,13.392105350758277,-20.0,0.610329929503493,48.93855984654121,24.063588608227736,103.6349428846154,102.3970182200869,-75.93641139177227
2021-03-23,102.584999,103.615097,101.960999,102.648003,102.648003,27340000,2661770265.8514304,2046162297,12.848856604637719,-20.0,0.5364545951569966,50.92545069319604,31.746631644588835,103.53657769230769,102.41560968526565,-68.25336835541117
2021-03-24,103.268501,103.9105,102.077751,102.252998,102.252998,23080000,2643104073.4813895,2023082297,12.483400945142122,-16.0,0.4409512466501013,49.77866808284699,24.637743757530576,103.38880834615384,102.40356437524598,-75.36225624246943
2021-03-25,102.240501,102.943497,100.536499,102.218002,102.218002,28378000,2654375206.662223,1994704297,11.839569175288698,-12.0,0.35830989671850944,49.67194511776083,28.480746693893284,103.22736623076922,102.38981901411664,-71.51925330610672
2021-03-26,101.943001,102.5495,100.700996,101.777496,101.777496,29870000,2659295561.4572353,1964834297,11.241725388996231,-8.0,0.2543390168949742,48.26912451315171,21.588169445794936,103.0703468076923,102.3444617538117,-78.41183055420507
2021-03-29,101.393997,102.921501,100.780998,102.797501,102.797501,24596000,2681041853.701628,1989430297,10.477547980449502,36.0,0.2513498202594917,51.672577515766314,39.33200023310396,102.98344303846154,102.37802021649232,-60.66799976689604
2021-03-30,102.8815,103.539001,102.2015,102.777,102.777,20732000,2678150985.783025,1968698297,10.035984271390012,36.0,0.24450806426007432,51.59909746238079,38.975368378387024,102.9654813846154,102.40757427452992,-61.024631621612976
2021-03-31,102.956001,104.666351,102.83725,103.431503,103.431503,29198000,2667925146.526472,1997896297,10.216894594363989,12.0,0.28857236295841915,53.85517301281097,51.316192035383594,102.96119307692308,102.48342084678696,-48.683807964616406
2021-04-01,104.897499,107.147003,104.844498,106.887497,106.887497,33980000,2694245650.5601225,2031876297,11.446662061136378,84.0,0.5954989290273858,63.52364132362764,96.07433865859545,103.04307761538462,102.80964870998793,-3.9256613414045605
2021-04-05,107.647003,111.865501,107.581001,111.277496,111.277496,43298000,2725659211.0736012,2075174297,13.927488632384527,88.0,1.179381498693644,71.64953255724714,94.80973699183744,103.41651973076922,103.43689665739623,-5.190263008162555
2021-04-06,111.125,111.883003,110.739998,111.237503,111.237503,27060000,2722155512.752072,2048114297,16.235076006850512,92.0,1.620208782635089,71.49327933186746,94.31102302524198,103.7778466923077,104.01471934944095,-5.688976974758028
2021-04-07,111.306503,112.75,111.266502,112.484001,112.484001,25798000,2738702078.3692822,2073912297,18.57801082890324,96.0,2.0465581044395265,73.43763060029765,97.82209048822287,104.10125057692306,104.64207354577866,-2.177909511777121
2021-04-08,113.898003,114.200249,112.884003,113.272003,113.272003,27166000,2727551941.665353,2101078297,21.066054713215607,100.0,2.420130432298393,74.61632801697056,93.20650626658127,104.46586607692308,105.28132757942468,-6.793493733418732
2021-04-09,112.834999,114.452003,112.685699,114.293999,114.293999,20888000,2744702886.7167144,2121966297,23.42893765408394,40.0,2.766762217004924,76.09775667718581,98.8645470548533,104.96426976923077,105.94893286983768,-1.1354529451466895
2021-04-12,113.3125,113.765999,111.923248,112.739502,112.739502,31318000,2741129755.960579,2090648297,25.08368189508767,39.99999999999999,2.8828043136609836,69.45769605428711,87.69357545368098,105.35984684615384,106.45193799059044,-12.306424546319008
2021-04-13,113.073502,113.860497,112.804497,113.363503,113.363503,23310000,2742498600.392397,2113958297,26.645009498514863,40.0,2.9906458729936816,70.56789693295374,92.17778960790777,105.6650968846154,106.96390576906522,-7.822210392092234
2021-04-14,113.758003,113.899498,112.459503,112.741997,112.741997,20220000,2730212001.1055937,2093738297,27.833429489359048,40.0,2.9914768625222052,67.91975882871591,87.71150509532383,106.10869276923077,107.39191252691225,-12.28849490467616
2021-04-15,113.848999,115.329849,113.300003,114.833,114.833,27472000,2744235260.9272747,2121210297,29.342352385974454,56.0,3.1248406763975964,71.75948365911277,96.60363666242324,106.57784653846154,107.9431041915854,-3.396363337576758
2021-04-16,115.150002,115.321999,114.222504,114.888,114.888,22596000,2748992814.3604417,2143806297,30.74349507568876,56.0,3.19810473938945,71.85490771497454,96.96299728411549,107.04463488461539,108.45754091813464,-3.0370027158845097
2021-04-19,114.598999,115.922501,114.39225,115.120003,115.120003,24688000,2747786930.7766376,2168494297,32.21393701777445,64.0,3.237567082310264,72.28039623916727,94.15131592804345,107.4054618076923,108.95105662790243,-5.848684071956557
2021-04-20,115.394501,115.480003,113.585503,114.681503,114.681503,21774000,2751206178.5992823,2146720297,32.898548447375006,64.0,3.1966094640025062,70.12263165282425,90.5160550607704,107.85105803846153,109.3755341369467,-9.4839449392296
2021-04-21,114.262497,114.765999,112.928497,114.664497,114.664497,23930000,2772492434.146215,2122790297,33.00406782930342,64.0,3.126734960040565,70.03531082239408,88.6441265632443,108.28721173076923,109.76730916383953,-11.355873436755706
2021-04-22,114.661499,115.188103,112.822502,113.396004,113.396004,21096000,2761625207.4617486,2101694297,33.26588580156244,64.0,2.9351673462807497,63.666728477974466,69.71171851585454,108.62451961538463,110.03610137392549,-30.288281484145454
2021-04-23,114.1735,116.291,113.9105,115.764999,115.764999,28670000,2777625223.281955,2130364297,33.91406025193352,80.0,2.9406092175939165,69.28428105275158,90.5242152678022,109.05571184615386,110.46046416104213,-9.475784732197791
2021-04-26,115.996498,117.063004,115.692001,116.336998,116.336998,20834000,2776394196.4308095,2151198297,34.77635865394768,84.0,2.9569911256872246,70.47141857932088,87.47510136285622,109.6144041923077,110.8957629639279,-12.524898637143778
2021-04-27,116.800003,116.872498,115.213501,115.356003,115.356003,31972000,2749914760.846538,2119226297,35.15477424370564,84.0,2.857872038003194,65.77610392235619,66.78828722608615,110.1219426153846,111.22615111474806,-33.211712773913845
2021-04-28,120.357246,122.618896,118.7425,118.995499,118.995499,59728000,2697983242.0481486,2178954297,36.9774464957776,92.0,3.0379764560512683,72.9712129678775,66.12269775519904,110.7783273076923,111.80165836550748,-33.877302244800966
2021-04-29,120.516502,121.825996,120.113998,121.494499,121.494499,39554000,2722219429.3661246,2218508297,38.669927872701564,92.0,3.343813519125405,76.6077616466469,89.48734101945014,111.50319253846153,112.51964656065508,-10.512658980549858
2021-04-30,120.224503,121.357002,120.108002,120.505997,120.505997,39142000,2708022698.0450673,2179366297,40.23674596285798,92.0,3.466468454364403,72.4550887678005,79.20250747264122,112.20523096153846,113.11122807468062,-20.79749252735878
2021-05-03,120.136002,120.985001,119.224998,119.758499,119.758499,33788000,2694718676.5246496,2145578297,40.981987747563934,88.0,3.4634322417526135,69.39185181935565,71.84480411378904,112.87986546153846,113.60361851359318,-28.155195886210954
2021-05-04,118.487,118.962997,115.584999,117.712502,117.712502,35120000,2703836657.3405056,2110458297,39.3552247570694,84.0,3.258370693504034,61.70243122510043,49.916326354370774,113.4927503076923,113.90798025332701,-50.083673645629226
2021-05-05,118.420998,119.110001,117.570503,117.836998,117.836998,21806000,2689580118.2297044,2132264297,37.898897602227116,80.0,3.070508811616918,61.978520313136876,51.18716131670481,114.0711925,114.19901860493242,-48.81283868329519
2021-05-06,117.531998,119.135498,117.116898,119.067497,119.067497,20618000,2708808992.481166,2152882297,36.292288103450446,76.0,2.9864914874989097,64.68814488424009,63.74789539906214,114.69775007692307,114.55964663419668,-36.25210460093787
2021-05-07,120.0,120.820503,119.5,119.934502,119.934502,23272000,2700851960.4047523,2176154297,35.44648797346456,72.0,2.955794649657193,66.49970899204317,72.59814172439359,115.33248080769229,114.95778406870062,-27.40185827560641
2021-05-10,118.744499,118.900002,116.736504,117.083,117.083,26006000,2683175965.7719865,2150148297,33.24906485379454,68.0,2.6705899060528964,56.274312967937995,43.49047210636889,115.72461553846152,115.11520747101909,-56.50952789363111
2021-05-11,114.593002,116.099998,114.150002,115.438004,115.438004,32110000,2693484251.9838557,2118038297,31.571620500666103,64.0,2.2854800709663152,51.36724044649951,26.698619920758645,115.88463507692308,115.13911832501768,-73.30138007924135
2021-05-12,113.085503,114.268501,111.502502,111.954002,111.954002,34934000,2669954956.757791,2083104297,30.865070000868247,60.0,1.6797843987934442,42.84570588244309,4.0615688864572075,115.91219273076922,114.90318378242378,-95.93843111354279
2021-05-13,113.054497,113.830048,112.136002,113.098503,113.098503,26670000,2673590983.477254,2109774297,30.208987393913095,-39.99999999999999,1.2773928904096579,46.014066830052386,14.357182733897224,115.93582742307693,114.76950372446646,-85.64281726610278
2021-05-14,114.591499,116.056999,114.166,115.807999,115.807999,26624000,2693203476.8609095,2136398297,28.607947211459155,-40.0,1.1637138352324996,52.69921659496986,38.73105793119593,116.03336573076923,114.84642930043191,-61.26894206880407
2021-05-17,115.466003,116.167,114.75,116.070503,116.070503,19842000,2710343016.0648613,2156240297,27.074809861414373,-40.0,1.0823278423132763,53.302547828897076,41.09247117365573,116.10169280769232,114.93710142632584,-58.90752882634427
2021-05-18,116.845299,117.157501,115.157997,115.171501,115.171501,17302000,2693274720.231495,2138938297,25.228150879303147,-40.0,0.9345144080624692,50.907687128071736,35.54028316382032,116.19523123076922,114.9544643577091,-64.45971683617968
2021-05-19,113.220001,115.837997,113.176003,115.435501,115.435501,19350000,2706773243.781886,2158288297,24.264369084045207,-40.0,0.8291162540703567,51.59546202468836,39.91069054746563,116.27492346153846,114.9900967015825,-60.089309452534366
2021-05-20,116.402,118.016998,116.054497,117.804497,117.804497,23832000,2725444152.060659,2182120297,22.586167376836762,-40.0,0.9260704724062379,57.36737746324759,66.45922135082742,116.469635,115.19857079776158,-33.54077864917257
2021-05-21,118.2995,118.449997,117.1185,117.254997,117.254997,22832000,2707293348.4944477,2159288297,21.193619269733848,-40.0,0.9476434870864097,55.70802110089821,61.73529064871317,116.56278873076923,115.35089866459404,-38.26470935128684
2021-05-24,118.349998,120.924004,118.005501,120.333504,120.333504,21244000,2719940761.819704,2180532297,20.771426671484345,-40.0,1.1993249716696113,62.28912064388601,93.73242185800108,116.7722311923077,115.71998054129078,-6.267578141998932
2021-05-25,121.0,121.644501,120.149498,120.453499,120.453499,18838000,2708763978.3363266,2199370297,20.609098408912352,-40.0,1.3924160496573705,62.52286837683757,88.25673321403391,116.97736565384615,116.0706115382322,-11.743266785966078
2021-05-26,120.641747,122.147202,120.625748,121.676498,121.676498,21856000,2717096458.5664225,2221226297,20.619807094767687,-40.0,1.6253914178852824,64.91018211567324,95.57804353340161,117.24640392307694,116.48586238725204,-4.421956466598386
2021-05-27,121.847,122.0,120.099998,120.125504,120.125504,38962000,2679180525.6463523,2182264297,20.368493095652553,-40.00000000000001,1.665672980823004,59.715060383954864,81.00746850545352,117.45644265384615,116.75546546967782,-18.99253149454648
2021-05-28,121.098,121.406998,120.384499,120.578003,120.578003,24108000,2664197218.055831,2206372297,20.13513009647421,-40.0,1.7143473679585384,60.703230996424516,85.25840089434179,117.73267338461537,117.03861639784984,-14.741599105658212
2021-06-01,121.099998,121.898552,120.244003,121.490501,121.490501,19166000,2673909638.2996554,2225538297,20.1067244364375,-40.0,1.8057377126606582,62.690721440515205,93.83072327073569,117.952885,117.36838562763874,-6.16927672926432
2021-06-02,121.765503,122.099998,120.209999,121.064003,121.064003,17158000,2672257467.278401,2208380297,20.15969089020084,-40.0,1.8227389945479615,61.13438490317008,89.18012825635294,118.13469288461539,117.64213506262845,-10.819871743647061
2021-06-03,119.750999,120.487251,119.141502,120.230499,120.230499,18346000,2683603094.7096677,2190034297,19.576472405472284,-40.0,1.7487967852625417,58.098797366595974,78.63492940018386,118.32217350000002,117.83386572465598,-21.36507059981613
2021-06-04,121.125999,122.692947,120.888496,122.587997,122.587997,25948000,2706532733.335488,2215982297,19.91532873675885,64.0,1.8589980653350722,63.603624429153,98.89723003518773,118.4603465,118.18602359690368,-1.102769964812257
2021-06-07,122.566002,123.400002,122.05365,123.304497,123.304497,23850000,2726999079.9521227,2239832297,20.47929306347496,68.0,1.9813096315989043,65.10414045164444,99.06587432177953,118.52996180769232,118.56516977491081,-0.9341256782204573
2021-06-08,123.995003,124.724747,123.412003,124.142502,124.142502,25060000,2729829216.8561954,2264892297,21.441966740722087,72.0,2.121408156374258,66.82674535967394,94.9583694988823,118.66982738461539,118.9783054952878,-5.041630501117701
2021-06-09,124.974998,125.25,124.366501,124.57,124.57,20126000,2718974581.9035807,2285018297,22.501351002240263,76.0,2.2410987708692147,67.7026382254834,92.60508098360681,118.8548851153846,119.39250508822946,-7.394919016393194
2021-06-10,124.7005,126.163002,124.699997,126.080002,126.080002,31234000,2746664613.154328,2316252297,23.765535980092185,80.0,2.429789881702945,70.65040511415347,99.08231542212039,119.17671203846155,119.8878752298421,-0.9176845778796062
2021-06-11,126.246002,126.349503,124.914497,125.696503,125.696503,25240000,2748933670.872554,2291012297,24.996545613322155,84.0,2.5193423715959966,68.92970995937,92.17401913374432,119.4790006923077,120.3181439535575,-7.825980866255681
2021-06-14,125.669502,126.411499,125.046997,126.351997,126.351997,22550000,2769516989.841672,2313562297,26.15970587190959,88.0,2.613084244058115,70.26285593053453,99.1815402399752,119.75917376923076,120.76509603107175,-0.8184597600247843
2021-06-15,126.522003,126.862,125.648499,126.032997,126.032997,22182000,2761391730.8513618,2291380297,27.39054982052253,92.0,2.6313026997585496,68.71757700902387,89.2623118353246,119.99373126923078,121.15531091765902,-10.7376881646754
2021-06-16,126.247498,126.523499,124.149948,125.696503,125.696503,26316000,2769369614.892615,2265064297,27.365044311590005,92.0,2.5887472368485334,67.04262105027989,84.90386241923787,120.32501984615386,121.49169551635094,-15.096137580762134
2021-06-17,125.523003,127.196503,125.514999,126.371002,126.371002,25756000,2769836821.3411274,2290820297,27.613888011767575,100.0,2.5797108572256064,68.69004965324359,89.75169587191854,120.74551976923077,121.85312562625087,-10.248304128081452
2021-06-18,125.705498,126.389,124.602997,125.567497,125.567497,53306000,2774104786.2224855,2237514297,27.18231029289484,96.0,2.4791353933361364,64.55056800650883,79.77646433563443,121.26911573076924,122.12826424652859,-20.223535664365567
2021-06-21,125.739998,127.036751,125.134247,126.455002,126.455002,26256000,2784303630.238582,2263770297,27.069727853344954,80.0,2.442882817430288,66.92173306636184,90.79452628249192,121.78282723076924,122.44876333937832,-9.205473717508085
2021-06-22,126.449997,127.269997,126.026497,126.999496,126.999496,20984000,2796158248.6800776,2284754297,27.06911292955358,92.0,2.430076100496308,68.32171101686612,96.67218839403837,122.21326942307692,122.7858546475725,-3.327811605961621
2021-06-23,126.550003,127.795998,126.251999,126.461502,126.461502,19694000,2781808749.657086,2265060297,27.304780031513964,96.0,2.349432272693363,65.3774556199251,80.6804833353649,122.61292323076921,123.0581248218264,-19.3195166646351
2021-06-24,127.053497,127.5355,126.959999,127.281998,127.281998,18934000,2784062302.992354,2283994297,27.523613769048612,96.0,2.3249283019338804,67.66600275703573,91.04895767375999,123.07871157692308,123.37100431650592,-8.951042326240005
2021-06-25,126.957001,127.504997,126.444,126.995003,126.995003,33484000,2785356505.8562636,2250510297,27.269992113639354,92.0,2.2563409367868985,66.02211241907716,81.72910781148244,123.52330780769232,123.6394486634314,-18.270892188517564
2021-06-28,127.0,127.336998,125.973801,126.819504,126.819504,28110000,2792124386.793502,2222400297,26.62776109825692,88.0,2.162891189885002,64.98247107527571,73.2177562019171,123.87003884615385,123.87500831799203,-26.782243798082906
2021-06-29,126.772499,127.0,125.436996,126.018501,126.018501,20950000,2786762996.611519,2201450297,25.57981490895983,84.0,2.001129568353477,60.31418192934818,51.24869379191192,124.20709669230769,124.03378555369632,-48.75130620808808
2021-06-30,125.653549,125.800003,124.7575,125.316002,125.316002,24006000,2788478551.3926563,2177444297,24.063602118979496,56.0,1.7955485535540845,56.481820480937635,31.98129482590754,124.39873123076922,124.12876454971882,-68.01870517409246
2021-07-01,124.849747,126.462502,124.849747,126.3685,126.3685,17120000,2803602818.3271875,2194564297,23.110453982158496,56.0,1.6979786695539474,60.52843317372291,60.84809588458746,124.62623126923077,124.29467087936928,-39.15190411541254
2021-07-02,126.8395,128.848007,126.768997,128.718994,128.718994,21160000,2822136650.025929,2215724297,23.53374993871876,84.0,1.7896886388466697,67.74241876742185,97.25390847581977,124.8970965,124.62239851793451,-2.7460915241802253
2021-07-06,129.449493,129.884506,128.408997,129.770996,129.770996,21350000,2840201765.2844605,2237074297,24.370795632835378,88.0,1.9250662542316235,70.35397552749903,98.02059722824337,125.26807696153845,125.00377610919861,-1.9794027717566207
2021-07-07,130.341003,130.639893,129.759995,130.077499,130.077499,16680000,2835559448.561385,2253754297,25.445539748049168,92.0,2.033643642305506,71.0883925852454,90.68405352684537,125.6334421923077,125.37960743444316,-9.315946473154614
2021-07-08,128.25,130.032501,128.039993,129.177002,129.177002,19780000,2838354051.0422783,2233974297,25.08677307229068,92.0,2.023701451852787,65.92143199120045,75.7674970713424,125.92907684615383,125.6608959207807,-24.232502928657603
2021-07-09,128.944504,129.849503,128.943497,129.574493,129.574493,15106000,2844289469.2580514,2249080297,24.753632587657798,92.0,2.024558545351624,67.0595712791192,81.88832334051789,126.25640338461538,125.95079200072287,-18.111676659482114
2021-07-12,129.833496,130.770004,129.600006,130.563995,130.563995,16944000,2855266593.253135,2266024297,24.887468018307256,100.0,2.081092797576048,69.76649853689052,96.57365716513462,126.65384553846152,126.29251074141007,-3.426342834865379
2021-07-13,130.8815,132.042007,130.636993,130.994507,130.994507,16618000,2847105687.1354737,2282642297,25.55662133431326,100.0,2.136012695500284,70.88743520145364,85.62016619655921,126.97717284615383,126.64080676056489,-14.379833803440794
2021-07-14,131.901505,132.996002,131.897995,132.082504,132.082504,17912000,2835213548.954205,2300554297,26.541765494088796,100.0,2.2414908640107285,73.55582777895613,88.91184343949904,127.3147885,127.04389544496749,-11.08815656050096
2021-07-15,132.5,132.595001,130.598007,131.266495,131.266495,16586000,2829731780.582342,2283968297,26.440508241471857,76.0,2.233491664251005,68.48567625631168,79.00702093657306,127.58878823076923,127.35668059719211,-20.992979063426944
2021-07-16,131.641006,132.182999,130.821503,131.845505,131.845505,14856000,2837222630.9763207,2298824297,26.346483649756127,76.0,2.247960420402194,70.06254149379228,86.0351190058581,127.86861534615385,127.68918610851122,-13.964880994141895
2021-07-19,131.155502,131.246994,128.537003,129.253998,129.253998,25710000,2825117060.991033,2273114297,24.720010025590902,76.0,2.026948654761071,56.44842604546664,54.579072748905034,127.99069211538462,127.80509810047334,-45.420927251094966
2021-07-20,130.003998,132.001343,129.1884,131.101501,131.101501,19084000,2831991368.34671,2292198297,23.607162529837115,76.0,1.9780713152444207,62.10216091831724,77.00430248120364,128.19857665384615,128.04927609303087,-22.995697518796362
2021-07-21,130.787003,132.617249,130.601501,132.600494,132.600494,14742000,2846488295.837647,2306940297,22.887204604993666,76.0,2.0368127692955227,65.96300234319703,95.14491014582767,128.43890346153847,128.38640334539895,-4.85508985417233
2021-07-22,132.649994,133.504501,132.399994,133.328506,133.328506,13608000,2855759628.057361,2320548297,22.649146493420243,100.0,2.1176987658393216,67.6848597331051,97.38705522259357,128.71949996153847,128.75248502351755,-2.6129447774064154
2021-07-23,135.259995,138.808502,134.7005,137.815994,137.815994,26378000,2869391589.4604955,2346926297,24.207767346960633,96.0,2.5149139167970986,75.80860493768061,90.78323656506193,129.18563423076924,129.42385605881256,-9.216763434938073
2021-07-26,138.25,139.712997,137.651001,139.644501,139.644501,23052000,2890912092.9959044,2369978297,25.868524353207054,100.0,2.943326187014179,78.21210198237479,99.41321017280548,129.6961534230769,130.1809408692709,-0.5867898271945283
2021-07-27,140.011002,140.011002,135.100006,136.796494,136.796494,42164000,2877878933.27026,2327814297,25.930847062600012,72.0,3.0182432057083304,67.03975962270808,73.14756007618071,130.12803792307693,130.6709818419175,-26.85243992381929
2021-07-28,138.561996,139.675995,136.350006,136.3815,136.3815,54688000,2824226621.5253916,2273126297,25.988718149893476,72.0,3.0094380071842863,65.56995167994569,68.36759354781184,130.5098263076923,131.09398318696063,-31.632406452188157
2021-07-29,136.3806,137.151505,136.138,136.540497,136.540497,19284000,2820259274.4239955,2292410297,25.921501718381897,72.0,2.980927278914038,65.87861610230172,69.7533091993471,130.87678788461537,131.4974286545932,-30.246690800652896
2021-07-30,135.511002,135.771347,134.814194,135.220993,135.220993,23954000,2816666623.646116,2268456297,25.12275304939833,72.0,2.8193595541562786,60.99179103307979,58.25336048922437,131.2136913846154,131.77324823573446,-41.74663951077563
2021-08-02,135.484497,136.020493,134.669495,135.989502,135.989502,20140000,2835882627.1043,2288596297,24.4811423745647,72.0,2.7219512620622766,62.726037505177096,64.95119094920607,131.54859538461537,132.08556332938375,-35.048809050793935
2021-08-03,136.0,136.335495,134.183502,136.279999,136.279999,19064000,2853963375.0732756,2307660297,23.608526734009065,72.0,2.637788386352554,63.38863247960135,67.48297607486292,131.9057106153846,132.39626226794792,-32.51702392513708
2021-08-04,136.249496,136.537994,135.414993,136.028503,136.028503,16528000,2855494296.2674685,2291132297,22.890696785128238,72.0,2.521726185880823,62.35518301260214,65.29109859605188,132.2599028846154,132.66531713698882,-34.70890140394812
2021-08-05,136.028503,136.949997,135.600006,136.940002,136.940002,11866000,2867184590.3998,2302998297,22.417482086979014,72.0,2.4747688130225356,64.60735075073879,73.23513798458585,132.67996061538463,132.98196046017483,-26.764862015414156
2021-08-06,136.294998,137.080048,136.046494,137.035995,137.035995,13560000,2879588659.15673,2316558297,22.041063747418246,68.0,2.417433916190305,64.84587900924194,72.51116690792122,133.13072957692307,133.2822593149767,-27.488833092078778
2021-08-09,136.949005,138.321503,136.428757,138.001999,138.001999,12374000,2887785085.941941,2328932297,22.269713035634513,64.0,2.422024456664303,67.2387088603701,78.64920785916296,133.57817184615385,133.63186966201548,-21.350792140837047
2021-08-10,138.079498,138.551498,137.226501,138.096497,138.096497,16034000,2892807006.617987,2344966297,22.58412501914253,52.0,2.405557917643506,67.47195897163364,74.84557892988693,133.93884503846152,133.96258279816246,-25.154421070113074
2021-08-11,138.283005,138.847748,137.350006,137.689499,137.689499,15204000,2884495584.3409863,2329762297,23.011403451970402,52.00000000000001,2.332775940716715,65.31506616049171,60.16296868296896,134.24340284615386,134.23865066496523,-39.83703131703104
2021-08-12,137.712997,138.417999,136.779007,138.389496,138.389496,14646000,2898632179.8557906,2344408297,22.940745695557553,52.0,2.3050088996405407,67.2539540470255,72.17492921492945,134.56309503846154,134.54612068978264,-27.825070785070547
2021-08-13,138.357498,138.673996,138.005005,138.406006,138.406006,12580000,2901133377.0019403,2356988297,23.00872961131501,24.0,2.2583032247274275,67.30038312605501,72.45824109824103,134.91805673076922,134.8320381201691,-27.541758901758964
2021-08-16,138.0,138.990494,136.165756,138.916,138.916,18040000,2918221875.1210575,2375028297,21.68662748116116,24.0,2.236658092248746,68.77324083677935,86.16302287504045,135.27734546153846,135.13455381497138,-13.836977124959542
2021-08-17,138.190994,138.718506,136.787506,137.300507,137.300507,21272000,2908252368.4115806,2353756297,20.458961217446866,24.0,2.0653394375461005,59.61342211320691,64.84314931250147,135.53644207692307,135.29499479164016,-35.156850687498526
2021-08-18,137.115494,138.294006,136.421005,136.570007,136.570007,14934000,2895694443.884044,2338822297,19.05839340170512,24.0,1.8493052842885334,55.98247984190677,49.64653571297801,135.75088438461538,135.38944014040754,-50.35346428702199
2021-08-19,135.467499,137.451996,135.356003,136.913498,136.913498,18296000,2904589306.1817713,2357118297,18.34580064558682,24.0,1.6863740441660582,57.29948721620833,56.792189377473385,135.93669184615385,135.50233331519217,-43.207810622526615
2021-08-20,137.082993,138.614502,136.466995,138.436996,138.436996,15564000,2917580366.1317506,2372682297,17.195167226926312,24.000000000000004,1.6610360293217639,62.63890001959059,88.48556436124674,136.21248034615385,135.71971573628906,-11.514435638753257
2021-08-23,138.998505,142.177002,138.747955,141.099503,141.099503,21090000,2925416273.1373997,2393772297,17.90806651931746,100.0,1.8346488435682886,69.75639963072163,84.20320835701649,136.56840334615384,136.11821849656394,-15.79679164298351
2021-08-24,141.543503,143.007507,141.3535,142.398499,142.398499,15126000,2929403438.769709,2408898297,18.88312916734128,100.0,2.0533862126381734,72.50817573998707,92.04067592462847,137.07396107692307,136.5834244597814,-7.959324075371532
2021-08-25,142.882996,143.313004,142.439499,142.949997,142.949997,12838000,2931571130.377656,2421736297,19.902390693704255,100.0,2.2453553740161283,73.60617670369838,95.43789173835708,137.52967246153847,137.05502242572354,-4.562108261642916
2021-08-26,142.6185,143.134796,142.091507,142.123001,142.123001,14922000,2917550037.926762,2406814297,20.584688337968867,96.0,2.3041992768163198,69.14640219609569,85.04457898145274,137.89592273076923,137.43042824604032,-14.95542101854726
2021-08-27,142.112503,145.011002,142.020004,144.550507,144.550507,24562000,2934548891.3181725,2431376297,21.91801111707331,72.0,2.51769057072741,74.10593206628532,95.2305018364064,138.32753815384615,137.95784148707438,-4.769498163593597
2021-08-30,144.704498,146.489502,144.600006,145.469498,145.469498,16916000,2933201409.7717705,2448292297,23.613563492207792,76.0,2.7295740224158465,75.69851872183077,90.83842375159867,138.62190369230768,138.51426048803182,-9.161576248401335
2021-08-31,145.884506,146.112,145.0,145.462006,145.462006,26756000,2928678202.102706,2421536297,25.188004983404095,76.0,2.8638756666456118,75.6576654428824,90.77113133975236,138.8456538846154,139.02890830373317,-9.228868660247645
2021-09-01,145.649994,146.820496,145.614502,145.841995,145.841995,15824000,2918824131.0277257,2437360297,26.864835048975902,84.0,2.9667735056672484,76.35468128619456,91.46494310738387,139.19355776923078,139.53358139234555,-8.535056892616131
2021-09-02,145.949493,146.324997,144.106506,144.218994,144.218994,21844000,2899195319.5247717,2415516297,27.22636859478254,84.0,2.8841119207905876,67.46852251646854,77.30818100721959,139.49499984615383,139.88064899291254,-22.691818992780416
2021-09-03,144.145996,145.376999,143.505005,144.774994,144.774994,19104000,2906012203.7327337,2434620297,27.127373682523107,84.0,2.8308344748525656,68.80778381685631,82.15793755554652,139.81171126923076,140.2431930675116,-17.842062444453482
2021-09-07,144.749496,145.824005,144.541,145.518997,145.518997,15170000,2913969493.9459443,2449790297,27.224052043067083,84.0,2.816183330885707,70.55466212503683,88.64756601098733,140.20778834615385,140.63399335880706,-11.352433989012667
2021-09-08,145.393494,145.550995,144.199997,144.883499,144.883499,15486000,2914152964.917774,2434304297,27.053013490210837,84.0,2.721916259904418,67.09805110123921,83.10438150208657,140.54986515384616,140.94877155445099,-16.89561849791343
2021-09-09,144.883499,145.669495,144.434006,144.913498,144.913498,14798000,2910841141.8339586,2449102297,26.950696807989964,36.0,2.619434386515593,67.17979274874222,81.58112893406792,140.8819228076923,141.24245499486204,-18.418871065932077
2021-09-10,145.443497,146.018997,141.741501,141.921005,141.921005,32896000,2880706085.8928194,2416206297,25.03303828705842,36.0,2.2705738260370083,53.02731581105396,39.306706525244245,141.10855750000002,141.2927179582056,-60.693293474755755
2021-09-13,143.201004,144.190994,142.282501,143.464996,143.464996,20176000,2885532031.532652,2436382297,23.252355374764846,36.0,2.0945419131146252,57.94953453649215,38.62260005311909,141.3595188076923,141.45362744278296,-61.37739994688091
2021-09-14,144.160995,144.727493,142.905502,143.406006,143.406006,18916000,2877008545.72619,2417466297,21.90715519196237,36.0,1.928049993723988,57.700754608290026,32.772329958977984,141.60451923076923,141.5982480766509,-67.22767004102201
2021-09-15,143.759003,145.581497,142.255997,145.205994,145.205994,20648000,2892993556.1342487,2438114297,21.14883267145149,36.0,1.9192243133612408,62.93026219564705,68.21217583399886,141.88159596153847,141.8654885154175,-31.787824166001148
2021-09-16,145.121002,145.199997,143.416351,144.373505,144.373505,20292000,2894480058.1105375,2417822297,20.444676045262817,36.0,1.8240287254604084,59.279953370872654,51.82135442149479,142.12301934615385,142.05126751427545,-48.17864557850521
2021-09-17,143.798492,144.249496,141.061493,141.463501,141.463501,60040000,2849582177.0608644,2357782297,19.663779289545026,36.00000000000001,1.496521564279277,48.65559682534525,6.980513814630702,142.26817326923077,142.00772925395876,-93.0194861853693
2021-09-20,139.000198,139.362503,137.052994,139.016998,139.016998,34918000,2874052637.267774,2322864297,20.5881909330778,36.0,1.0277106252994486,41.86264817940145,20.107536195027066,142.29230796153846,141.78619360551735,-79.89246380497293
2021-09-21,140.117004,140.8116,138.905502,139.6465,139.6465,18130000,2870018757.9709067,2340994297,20.5905349818112,36.0,0.6989134893431697,44.028018856515615,26.552397941664065,142.34001926923077,141.62769778288643,-73.44760205833593
2021-09-22,140.050507,141.583496,139.471756,140.938507,140.938507,22068000,2878606294.228211,2363062297,20.168044364245848,36.0,0.5364101550259193,48.28540071676279,41.905864353149816,142.41780799999998,141.57664661378374,-58.094135646850184
2021-09-23,141.609497,142.252457,141.096497,141.826508,141.826508,17272000,2883149495.4324045,2380334297,19.41549235326288,36.0,0.4738174782243618,51.04173097241146,53.240156176614896,142.59188496153845,141.59515486461459,-46.759843823385104
2021-09-24,140.945999,142.903503,140.850494,142.632996,142.632996,14950000,2894159834.5249267,2395284297,18.371643055797055,36.0,0.4837132274171836,53.46746902918496,62.235111899917705,142.82507684615385,141.67203198575424,-37.764888100082295
2021-09-27,141.585495,142.5,140.5,141.501007,141.501007,18844000,2894178810.4329267,2376440297,17.571738548541763,32.0,0.3956527890079258,49.74208687944584,49.60976479708934,143.0015195,141.65936346829096,-50.39023520291066
2021-09-28,139.088501,139.606506,135.699997,136.184006,136.184006,42190000,2862443331.187903,2334250297,18.610419662425972,-72.0,-0.101997523580593,36.77939931515385,4.690464192266826,142.91486603846153,141.25378143360274,-95.30953580773317
2021-09-29,137.109695,137.398499,134.25,134.520996,134.520996,26338000,2840639232.991905,2307912297,19.964674278956824,-76.0,-0.6233938935735353,33.81150547595924,2.302626128632681,142.66184653846156,140.75505658666918,-97.69737387136733
2021-09-30,134.324997,135.589996,133.0,133.265503,133.265503,35294000,2812581277.2807765,2272618297,21.531854796676164,-80.0,-1.1249444068890853,31.729818448880863,2.1102655749152515,142.31057746153846,140.2002748395085,-97.88973442508475
2021-10-01,133.554504,137.070999,133.377502,136.462494,136.462494,28388000,2831615410.232827,2301006297,22.16210360348227,-80.0,-1.2500465878982823,41.591263135861226,27.52052478333849,142.0610581153846,139.9234021847301,-72.47947521666151
2021-10-04,135.699493,135.699997,131.166504,133.764999,133.764999,31530000,2836229966.9135146,2269476297,23.322970564933907,-88.0,-1.5490003583425391,36.7656190616295,18.026335496659513,141.7395965,139.46722417104638,-81.97366450334049
2021-10-05,134.0,137.362,134.0,136.177002,136.177002,24126000,2843348672.5958467,2293602297,23.554117530582186,-88.0,-1.5731604764018243,43.12054483950928,35.70385505590081,141.41753861538461,139.22350401022814,-64.29614494409918
2021-10-06,134.625504,137.852005,134.486496,137.354004,137.354004,19764000,2857263636.5278997,2313366297,23.529425529753716,-88.0,-1.4802696916744367,45.97383159167906,47.294227497807874,141.1054042307692,139.08502252798903,-52.705772502192126
2021-10-07,138.863007,140.154449,138.563004,139.185501,139.185501,18250000,2853290686.944345,2331616297,22.466783147686062,-88.0,-1.2445205162706543,50.16324699894476,68.3223795111509,140.86400019230769,139.0924653777676,-31.677620488849097
2021-10-08,139.906006,140.317001,139.429352,140.056,140.056,18924000,2861086002.24127,2350540297,21.410953454129377,-84.0,-0.9761926607119165,52.065819910426015,75.73908799003911,140.64146192307692,139.1638383127478,-24.26091200996089
2021-10-11,139.800003,140.763657,138.806503,138.847504,138.847504,16584000,2845196848.5170355,2333956297,20.66418527820212,-64.0,-0.8512438204797093,49.25456833816364,65.44262293964569,140.43486615384614,139.14040614143315,-34.55737706035431
2021-10-12,139.637497,139.695007,136.25,136.712997,136.712997,22536000,2828718369.092175,2311420297,20.83203794631027,-64.0,-0.9139227083834953,44.66711220363419,47.25648353552726,140.12478934615385,138.96059805688256,-52.74351646447274
2021-10-13,137.75,138.550003,136.976501,137.899994,137.899994,16380000,2831565310.449733,2327800297,20.987901138124982,-64.0,-0.8579258062182475,47.5904089261907,57.369775698200115,139.83175076923078,138.88203479340976,-42.630224301799885
2021-10-14,139.951996,141.651505,139.339005,141.412003,141.412003,21426000,2848553195.9831386,2349226297,19.726420334736737,-64.0,-0.5241163950492478,55.14172746536904,90.40016425646596,139.6982316923077,139.06943984574977,-9.59983574353405
2021-10-15,142.199997,142.199997,141.064499,141.675003,141.675003,21250000,2850153451.9941573,2370476297,18.33674535908308,-64.0,-0.2356319117111525,55.656982300916816,95.24181508068214,139.5736741923077,139.26244452384236,-4.758184919317869
2021-10-18,141.213501,142.998749,141.213501,142.960495,142.960495,16564000,2866007590.668448,2387040297,17.32512623084848,-52.0,0.09562032921425612,58.18516377357633,99.67669702579693,139.61365457692307,139.5363741887429,-0.3233029742030773
2021-10-19,143.291504,144.106995,143.095993,143.822006,143.822006,15316000,2872688807.5048137,2402356297,16.81098277907132,-52.00000000000001,0.4227832720565061,59.83779765176797,97.79769562066829,139.62738573076925,139.85382839698417,-2.2023043793316974
2021-10-20,144.222504,144.247757,141.912003,142.414993,142.414993,17940000,2862475340.8640633,2384416297,15.808832912803402,-52.0,0.5620491187613084,55.948621548739695,85.98938496182286,139.58926984615385,140.04354429350389,-14.010615038177129
2021-10-21,142.192001,142.849503,141.636993,142.780502,142.780502,14850000,2875635185.978743,2399266297,14.75777462812942,-48.0,0.6939128320626935,56.73530551277481,88.78352861151762,139.49598169230768,140.24628190139248,-11.216471388482388
2021-10-22,140.350998,141.558502,137.170502,138.625,138.625,30182000,2865462146.1592355,2369084297,15.236039152755074,-44.0,0.45782398257446744,46.55583826632439,45.131827384275375,139.27488534615384,140.12618694573376,-54.868172615724625
2021-10-25,138.810501,139.205795,136.748505,138.772995,138.772995,21082000,2879117843.525033,2390166297,15.80463749028297,48.0,0.2794425878748541,46.92109801211262,43.913373487298536,139.17140434615385,140.02595050530905,-56.086626512701464
2021-10-26,140.606003,140.839493,139.005493,139.671997,139.671997,28258000,2871398633.091009,2418424297,15.587468518960657,48.0,0.20821581324835847,49.19266854487636,42.78695889359981,139.1965966153846,139.99973172713803,-57.21304110640019
2021-10-27,139.902496,149.117996,139.902496,146.427505,146.427505,51850000,2892973128.050588,2470274297,16.108032821910776,68.0,0.6889394534897519,62.262264694270456,79.09160835921921,139.4574045,140.47586308068335,-20.9083916407808
2021-10-28,147.298996,147.4245,144.763504,146.128998,146.128998,32418000,2893825816.5386577,2437856297,16.591413960364456,68.0,1.0339110980835073,61.509328868564594,76.77184543731589,139.65703876923078,140.89461381544757,-23.228154562684104
2021-10-29,145.520004,148.613007,145.166504,148.270493,148.270493,28954000,2917024910.562368,2466810297,17.315673642592245,68.0,1.4632370749238532,64.79818816526296,93.41386957223163,139.90488434615384,141.44097523652553,-6.5861304277683725
2021-11-01,148.164993,148.399506,143.579498,143.774002,143.774002,32272000,2887357484.2842374,2434538297,17.381080986493327,68.0,1.424234075867986,54.305738762648794,56.79697733722427,139.94876919230768,141.61379203381995,-43.20302266277573
2021-11-02,144.809402,146.920502,144.641006,145.863007,145.863007,21150000,2888883831.2925234,2455688297,17.44181637725862,68.0,1.5440898563698795,57.730217459553714,73.6853440452805,140.11653842307692,141.92854869798146,-26.314655954719495
2021-11-03,146.274994,146.910507,145.053497,146.789993,146.789993,17886000,2904448343.0894446,2473574297,17.49821352582639,68.0,1.6943450934426778,59.191719686441395,81.17947618054782,140.524461,142.28865568331614,-18.820523819452177
2021-11-04,147.199997,149.949997,146.634995,148.682999,148.682999,24700000,2910267599.9707375,2498274297,18.358065956353553,92.0,1.9437666826769942,62.07544234884988,90.40261509835402,141.0691534230769,142.76231074381124,-9.597384901645972
2021-11-05,149.3535,150.570755,148.651993,149.240997,149.240997,20408000,2902388922.139928,2518682297,19.305029163161265,96.0,2.1615439314198,62.907506031586784,90.37958364231584,141.6835955,143.24221342945486,-9.620416357684158
2021-11-08,150.0,151.0345,149.119995,149.351501,149.351501,18388000,2888447953.960686,2537070297,20.297632030604493,100.0,2.3163492866294746,63.08025868710838,88.21923849196368,142.17932653846154,143.69475324949525,-11.780761508036322
2021-11-09,149.746002,150.378494,147.507004,149.248505,149.248505,16876000,2892041863.9210205,2520194297,20.4588946463787,96.0,2.4030221855928176,62.786741400229396,87.49828065878496,142.774846,144.10614226805117,-12.501719341215031
2021-11-10,148.00975,148.699997,145.324997,146.626007,146.626007,22708000,2886841025.449909,2497486297,19.695655789651884,92.0,2.2343413151442633,55.68219933711488,69.14115537629674,143.1767308076923,144.2927989148622,-30.858844623703263
2021-11-11,147.106995,148.502243,146.694504,146.748001,146.748001,12464000,2875114727.748748,2509950297,18.986933994119845,76.0,2.0864530740219323,55.932003368361784,69.99509659635177,143.5380383846154,144.47466573598354,-30.004903403648232
2021-11-12,147.831497,149.859497,146.453995,149.645493,149.645493,17048000,2890020112.53842,2526998297,18.779791378078112,76.0,2.1779479383959313,61.48491275149307,88.45285400532214,143.9403457692308,144.85768997776253,-11.547145994677864
2021-11-15,150.0,150.477005,148.652496,149.388,149.388,16248000,2886872041.3324137,2510750297,18.786125642189347,76.0,2.204271277282743,60.75227767341685,85.20931181842906,144.29926884615386,145.19326849792827,-14.790688181570937
2021-11-16,149.170502,149.832504,148.350006,149.076004,149.076004,17254000,2886517044.895319,2493496297,18.64608646750046,76.0,2.1748865054444195,59.82213548759818,73.72910161526455,144.6926726923077,145.48087853511876,-26.27089838473544
2021-11-17,149.229004,149.626007,148.563004,149.061996,149.061996,15290000,2885581825.9824843,2478206297,18.51605009100364,40.0,2.1259617696115924,59.77788285652687,73.54120092791374,145.1676341923077,145.74614649548033,-26.458799072086272
2021-11-18,149.145996,151.610001,148.998505,150.709,150.709,26658000,2893845093.8764424,2504864297,19.08218124718723,72.0,2.1947878737925635,63.22265690362377,88.78026693969224,145.66028826923076,146.11376527359292,-11.219733060307764
2021-11-19,151.0,151.850006,149.887497,149.952499,149.952499,19766000,2875388468.286445,2485098297,19.685838300856297,76.0,2.163351973948096,60.65315612018518,73.67863781384357,145.98876888461538,146.39811591999344,-26.321362186156442
2021-11-22,150.141754,150.744507,147.005493,147.078506,147.078506,24608000,2851741525.882913,2460490297,18.779783595310505,76.0,1.8848047250791353,52.005708981965284,29.794840262846808,146.19659592307693,146.4485151851791,-70.2051597371532
2021-11-23,147.113007,147.694,144.889496,146.757004,146.757004,18126000,2857755587.731996,2442364297,17.80135328172089,76.0,1.6194435617193221,51.12755198396196,26.830045499539356,146.3426155,146.47136620849918,-73.16995450046065
2021-11-24,146.350006,147.0,145.199005,146.717499,146.717499,16464000,2869054557.885717,2425900297,16.89281084767339,76.0,1.3899329230560227,51.01356378809358,26.262486513200837,146.4539806153846,146.48959826712886,-73.73751348679916
2021-11-26,145.015503,145.296997,142.485504,142.806,142.806,16992000,2855936562.2186465,2408908297,17.02407416649845,76.0,0.8822487939260384,41.215481187243505,3.4224564210677655,146.46901934615386,146.21673913623042,-96.57754357893224
2021-11-29,144.298492,146.862,144.298492,146.113998,146.113998,26276000,2866878496.1248407,2435184297,16.450626007290552,76.0,0.7383223361298974,49.9676044864303,38.7473247376103,146.59723073076924,146.2091286816948,-61.2526752623897
2021-11-30,145.450256,146.628494,142.065994,142.451996,142.451996,41590000,2832325788.477718,2393594297,16.64530269024954,76.0,0.3250199964191438,42.43547835355992,3.9452322830349997,146.7444228846154,145.93082255712483,-96.054767716965
2021-12-01,144.212494,146.499146,141.5,141.617996,141.617996,28476000,2805194039.714229,2365118297,16.997174057300025,72.0,-0.06902622411115544,40.922531396409155,1.1400573101117526,146.853846,145.61135392326375,-98.85994268988824
2021-12-02,141.824005,144.675003,140.981995,143.776505,143.776505,21250000,2816103914.5371375,2386368297,17.48290802275894,68.0,-0.20477651969343924,46.262565441895745,25.71316867456221,147.01171169230767,145.47543918820716,-74.28683132543779
2021-12-03,144.495499,145.212997,141.149994,142.520493,142.520493,26688000,2807420271.074408,2359680297,17.66187667362288,-32.0,-0.4089946427884854,43.78258554173402,14.156205767550073,146.861442,145.256554285377,-85.84379423244992
2021-12-06,143.574005,144.351501,140.647003,143.796494,143.796494,22198000,2822966873.0247936,2381878297,17.999789141552828,-40.0,-0.4625444356089474,46.89702037505955,28.112917581116285,146.7717303076923,145.1484016716454,-71.88708241888372
2021-12-07,145.949997,148.300003,145.702499,148.036499,148.036499,23258000,2841506053.70286,2405136297,16.88551346726856,-39.99999999999999,-0.160994222740527,55.682807185559874,65.95995734357996,146.76273053846154,145.36233480707907,-34.04004265642004
2021-12-08,148.331497,149.156494,147.199997,148.720505,148.720505,18964000,2852018115.9835587,2424100297,16.165809917937302,-40.0,0.1316623397374599,56.92104803071071,72.06551671904394,146.95298065384617,145.61108815470286,-27.934483280956062
2021-12-09,148.175995,149.604996,147.529007,148.106003,148.106003,18580000,2843766287.934373,2405520297,15.662901939062937,-40.0,0.3104311412260472,55.42284802411798,66.5803624260386,147.03924973076923,145.7958966617619,-33.419637573961396
2021-12-10,149.100006,149.399994,147.357498,148.675003,148.675003,21634000,2850042162.098141,2427154297,15.116967395499042,-40.0,0.49234480460054897,56.56291720738301,79.50479643286106,147.1117501153846,146.0091637979277,-20.495203567138944
2021-12-13,148.444,148.5625,146.360001,146.704498,146.704498,24104000,2833478465.805884,2403050297,14.149750650839595,-40.0,0.4720677054825728,51.637592856696166,67.62111781065242,147.03565392307692,146.06067003511825,-32.37888218934758
2021-12-14,144.770004,145.442001,142.242493,144.970505,144.970505,24778000,2850953638.0661187,2378272297,14.547245264406783,-40.0,0.31247717249291895,47.70129723054507,48.264181496904456,146.87140423076923,145.97991706955395,-51.735818503095544
2021-12-15,144.365997,147.517242,142.705505,147.3685,147.3685,27280000,2876547061.3641915,2405552297,14.042891353466043,-40.0,0.37517390963785147,53.033377352921825,75.03351476162136,146.79513496153848,146.0827750644018,-24.966485238378635
2021-12-16,148.076996,148.551498,144.092499,144.838501,144.838501,27400000,2858315242.2944856,2378152297,13.175527544398827,-40.0,0.21819651669287055,47.527716464934144,46.79059249097428,146.62551942307692,145.99060661518683,-53.20940750902572
2021-12-17,142.714493,144.460098,141.787994,142.802994,142.802994,43404000,2847885303.184332,2334748297,13.147115787502079,-40.0,-0.06965466600414061,43.60544349683138,24.067790631227364,146.47848046153848,145.75448716221004,-75.93220936877263
2021-12-20,140.679596,142.610504,140.25,142.401505,142.401505,20264000,2864560954.47914,2314484297,13.580605371649883,-80.0,-0.32641292406015054,42.854218245863464,22.998459860378198,146.31130753846153,145.50611811315744,-77.0015401396218
2021-12-21,143.149994,144.692047,141.735001,144.220505,144.220505,19548000,2877874555.003447,2334032297,13.155985092949367,-80.0,-0.37875158294664857,47.28525461072921,42.442615688985896,146.10265415384615,145.41088751218282,-57.557384311014104
2021-12-22,144.100006,147.302994,143.962997,146.949005,146.949005,18438000,2892404258.569648,2352470297,12.562630532526057,-80.0,-0.19778327771018667,53.15309128094893,71.60884943189714,146.00884665384615,145.52482214091003,-28.391150568102866
2021-12-23,147.089493,148.572601,146.950851,147.142502,147.142502,13818000,2881852154.691738,2366288297,12.400847779533564,-80.0,-0.03830939437440861,53.54798968515139,73.67723086145635,145.9344811923077,145.64465027862042,-26.322769138543645
2021-12-27,147.463501,148.426498,147.25,148.063995,148.063995,13256000,2886939267.4212117,2379544297,12.250620937469106,-80.0,0.16058051871632983,55.472988540026606,83.52750765473343,145.89609653846153,145.8238609987226,-16.472492345266577
2021-12-28,148.374496,148.374496,145.935501,146.447998,146.447998,18624000,2876142051.9189253,2360920297,11.60425744293052,-80.0,0.18566453018382845,51.44659869412772,66.25334740923473,145.73221184615386,145.8700933691876,-33.74665259076527
2021-12-29,146.429504,147.183746,145.504501,146.504501,146.504501,17022000,2879393448.594217,2377942297,10.840320800060184,-76.0,0.20770877244257235,51.578936588983105,66.85733484012184,145.59959653846155,145.91708652702556,-33.142665159878156
2021-12-30,146.449997,147.0625,145.758499,146.002502,146.002502,12978000,2871272302.130372,2364964297,10.130951060252013,-28.0,0.18256734660604934,50.26802790977334,62.868915542458254,145.55821176923075,145.92341359909776,-37.131084457541746
2021-12-31,145.544006,146.365005,144.677505,144.679504,144.679504,17298000,2854015284.295706,2347666297,9.779822550701127,-28.0,0.055250806744311376,46.885948648005254,53.222592312187174,145.47830792307693,145.83127214731275,-46.777407687812826
2022-01-03,144.475494,145.550003,143.502502,145.074493,145.074493,25214000,2867517925.7762227,2372880297,9.902860849515571,-28.0,-0.013619163879468488,48.0105982927324,57.96857256523525,145.41511538461538,145.77521443269697,-42.03142743476475
2022-01-04,145.550507,146.610001,143.816147,144.416504,144.416504,22928000,2854443687.1366944,2349952297,9.534936948146093,-28.0,-0.11991106492229164,46.25359868427107,50.06252252150509,145.47705784615385,145.67456921546017,-49.93747747849491
2022-01-05,144.181,144.298004,137.523499,137.653503,137.653503,49642000,2806706965.4021916,2300310297,11.091740294667929,-72.0,-0.7413203427772146,32.918852878571315,1.1766024062409208,145.1516541923077,145.0804161624631,-98.82339759375907
2022-01-06,137.497498,139.686005,136.763504,137.550995,137.550995,29050000,2793312469.7459025,2271260297,12.70912919314822,-76.0,-1.2279086448826035,32.764665811292005,6.668511572053222,144.96315415384615,144.5226812615399,-93.33148842794678
2022-01-07,137.904999,138.254745,135.789001,137.004501,137.004501,19408000,2793038997.9045434,2251852297,14.429338755551967,-80.0,-1.6387404981574036,31.906647126204533,9.508276228918252,144.78571203846153,143.96577901994434,-90.49172377108174
2022-01-10,135.098999,138.639999,133.140503,138.574005,138.574005,34096000,2826316693.3093586,2285948297,16.563753233240924,-84.0,-1.816739602595959,37.008573190225285,35.20909470637113,144.58561588461538,143.5663883518003,-64.79090529362887
2022-01-11,138.180496,140.329498,136.813507,140.017502,140.017502,23502000,2845647732.6942716,2309450297,17.766969752294337,-84.0,-1.8203432473544296,41.360278543816364,44.56295573032269,144.489347,143.30350788129655,-55.43704426967731
2022-01-12,141.554504,142.814255,141.112,141.647995,141.647995,23642000,2836894211.5531974,2333092297,17.865877544848306,-84.0,-1.672354145699643,45.90611634529452,55.128550894376225,144.40671242307693,143.18087729749683,-44.871449105623775
2022-01-13,141.8405,143.185501,138.914001,139.130997,139.130997,26566000,2813027364.42034,2306526297,18.49131685854306,-84.0,-1.7381362666743598,40.66534605259244,39.18942796985088,144.06419311538463,142.8808861643489,-60.81057203014912
2022-01-14,137.5,141.2005,137.5,139.786499,139.786499,23826000,2818645020.7770486,2330352297,19.387413188833996,-84.0,-1.7175763869061313,42.50620856923237,43.62609330331186,143.72057750000002,142.65167230032304,-56.37390669668814
2022-01-18,136.600006,137.391495,135.617004,136.290497,136.290497,27382000,2812048232.227543,2302970297,20.61075940436971,-80.0,-1.9607780493452367,36.07739983329215,22.43067359868364,143.26613496153848,142.18047412992877,-77.56932640131636
2022-01-19,136.938507,138.399506,135.5,135.651993,135.651993,20796000,2793432497.712767,2282174297,21.319773142858992,-44.0,-2.1799104053947076,35.03518049117581,18.039725191723633,142.76524996153847,141.69688293511925,-81.96027480827637
2022-01-20,136.514008,137.912003,133.144501,133.5065,133.5065,21930000,2774832811.1851053,2260244297,22.470590258525757,-44.0,-2.4979034546597347,31.719322209053843,2.7172282144441655,142.25763465384617,141.09018790288818,-97.28277178555584
2022-01-21,133.011993,134.760498,130.001007,130.091995,130.091995,41920000,2734515594.7432632,2218324297,24.097120704775474,-76.0,-2.990959337079204,27.29225288448228,0.5478236671047622,141.68538426923075,140.27550694711866,-99.45217633289523
2022-01-24,126.027496,130.778503,124.641953,130.371994,130.371994,55148000,2782357157.6305532,2273472297,26.336756771299,-80.0,-3.3208355716006963,28.177503689808688,26.083523670377986,141.03167249999998,139.54191339548024,-73.91647632962201
2022-01-25,128.435501,129.338501,126.377998,126.735497,126.735497,36008000,2755045533.8828316,2237464297,28.416418833070846,-80.0,-3.8315322616491585,24.077304589324072,10.650888115827515,140.33540311538462,138.593289958778,-89.34911188417249
2022-01-26,130.592499,132.807495,127.153503,129.240005,129.240005,39630000,2744664982.5060344,2277094297,28.984097174968362,-80.0,-3.988196753719592,31.473138437057145,24.795966769681826,139.8137496923077,137.90045403590554,-75.20403323031817
2022-01-27,131.360992,132.609955,128.945007,129.121002,129.121002,30248000,2717322069.7050886,2246846297,29.5112270638732,-80.0,-4.074983170541515,31.317033615819426,24.154217952249518,139.30296111538462,137.25012425546808,-75.84578204775048
2022-01-28,130.0,133.370499,128.694504,133.289505,133.289505,30518000,2746782850.9133663,2277364297,29.705803926045295,-80.0,-3.7640095179599484,42.14242030162894,46.633750995224844,138.88253803846152,136.95674505135935,-53.366249004775156
2022-01-31,134.197998,135.843506,132.274002,135.698502,135.698502,34056000,2778071936.3930297,2311420297,28.981069915486184,-80.0,-3.285303795647195,47.3108259167916,59.62477622944648,138.4498263846154,136.86354186236977,-40.375223770553525
2022-02-01,137.835007,138.199997,134.568253,137.878494,137.878494,51204000,2820210187.479009,2362624297,27.543280096879673,-76.0,-2.6989075995828387,51.53040420908777,71.38084362280615,138.09351838461538,136.93872350219425,-28.61915637719385
2022-02-02,151.863495,152.100006,145.557495,148.036499,148.036499,89750000,2798474015.5031424,2452374297,27.762977609729493,28.0,-1.3983984134972616,65.42504874434128,85.20103737872451,138.09246084615384,137.76078094647616,-14.798962621275495
2022-02-03,145.294998,149.117706,142.205002,142.650497,142.650497,56930000,2748881818.5828056,2395444297,27.16388606964933,28.0,-0.7931973769516105,56.22208407933521,65.58565532669049,137.9464031153846,138.12298213562607,-34.414344673309515
2022-02-04,143.016998,144.535248,139.817505,143.016006,143.016006,49224000,2766402875.795121,2444668297,26.079539253431534,28.0,-0.2808403212312385,56.667548687700716,66.91680943291937,137.81223023076922,138.48542834780193,-33.083190567080635
2022-02-07,143.709,143.846497,138.699005,138.938004,138.938004,44610000,2725935376.799494,2400058297,24.83030537699164,28.0,-0.20153121693485332,50.494037194327284,52.065057198338145,137.54051876923077,138.51895247018697,-47.93494280166186
2022-02-08,138.991257,139.837097,136.873001,139.212997,139.212997,34256000,2745765953.601325,2434314297,23.278040022149476,27.999999999999993,-0.11516103873188399,50.88262739972254,53.06655938059409,137.3302685,138.57036317609905,-46.933440619405914
2022-02-09,140.849747,142.175507,140.376999,141.453003,141.453003,28628000,2751392838.7750354,2462942297,22.28792342470854,28.0,0.13251021813636044,54.04681471322374,61.224479390435995,137.19098042307692,138.78389205194355,-38.77552060956402
2022-02-10,139.5,141.431,138.050003,138.602493,138.602493,33018000,2729165806.5398693,2429924297,20.85811888541233,28.0,0.09765345108854717,49.66238881871026,50.843153372892125,136.9673646153846,138.7704550851329,-49.15684662710789
2022-02-11,138.75,139.283249,133.288498,134.130005,134.130005,38808000,2701253072.633824,2391116297,20.125091250126047,28.0,-0.2875485111408125,43.675613700411674,30.13764321976731,136.83184546153845,138.42671804178974,-69.86235678023269
2022-02-14,133.365494,136.166504,133.302002,135.300003,135.300003,26792000,2711836115.6898246,2417908297,19.444422731645925,28.0,-0.49273484039582627,45.52564079204526,32.655879663774925,136.74526884615386,138.1951095201757,-67.34412033622507
2022-02-15,137.471497,137.899994,135.539505,136.425507,136.425507,26578000,2705210050.3575993,2444486297,18.41391319450616,28.0,-0.55809435373925,47.31826116422794,33.03070790790991,136.72299984615387,138.06402785201453,-66.96929209209009
2022-02-16,136.430496,137.945999,134.823654,137.487503,137.487503,25610000,2723298727.4032173,2470096297,17.60585942786155,28.0,-0.518224270418699,49.022897971838184,37.56808548690818,136.6812113076923,138.02132230742086,-62.43191451309182
2022-02-17,136.149994,136.839493,132.201996,132.308502,132.308502,30968000,2693753166.1920724,2439128297,17.38397527032753,28.000000000000004,-0.8942210168721942,41.90228663561635,0.5352595561063442,136.3847113076923,137.5981504327971,-99.46474044389366
2022-02-18,133.037506,133.824005,130.307053,130.467499,130.467499,31858000,2664801938.1173077,2407270297,17.53443018511312,28.0,-1.3254754476619723,39.69505509097785,0.736228816718906,135.95469223076924,137.06995403036768,-99.2637711832811
2022-02-22,129.985001,131.900757,127.740997,129.402496,129.402496,38906000,2656975750.4593663,2368364297,18.125267965702633,28.0,-1.7332052216692375,38.43379554941303,6.820880931568356,135.58051911538462,136.50199417626638,-93.17911906843165
2022-02-23,131.078506,131.748993,127.503502,127.584999,127.584999,26432000,2631558534.711176,2341932297,18.71501912824292,28.0,-2.1778855150177208,36.31328171807257,0.37705297868012544,135.11123065384615,135.84147601506146,-99.62294702131987
2022-02-24,125.0,133.037003,124.764503,132.673492,132.673492,43166000,2670930925.5661774,2385098297,19.724811527297728,28.0,-2.0955428785811137,45.396656480728886,40.00349506303384,134.97211507692307,135.6068105324643,-59.99650493696617
2022-02-25,133.525497,135.389008,131.764999,134.519501,134.519501,26236000,2684577340.0259647,2411334297,19.949170971800278,28.0,-1.8598886092524083,48.27867847613219,51.121481329466874,134.9285576923077,135.5262690856151,-48.878518670533126
2022-02-28,133.2845,135.640503,132.825256,134.891006,134.891006,29676000,2698452187.9622207,2441010297,20.08219161048337,28.0,-1.624428157678608,48.863634801858126,58.16151096168835,134.98180792307693,135.47921256075472,-41.83848903831166
2022-03-01,134.479996,136.110992,133.378494,134.167999,134.167999,24640000,2688050736.8650928,2416370297,20.057838043106074,28.000000000000004,-1.4791143661871047,47.73220440353944,54.00892447098399,135.13857730769232,135.38208563032845,-45.99107552901601
2022-03-02,134.608246,135.615494,133.432495,134.751495,134.751495,23966000,2693045953.9797134,2440336297,20.03522401625573,-60.0,-1.3018618359166965,48.763310138139005,59.92256201168126,135.30701965384617,135.33537521326707,-40.07743798831874
2022-03-03,135.9785,136.713806,133.431,134.307999,134.307999,19780000,2683834376.3720202,2420556297,19.63799603286818,-60.0,-1.183531336862501,47.98841676390863,65.73223334852739,135.59826973076923,135.25927327154358,-34.26776665147261
2022-03-04,133.382507,134.199005,130.408493,132.121994,132.121994,24446000,2681490005.6221056,2396110297,19.97369520469329,-60.0,-1.251716885046676,44.25539027976094,55.81681320542067,135.70911546153846,135.0268822143922,-44.18318679457932
2022-03-07,131.904007,131.904007,126.410004,126.4645,126.4645,39178000,2643089232.823474,2356932297,21.048093035418407,-60.0,-1.7421840936234787,36.369964315262564,12.89684418217778,135.6069423076923,134.39263167999277,-87.10315581782221
2022-03-08,126.250504,131.246506,125.860748,127.278503,127.278503,35250000,2626397758.3829217,2392182297,22.14066942875592,-60.0,-2.041664612096781,38.07950710267692,19.07219028856813,135.37574992307694,133.8656591851785,-80.92780971143188
2022-03-09,131.399994,134.198502,130.087997,133.865997,133.865997,32258000,2653436961.0380697,2424440297,22.12450380762296,-60.0,-1.727535415891026,49.82747337219891,75.37475393354354,135.30526896153847,133.8656842084986,-24.625246066456466
2022-03-10,131.462494,133.538498,131.401001,132.682007,132.682007,24266000,2658256280.5458865,2400174297,22.109492873713783,-60.0,-1.556185129223934,48.06246483402936,66.25912825208295,135.1054040769231,133.77800441527648,-33.74087174791707
2022-03-11,133.999496,134.199997,130.296494,130.475494,130.475494,26600000,2634095832.9171796,2373574297,22.340454253562903,-56.00000000000001,-1.580220156715825,44.87239401191501,47.79350728657556,134.42998080769232,133.5333740141449,-52.20649271342443
2022-03-14,130.572998,131.026001,126.413002,126.740997,126.740997,30254000,2608144093.0000453,2343320297,23.315126123454483,-52.0,-1.8789514043893405,40.02970099711745,16.540663501461033,133.81807696153845,133.0302349760601,-83.45933649853897
2022-03-15,127.741501,130.517242,126.568001,129.660507,129.660507,30292000,2625293204.7235384,2373612297,24.22017857406809,-48.0,-1.8586921664766862,45.02472569102777,40.9731345836656,133.30440392307693,132.78062549635192,-59.0268654163344
2022-03-16,131.0,133.770996,129.201004,133.690506,133.690506,32058000,2656221947.420681,2405670297,23.87878120143792,-40.0,-1.5001564653602202,51.08165910311318,72.14333508583475,133.10257707692307,132.84802405217772,-27.85666491416525
2022-03-17,133.320999,134.739502,132.718994,134.600494,134.600494,23994000,2676914443.0940466,2429664297,23.24151905862999,-40.0,-1.12956499052126,52.358068992430354,80.52795811097658,132.9251731153846,132.9778366409053,-19.472041889023416
2022-03-18,133.884003,136.913498,132.932007,136.801498,136.801498,45900000,2720232093.9188256,2475564297,21.96666261949274,-36.0,-0.6507643422511649,55.39000784237013,98.98667752369323,132.74626907692306,133.26107081565306,-1.0133224763067539
2022-03-21,136.847504,137.582504,134.611496,136.4785,136.4785,26632000,2727071596.2022257,2448932297,20.580884223066896,-32.0,-0.293985733580854,54.83846398946481,90.58158180395495,132.66457703846154,133.49939890338246,-9.418418196045058
2022-03-22,136.5,141.5,136.5,140.277496,140.277496,29776000,2742287084.560626,2478708297,19.98773102162826,72.0,0.2919457431104604,59.89652759767355,92.1831044093414,132.90101900000002,134.00148016979858,-7.816895590658598
2022-03-23,139.138504,140.024994,138.166504,138.503494,138.503494,25302000,2726160835.8210573,2453406297,19.436945906006674,72.0,0.6061660197989909,56.70285452284766,80.83983812013508,133.0242301923077,134.33496267573943,-19.160161879864912
2022-03-24,139.272507,141.3965,138.039398,141.311996,141.311996,20544000,2745670580.575908,2473950297,19.273241674288904,72.0,1.0694821679760764,60.310849546913545,98.79787089561567,133.21217207692308,134.851779959018,-1.2021291043843179
2022-03-25,141.753998,141.959503,139.699493,141.5215,141.5215,19270000,2757471305.829336,2493220297,19.262949711034548,84.0,1.4370038889925638,60.574776107701474,97.27927408051114,133.3673258076923,135.34583329538702,-2.7207259194888596
2022-03-28,140.684494,141.976501,139.828156,141.949997,141.949997,23774000,2780658709.0806756,2516994297,19.25788691756417,88.0,1.7427542414813502,61.143904953774445,99.8297041044561,133.73815253846155,135.83503060683984,-0.1702958955439066
2022-03-29,143.160507,144.162506,142.483994,143.25,143.25,28678000,2778155702.250817,2545672297,19.81461479829222,92.0,2.066145734269071,62.89400071899198,94.85897746776469,134.2297871923077,136.38428759892577,-5.14102253223531
2022-03-30,142.869995,143.480499,142.167999,142.644501,142.644501,21046000,2772391166.7719593,2524626297,20.19621039305266,92.0,2.2476674025868704,61.50448580592393,91.44762017011847,134.7390950769231,136.84800711011644,-8.552379829881536
2022-03-31,142.448502,142.644501,139.619003,139.649506,139.649506,29516000,2743470326.013843,2495110297,19.525037886813248,92.0,2.1253538104986944,55.028458210661455,74.57393739002507,135.20311457692307,137.0555255464041,-25.42606260997493
2022-04-01,140.009995,140.949997,138.796997,140.699997,140.699997,23480000,2761497469.534512,2518590297,18.598592448821677,60.0,2.089103368714518,56.74867138408381,80.32050915896748,135.5118263076923,137.32548639481863,-19.67949084103252
2022-04-04,140.824493,144.043747,140.824493,143.642502,143.642502,19076000,2775818237.65781,2537666297,18.63548672120295,60.0,2.271624323228764,61.22300349245136,96.52438638847892,135.86271096153845,137.7934134766839,-3.475613611521091
2022-04-05,143.399506,143.589996,140.943497,141.063004,141.063004,19256000,2758301310.139606,2518410297,18.66974568841413,60.0,2.1829656941646647,55.77575838856532,72.91476602637371,136.1000955,138.0356053672999,-27.08523397362629
2022-04-06,139.161499,139.848495,136.418106,137.175995,137.175995,23574000,2745143898.629133,2494836297,17.550674324414082,60.0,1.7785519113461703,48.73855690128988,37.789843532331005,136.21578765384615,137.97193052527768,-62.210156467668995
2022-04-07,136.617996,137.701508,134.857254,136.464996,136.464996,19448000,2747682237.6944914,2475388297,16.958561818567667,60.0,1.3847172392080722,47.55659525802396,19.40632456672144,136.28169153846153,137.8603057456275,-80.59367543327856
2022-04-08,136.25,136.25,133.752502,134.010498,134.010498,16434000,2734643560.7450004,2458954297,16.712554299618485,60.0,0.8645766472000673,43.6235404138037,2.4783467902607867,136.2702491923077,137.57513480150695,-97.52165320973921
2022-04-11,132.899994,132.939194,129.617493,129.796494,129.796494,24188000,2713062463.7672772,2434766297,17.465840761568636,60.0,0.111046500786955,37.83776388719452,1.2306692335029152,136.18080688461538,136.99893918658051,-98.76933076649709
2022-04-12,132.423492,132.423492,127.575996,128.374496,128.374496,23004000,2697637095.704261,2411762297,18.570135837290422,60.0,-0.5940273461268646,36.097914772312315,4.81415318834396,136.25426826923078,136.3600915431301,-95.18584681165603
2022-04-13,128.626495,130.655746,128.438599,130.285995,130.285995,19542000,2710661102.948706,2431304297,19.595552693317796,44.00000000000001,-0.987181837627702,40.08608421250956,16.338572731695876,136.36994103846155,135.9101584658612,-83.66142726830412
2022-04-14,130.649506,130.710251,127.111504,127.252998,127.252998,23484000,2689023770.745025,2407820297,20.81353021072146,44.0,-1.5259074040442613,36.22306912113149,0.8298280652363338,136.11559492307694,135.26888732024184,-99.17017193476367
2022-04-18,127.410004,128.712006,126.578453,127.960999,127.960999,14918000,2693439549.871206,2422738297,22.05056304851133,44.0,-1.874117868854455,37.73157573903555,7.862499049564989,135.9340176923077,134.7275622594832,-92.13750095043501
2022-04-19,128.076996,130.903748,127.4515,130.531006,130.531006,22720000,2711253356.4343495,2445458297,22.27159674558367,44.0,-1.9205600635763744,43.00180852344854,22.630898741240742,135.93615276923077,134.41670624026222,-77.36910125875926
2022-04-20,131.283997,131.923492,127.894051,128.245499,128.245499,22610000,2692587446.5848193,2422848297,22.07468740985047,40.0,-2.117379320824881,39.77752919741292,9.54490660162949,135.99401823076926,133.95957977802058,-90.45509339837051
2022-04-21,129.350006,130.307495,124.650002,124.9375,124.9375,30158000,2665494537.3181176,2392690297,22.659595844718286,-64.0,-2.511338723844915,35.61509361911396,1.4824264215085814,135.8123641153846,133.29127757224128,-98.51757357849142
2022-04-22,125.0,125.452003,119.140503,119.613998,119.613998,46410000,2626047985.9277983,2346280297,24.180562254971612,-68.0,-3.2160439572783446,30.147696797211665,1.9013386368458653,135.27095996153847,132.27814575207526,-98.09866136315414
2022-04-25,119.429497,123.278,118.769249,123.25,123.25,34522000,2660141212.6378117,2380802297,25.64911687907149,-72.0,-3.4414619269794287,37.23491790531301,18.052442176699984,134.8344025,131.6093942148845,-81.94755782330002
2022-04-26,122.75,122.75,119.16185,119.505997,119.505997,49394000,2620222177.1281476,2331408297,27.012774744307087,-72.0,-3.877519414044613,33.469281383211566,3.4951345033877925,134.1691909230769,130.7128462730412,-96.50486549661221
2022-04-27,114.373001,117.5,113.124252,115.0205,115.0205,62238000,2611926352.511191,2269170297,29.105671181525754,-80.0,-4.5327890644341835,29.60623246655993,7.715458552411223,133.34388323076922,129.55045025281592,-92.28454144758878
2022-04-28,117.114998,120.438499,115.143898,119.411499,119.411499,36790000,2634443953.1368093,2305960297,29.944694868558795,-80.0,-4.64424212881994,37.24259045333369,27.187215738924454,132.5413448846154,128.7994168266814,-72.81278426107555
2022-04-29,117.578003,118.959999,114.694,114.966499,114.966499,33694000,2605054492.9672217,2272266297,30.791585236103426,-80.0,-5.033223964121376,33.30399388161209,9.297261632156186,131.63607584615383,127.77475624692723,-90.70273836784382
2022-05-02,113.906502,117.3395,113.399498,117.156998,117.156998,30280000,2632529336.746489,2302546297,31.77490005166323,-80.0,-5.1058824736695385,36.84838821783221,20.895879837755274,130.70703746153848,126.98825563604373,-79.10412016224473
2022-05-03,116.764999,119.300003,116.626999,118.129501,118.129501,21216000,2635164466.3609605,2323762297,31.94745307142451,-80.0,-5.027043374612759,38.413201092979826,26.624741212942666,129.8073451923077,126.33205158892939,-73.37525878705733
2022-05-04,118.003502,123.142998,115.738503,122.574997,122.574997,33232000,2663297993.2761655,2356994297,30.847356413158405,-80.0,-4.553360144586932,45.108871788558,50.271952483185444,129.0621528846154,126.0537512490087,-49.728047516814556
2022-05-05,120.220497,121.233253,115.182503,116.746498,116.746498,43090000,2642483758.941579,2313904297,29.945509099097332,-64.0,-4.595302147904732,39.10585657778285,19.268044878409988,128.04278742307693,125.36432508241546,-80.73195512159002
2022-05-06,115.518997,117.498497,114.142998,115.660004,115.660004,35310000,2639100743.190419,2278594297,29.33501831063589,-64.0,-4.662466462208954,38.08830960465749,13.488587836529565,127.00492215384617,124.64548648371803,-86.51141216347042
2022-05-09,113.303497,115.562897,112.551498,113.084,113.084,34520000,2616789001.903396,2244074297,29.10612090649617,-96.0,-4.867447751624397,35.71544676666309,2.7488238949485924,125.98317192307692,123.78908007751669,-97.25117610505141
2022-05-10,116.040497,116.691002,113.383301,114.584503,114.584503,31158000,2608261252.8940387,2275232297,28.497747018296007,-96.0,-4.852877892885786,38.1332087591328,11.449680916256089,124.97872984615385,123.10725955325618,-88.55031908374391
2022-05-11,113.710503,116.670998,113.650002,113.960999,113.960999,36502000,2579274663.3705835,2238730297,27.932828407824427,-92.0,-4.835897520450871,37.502035178175724,10.925936620310639,123.83713357692308,122.42975877153351,-89.07406337968935
2022-05-12,111.938004,114.856499,110.113503,113.161003,113.161003,41464000,2591094090.1329083,2197266297,28.18952862866173,-100.0,-4.831301211330057,36.663516325947946,23.149384287147445,122.76397969230769,121.74318426993844,-76.85061571285256
2022-05-13,114.845497,118.084999,114.0,116.515503,116.515503,29738000,2597980837.5142417,2227004297,27.30744830265593,-96.0,-4.505047109183209,42.47198980936829,49.13467482814948,121.96934538461538,121.35594862031337,-50.865325171850515
2022-05-16,115.384003,116.607498,114.334999,114.792503,114.792503,23282000,2584073194.22727,2203722297,26.488373714221982,-92.0,-4.335542646142997,40.421477363228526,35.91083154028608,121.13578796153845,120.86976746325313,-64.08916845971392
2022-05-17,117.227501,117.227501,115.337502,116.7015,116.7015,21576000,2593639666.628578,2225298297,25.513705839877577,-88.0,-4.001047449787919,43.666595077890406,50.56218218741398,120.47005726923076,120.56100691041956,-49.43781781258602
2022-05-18,115.237503,115.695648,112.141998,112.401001,112.401001,27982000,2569736527.4876947,2197316297,25.390473578153234,-84.0,-4.036442330708709,38.56991166099139,17.55630590441147,119.80099984615384,119.95656202816626,-82.44369409558854
2022-05-19,111.841003,113.587502,110.468002,110.745499,110.745499,29192000,2545738111.3466463,2168124297,25.636203349613798,-64.0,-4.150236857575919,36.789745056671336,4.85050264803049,119.1229615,119.27426106311691,-95.14949735196952
2022-05-20,112.085503,112.550003,106.373001,109.313004,109.313004,37586000,2543930941.516363,2130538297,26.618906523731336,-88.0,-4.306369072556464,35.27269893271814,17.531326928681047,118.31630799999999,118.53639016955269,-82.46867307131895
2022-05-23,110.103996,112.005501,109.154251,111.666496,111.666496,31558000,2567984640.041571,2162096297,27.531416613983335,-88.0,-4.191876499420914,39.67399768136407,31.56527100153919,117.71682715384615,118.02750911995619,-68.4347289984608
2022-05-24,106.377502,106.394997,102.208,105.926003,105.926003,60386000,2614842724.1228347,2101710297,29.357113839516295,-96.0,-4.512334734150386,33.66158173818107,19.542462851873744,116.86932730769232,117.1311012592187,-80.45753714812626
2022-05-25,105.141998,106.544701,104.21125,105.8395,105.8395,37900000,2629834921.130614,2063810297,30.995344098912998,-96.0,-4.718883906839849,33.57900124165519,22.872710390672715,115.91965400000001,116.29468635112842,-77.12728960932728
2022-05-26,106.050499,108.955254,105.487999,108.295998,108.295998,30288000,2648605137.9113235,2094098297,31.61393160022671,-92.0,-4.630973772544252,38.21452974380235,38.34476527963502,115.15236549999999,115.7021909177115,-61.65523472036497
2022-05-27,109.788498,112.867996,109.550003,112.799004,112.799004,29924000,2677284700.9230595,2124022297,30.92472067994976,-88.0,-4.150109527468857,45.696144067585955,66.70658604941652,114.68550026923077,115.48714003491807,-33.29341395058349
2022-05-31,113.079002,116.433502,112.572502,114.039001,114.039001,51302000,2664954123.714046,2175324297,29.321510323150573,-84.0,-3.6271522012420263,47.5785813772403,74.51660732610742,114.4710773076923,115.37987047677598,-25.483392673892578
2022-06-01,114.931503,117.399002,113.550499,114.137001,114.137001,28630000,2645050401.0535727,2203954297,27.590780730425305,-56.0,-3.1682750687139816,47.73279022582098,75.13385243647114,114.12057734615384,115.28780607108887,-24.866147563528845
2022-06-02,114.188004,117.898003,113.307999,117.746002,117.746002,27472000,2670702894.372533,2231426297,25.8553993775324,-56.0,-2.4847527333291737,53.19353611387999,97.86485468695948,114.05288523076923,115.46989465841563,-2.1351453130405313
2022-06-03,115.9925,116.364502,113.667999,114.564003,114.564003,25052000,2662299636.9906573,2206374297,24.243973835560418,-56.0,-2.1747479436877626,48.392867503824384,78.75080074873152,114.03532765384617,115.40279157260707,-21.249199251268482
2022-06-06,116.7425,119.398499,116.528297,117.010498,117.010498,23786000,2646505850.072524,2230160297,23.07033932315878,-56.0,-1.7119212515904962,51.98112671734927,86.1085998725226,113.94298146153845,115.52188093759914,-13.891400127477407
2022-06-07,115.648003,117.74865,115.125504,117.2295,117.2295,26414000,2662464596.6478195,2256574297,21.58912935589359,-56.0,-1.3123284272796383,52.300849187260944,87.38257103531434,114.03001996153847,115.64837123851773,-12.617428964685661
2022-06-08,116.876503,118.646004,116.696747,117.237999,117.237999,22544000,2652440223.447159,2279118297,20.449719744119676,-56.0,-0.9836238335628167,52.31411871414535,87.43201113591874,114.03313538461538,115.76612144307197,-12.56798886408125
2022-06-09,116.341499,118.349998,114.866997,114.917999,114.917999,23142000,2629975965.5919356,2255976297,19.10812038940541,-56.00000000000001,-0.8999535811230004,48.35927427825873,73.93618416777775,113.90961607692307,115.70329755839997,-26.06381583222224
2022-06-10,112.78125,113.497002,110.861,111.427498,111.427498,31324000,2612115523.929145,2224652297,18.846962260984018,-52.0,-1.1025886074892526,43.0822040902102,53.631357647035145,113.48086611538461,115.38657166518514,-46.368642352964855
2022-06-13,107.445999,109.218498,106.588051,106.876503,106.876503,36756000,2583420771.095121,2187896297,19.4420474452853,32.0,-1.6118254673774715,37.35817282095162,27.157460641485745,113.10125092307693,114.75619620850476,-72.84253935851426
2022-06-14,106.889999,108.457497,106.351997,107.194,107.194,25480000,2578320003.049526,2213376297,20.037195054716925,32.0,-1.9671044377471247,37.977289884629826,19.639830755392218,112.77563538461537,114.1960335263933,-80.36016924460779
2022-06-15,108.899498,112.063004,108.118752,110.390503,110.390503,33192000,2583362861.872948,2246568297,19.50700115372896,32.0,-1.968048070512566,43.980302923193705,35.24319039574418,112.67203934615385,113.91414237629009,-64.75680960425582
2022-06-16,108.149498,109.290497,105.792503,106.636002,106.636002,35314000,2565079950.9405684,2211254297,19.49004555339599,32.0,-2.245863838969669,39.1831881575517,6.199465294565779,112.36632776923078,113.37502086693527,-93.80053470543422
2022-06-17,106.535004,109.249496,105.628548,107.865501,107.865501,43516000,2575330669.903669,2254770297,19.507442915735886,32.0,-2.339852183613047,41.43594177076072,16.245177633529696,112.13188553846155,112.96690828419932,-83.75482236647031
2022-06-21,109.702003,112.672997,109.293503,112.014999,112.014999,39010000,2599149933.077387,2293780297,18.54478424650565,31.999999999999996,-2.0558107079505703,48.38488844128134,46.37962037773414,112.08780846153846,112.89639648536973,-53.620379622265865
2022-06-22,111.163002,113.769501,110.724297,112.033997,112.033997,23922000,2595804973.827366,2317702297,17.363264087542255,32.00000000000001,-1.808327538038938,48.41506763880067,46.517587462729544,111.91544284615384,112.832515042009,-53.48241253727046
2022-06-23,112.949997,113.196503,111.028999,112.684502,112.684502,24710000,2608841136.3534784,2342412297,16.266138225647676,32.0,-1.5419306096119954,49.50378974616253,51.24167834729402,111.8343658846154,112.82155111297129,-48.75832165270598
2022-06-24,113.602997,118.637497,113.602997,118.538002,118.538002,39122000,2646416828.521519,2381534297,16.267940405307883,32.0,-0.8486973396523041,58.077864090688784,93.75090731985905,111.90500057692309,113.24499191941787,-6.2490926801409445
2022-06-27,118.934998,119.25,116.000748,116.622498,116.622498,32840000,2626144810.321638,2348694297,16.396855496354497,32.0,-0.448697833676448,54.79878770127863,80.71055861005122,112.06736584615383,113.49517755501654,-19.28944138994878
2022-06-28,116.350998,117.856499,112.444,112.571503,112.571503,28232000,2599242940.709099,2320462297,15.526010469691073,32.0,-0.45335083801242604,48.55512667497517,50.97074085787631,112.13759676923077,113.4267572176079,-49.02925914212369
2022-06-29,112.148499,113.664497,111.554001,112.2565,112.2565,18628000,2593015960.537613,2301834297,14.489016646281959,32.0,-0.4769584073581541,48.09622774241631,48.65819003730296,112.25080815384617,113.34007149778509,-51.341809962697035
2022-06-30,110.499496,111.329803,107.309998,109.372498,109.372498,38046000,2594011593.1541204,2263788297,14.364062834147118,32.0,-0.7200817804084068,43.996408301593796,27.485689484498398,112.16257746153846,113.04617716461581,-72.51431051550159
2022-07-01,108.336998,109.806351,107.105003,109.081001,109.081001,31028000,2608376682.784927,2232760297,14.291852333945457,28.000000000000004,-0.9256103173519676,43.591941258170586,25.34570470167207,112.28392353846154,112.7524604116813,-74.65429529832792
2022-07-05,107.514503,114.052597,106.249496,113.887001,113.887001,36398000,2643229819.221582,2269158297,13.41482426621624,24.0,-0.6927040677510234,51.50739463358654,60.62828691096955,112.5934428076923,112.83650045526046,-39.37171308903045
2022-07-06,114.092003,116.351997,112.250504,115.213501,115.213501,28852000,2656064292.6321177,2298010297,13.113222007864326,-36.00000000000001,-0.3965159341007052,53.449046623815505,70.366602620631,112.85950061538462,113.01257456968561,-29.63339737936899
2022-07-07,116.008003,119.862,115.533997,119.306,119.306,32184000,2679979211.4877653,2330194297,13.53039376324162,48.0,0.16652615276608174,58.914769552725055,96.09370938265717,113.10976969230771,113.47875423119038,-3.906290617342844
2022-07-08,117.550003,120.434998,117.514,120.168503,120.168503,29082000,2703754663.8009815,2359276297,14.025138706575081,52.0,0.6745619170888801,59.981217398448635,98.20014250546221,113.34551976923078,113.97429117702814,-1.7998574945377992
2022-07-11,118.650002,118.794502,116.234497,116.522499,116.522499,26718000,2683048243.806489,2332558297,14.117171493297652,52.0,0.7740589983436195,53.642464445914406,72.4190303593063,113.4372696923077,114.16304731206309,-27.580969640693695
2022-07-12,116.838501,117.849503,114.614998,114.849503,114.849503,24970000,2661698946.108696,2307588297,13.749615447623885,52.0,0.7097329964965411,50.98019220742145,60.625327182640454,113.3258658846154,114.2138958815399,-39.37467281735954
2022-07-13,112.639,115.156998,111.822998,112.186996,112.186996,38958000,2631247625.223273,2268630297,12.847857325359755,52.0,0.43885328568762816,46.98376339605147,41.85611478536325,113.23444253846152,114.06375514957398,-58.14388521463674
2022-07-14,110.825996,111.987503,109.3255,111.440002,111.440002,32366000,2650300028.3820972,2236264297,12.58921553422231,52.0,0.16203515003178381,45.896679852610376,36.59021725138817,113.0201926923077,113.86940306442035,-63.40978274861183
2022-07-15,112.962997,114.000504,111.822502,112.766998,112.766998,34330000,2645744608.644191,2270594297,11.830983891949918,52.0,0.04916552067142277,48.190006118709675,45.94481041277219,112.848558,113.78774343001884,-54.05518958722781
2022-07-18,113.440002,114.800003,109.300003,109.910004,109.910004,33354000,2619789144.4092817,2237240297,11.702744415915749,52.0,-0.2677337447325385,43.877694595857186,25.804571456124762,112.56671203846153,113.50050347223967,-74.19542854387524
2022-07-19,111.730003,114.809998,110.5,114.620003,114.620003,30992300,2648049015.2812405,2268232597,11.580907676191766,52.0,-0.1372391322173172,51.571639653366056,59.00747819851566,112.55525065384616,113.58342936318489,-40.99252180148434
2022-07-20,114.059998,116.330002,113.260002,114.699997,114.699997,26780100,2646391527.7239113,2295012697,11.040893849482414,52.0,-0.027054496973562436,51.692768340515414,59.571391974707716,112.68111599999999,113.66613807702305,-40.428608025292284
2022-07-21,115.089996,115.209999,111.910004,115.040001,115.040001,27267800,2670849946.8221827,2322280497,10.878119632055355,52.0,0.08670363601768827,52.23956619740228,61.9682334823259,112.9950966923077,113.76790570094727,-38.0317665176741
2022-07-22,111.809998,113.18,107.599998,108.360001,108.360001,44455300,2638504377.7383723,2277825197,11.673148679873991,52.0,-0.35803519011187745,42.14593436682329,14.877901395382437,113.03994288461539,113.36732016754377,-85.12209860461756
2022-07-25,108.879997,110.580002,107.010002,108.209999,108.209999,28289900,2629232850.360389,2249535297,12.528125298535965,52.00000000000001,-0.7143630887591286,41.94992161672643,8.938527802913288,112.95607734615383,112.98529637735534,-91.06147219708672
2022-07-26,107.43,107.739998,104.760002,105.440002,105.440002,36626600,2609321768.0993395,2212908697,13.754216948782668,-48.0,-1.2063649000780998,38.39844316095302,4.33811912934464,112.91007734615384,112.42638568273644,-95.66188087065537
2022-07-27,109.599998,114.400002,108.419998,113.599998,113.599998,41474600,2639699437.094477,2254383297,13.024615733307177,-48.0,-0.9271488046718446,51.44053501241407,56.39552316313193,113.13063492307694,112.51331992845967,-43.604476836868066
2022-07-28,112.800003,114.699997,111.850998,114.589996,114.589996,23303800,2661203698.8680334,2277687097,12.275483296758953,-48.0,-0.6188497577903291,52.74763312737202,70.04164024368522,113.22967326923077,112.6671477856108,-29.95835975631477
2022-07-29,113.400002,116.900002,113.230003,116.639999,116.639999,31336200,2688099839.887854,2309023297,11.737987693418862,-48.0,-0.2067194987488108,55.423387361978854,90.75973942780557,113.40682719230769,112.96143306075074,-9.24026057219443
2022-08-01,115.529999,117.120003,114.690002,115.480003,115.480003,22856200,2680104885.505613,2286167097,11.290561509633504,-48.0,0.02599506316406064,53.57467692367902,86.73139265927244,113.51434646153847,113.14799379699141,-13.26860734072757
2022-08-02,114.43,117.080002,114.260002,115.900002,115.900002,17911000,2683026537.9878826,2304078097,10.756539516308703,-48.0,0.2415292405811158,54.170743930365994,90.12944254616163,113.41288492307692,113.35184625647352,-9.870557453838366
2022-08-03,116.339996,119.419998,116.150002,118.779999,118.779999,25302800,2698424881.40922,2329380897,10.840764782544387,-48.0,0.6373859295479747,58.139655389710185,95.63438489342013,113.49586573076924,113.75393164488288,-4.365615106579857
2022-08-04,118.300003,119.5,117.709999,118.870003,118.870003,15757700,2703090628.1344457,2345138597,10.938468658450585,-48.0,0.9474462080314083,58.26130812989869,95.72593564802382,113.73811573076924,114.13289989341008,-4.274064351976188
2022-08-05,116.93,118.860001,116.709999,118.220001,118.220001,15615700,2709409547.945404,2329522897,10.708214903980258,-48.0,1.1277218084611178,56.973562635366605,91.3161521460179,113.96748115384615,114.43564812352784,-8.683847853982094
2022-08-08,119.120003,120.860001,117.830002,118.139999,118.139999,17061100,2695839465.478215,2312461797,11.017844138449048,36.0,1.2497299192426539,56.807135731243356,83.10557659040852,114.30469273076922,114.710044484748,-16.894423409591482
2022-08-09,117.989998,118.199997,116.559998,117.5,117.5,15424300,2698096728.5140467,2297037497,10.882116582077758,36.0,1.2800243317439595,55.41262451437507,79.13042727518183,114.62850038461536,114.91670785624814,-20.869572724818166
2022-08-10,119.589996,121.779999,119.360001,120.650002,120.650002,20497000,2699451937.0671115,2317534497,11.63384676249748,43.99999999999999,1.5404543092678296,60.546244175206795,93.36076851247387,114.88861580769232,115.34139631134087,-6.63923148752613
2022-08-11,122.080002,122.339996,119.550003,119.82,119.82,16671600,2686007070.600278,2300862897,12.45690525191614,48.0,1.660728869330498,58.63070990842991,85.6655468710626,115.06578884615384,115.67314473272303,-14.334453128937394
2022-08-12,121.160004,122.650002,120.400002,122.650002,122.650002,16121100,2702128170.600278,2316983997,13.293094002700908,52.0,1.9617905346863722,62.93639855171117,100.0,115.19440430769231,116.18994897474354,-0.0
2022-08-15,122.209999,123.260002,121.57,122.879997,122.879997,15525000,2710671430.1940536,2332508997,14.215898165776181,56.0,2.193655651022894,63.27097112336295,97.43932009721831,115.29869253846155,116.6855080877255,-2.5606799027816787
2022-08-16,122.32,123.227997,121.535004,122.510002,122.510002,15626200,2713043548.849358,2316882797,15.05776513901765,56.0,2.3208021592520964,62.296721928137934,93.42624474494004,115.52898111538462,117.11695208122731,-6.573755255059953
2022-08-17,120.93,122.150002,120.199997,120.32,120.32,17589200,2697619222.034401,2299293597,15.26284709247266,56.0,2.219269467303434,56.72869078365597,70.68791332880485,115.73938484615384,117.35421489002529,-29.31208667119514
2022-08-18,120.230003,121.690002,119.550003,120.860001,120.860001,15652000,2701129930.7048254,2314945597,15.179491096113878,56.0,2.157507244639362,57.73188287428268,73.3333222222222,116.07296196153847,117.61390275002341,-26.666677777777814
2022-08-19,119.870003,120.0,117.669998,118.120003,118.120003,20187000,2688740564.2991314,2294758597,14.352854611536022,56.0,1.8659557226701793,51.24049253599209,42.888899999999964,116.32988507692306,117.65139165742909,-57.11110000000003
2022-08-22,116.099998,116.5,114.669998,115.07,115.07,19316000,2677868750.296742,2275442597,14.079705034756326,56.0,1.3729626302707345,45.15417485018598,4.6565985301053034,116.41846207692308,117.46017746058249,-95.34340146989469
2022-08-23,114.32,115.93,114.300003,114.769997,114.769997,14390700,2671776890.9152217,2261051897,13.939811667738491,56.0,0.9471363199262015,44.59310229847243,5.245469335431846,116.60538488461538,117.26090483387267,-94.75453066456815
2022-08-24,114.449997,115.717003,113.779999,114.699997,114.699997,16051200,2670973023.287896,2245000697,13.97456990151615,56.0,0.5971340959249147,44.45430147940707,9.704617182083096,116.60846157692308,117.07120795728952,-90.2953828179169
2022-08-25,115.150002,117.779999,115.050003,117.699997,117.699997,14874700,2684975922.9267235,2259875397,13.183142104879051,56.0,0.5554271216113591,51.431582191866255,41.35017678791868,116.72384619230769,117.11778492341622,-58.649823212081316
2022-08-26,115.809998,116.599998,111.220001,111.300003,111.300003,31698700,2654219959.2878776,2228176697,13.611439397058055,56.0,0.005880231518290202,39.91312132657311,0.6644683833498638,116.58000011538462,116.68683811427428,-99.33553161665013
2022-08-29,110.779999,111.959999,109.809998,110.339996,110.339996,20386100,2643884638.0808177,2207790597,14.369043534997255,56.0,-0.5013252149252025,38.51956212193787,3.940504404311002,116.65615376923076,116.21670166136508,-96.059495595689
2022-08-30,111.029999,111.370003,108.800003,109.910004,109.910004,20548200,2641086261.0755258,2187242397,15.320909240598775,56.00000000000001,-0.9272966477236793,37.88158004750649,7.676355994215471,116.7215385769231,115.74953887163434,-92.32364400578453
2022-08-31,111.629997,111.769997,109.050003,109.150002,109.150002,25898000,2617092510.939312,2161344397,16.029711372406314,52.0,-1.3110944067797448,36.7238317093288,2.4204635145548554,116.86423088461538,115.26068428855031,-97.57953648544515
2022-09-01,109.199997,111.220001,108.190002,110.550003,110.550003,22784400,2629800668.3853045,2184128797,16.91509915640369,-52.0,-1.48516841849856,40.34093427041407,15.660258792302574,116.74692338461537,114.91174493384288,-84.33974120769741
2022-09-02,111.339996,111.675003,108.129997,108.68,108.68,20618100,2615580310.366164,2163510697,17.52010692467226,-56.0,-1.7538002234805532,37.275821126354536,3.642886475029831,116.51961584615385,114.45013419800267,-96.35711352497017
2022-09-06,108.135002,108.879997,106.510002,107.480003,107.480003,20565100,2611849142.5601983,2142945597,18.52537190740241,-60.0,-2.0400066664324754,35.416197603579235,6.2020524296674955,116.16730830769232,113.9338281833358,-93.79794757033251
2022-09-07,107.760002,110.989998,107.614998,110.480003,110.480003,22987200,2627889168.0037537,2165932797,18.47643189562853,-60.0,-2.0016783050251945,43.063594580390095,26.15283926218705,115.97500061538462,113.67798928086648,-73.84716073781296
2022-09-08,109.18,110.580002,108.059998,109.419998,109.419998,21660700,2629608234.0676174,2144272097,18.430987598981353,-60.0,-2.0333966166858772,41.20693746872399,21.571508016532,115.72576969230771,113.36258251932081,-78.42849198346799
2022-09-09,110.050003,112.0,110.0,111.779999,111.779999,21732900,2646559874.3347173,2166004997,17.753949067362928,-60.0,-1.8468123467142021,46.71518957032695,46.76129904914794,115.45653892307692,113.24535411048222,-53.238700950852056
2022-09-12,111.989998,112.639999,110.93,111.870003,111.870003,19732900,2648521706.552338,2185737897,16.85043693972998,-60.0,-1.6724019887966506,46.91943744678627,47.55991505587797,115.18730815384615,113.14347625044651,-52.440084944122034
2022-09-13,108.889999,109.370003,105.0,105.309998,105.309998,33015000,2620190723.4603357,2152722897,17.777645046585267,-80.0,-2.0400022270230806,36.06769349412855,2.4256496420695575,114.69076957692307,112.56321860226528,-97.57435035793044
2022-09-14,105.440002,106.099998,104.5,105.870003,105.870003,22115800,2635948361.236383,2174838697,18.75446940174412,-84.0,-2.2600874595136276,37.39876702175038,10.316288427431331,114.21884665384616,112.06742485394933,-89.68371157256865
2022-09-15,105.010002,106.209999,103.309998,103.900002,103.900002,26494900,2620234214.056537,2148343797,19.93535645190469,-88.0,-2.5639140039490798,34.66458803051006,4.439458239277707,113.69576980769232,111.4624305684716,-95.56054176072229
2022-09-16,102.970001,104.029999,101.855003,103.629997,103.629997,64540100,2661035264.347756,2083803697,21.348949029493788,-92.0,-2.794275211082848,34.294517588360875,16.45799405025283,113.04115423076922,110.88225030414037,-83.54200594974716
2022-09-19,102.540001,104.019997,102.370003,103.849998,103.849998,19738600,2676706525.604221,2103542297,22.661570708683666,-92.0,-2.9253641088533726,34.90431849478459,18.497874269030806,112.42692338461538,110.3613427260559,-81.5021257309692
2022-09-20,102.879997,103.169998,101.120003,101.830002,101.830002,24001700,2669330410.543013,2079540597,24.155845069842062,-100.0,-3.155870885068424,31.970418436627412,6.163187903884653,111.62615415384614,109.72939156116286,-93.83681209611535
2022-09-21,102.239998,103.489998,99.989998,100.010002,100.010002,26596800,2643037634.7642703,2052943797,25.7796446491385,-100.0,-3.445688206774591,29.559570417906187,0.15813437485103857,110.74653896153845,109.0094367788545,-99.84186562514896
2022-09-22,99.449997,101.68,99.410004,100.57,100.57,21272700,2643506159.7789397,2074216497,27.406535546173092,-100.0,-3.588813752763471,31.276785712172924,8.767924704431048,109.90269273076923,108.38429331375416,-91.23207529556895
2022-09-23,100.059998,100.110001,98.010002,99.169998,99.169998,25657000,2646193951.7259836,2048559497,29.19442605361294,-100.0,-3.771732060842922,29.350398370751577,7.928887476873758,109.08923111538462,107.70175292014274,-92.07111252312625
2022-09-26,98.610001,100.440002,98.379997,98.809998,98.809998,22437900,2633123329.415018,2026121597,30.650016220103776,-96.0,-3.9007793727474223,28.858189863633015,5.468189774748367,108.24115407692308,107.04310440753957,-94.53181022525165
2022-09-27,99.910004,100.459999,97.339996,98.089996,98.089996,24225000,2620544952.8317266,2001896597,32.21757037658976,-88.0,-4.014867547342149,27.852162214904865,4.901959823145131,107.47076919230769,106.37991119216628,-95.09804017685487
2022-09-28,98.019997,101.400002,97.800003,100.739998,100.739998,24617000,2636135662.286646,2026513597,33.07219205499557,-88.0,-3.847103222054912,36.61109621504428,22.22223093681746,106.91961526923076,105.96213984459841,-77.77776906318253
2022-09-29,99.300003,99.300003,96.519997,98.089996,98.089996,21921500,2638974348.472215,2004592097,34.16401814302365,-96.0,-3.883218474641211,32.37796124347136,9.739446682450758,106.27807676923076,105.37901807833187,-90.26055331754924
2022-09-30,97.730003,99.494003,96.029999,96.150002,96.150002,26277800,2614517224.6800947,1978314297,35.28821057873642,-100.0,-4.022018054591811,29.673064721620662,0.8995724439062914,105.56461542307692,104.69538725771469,-99.10042755609372
2022-10-03,97.220001,99.970001,97.019997,99.300003,99.300003,24840000,2628074019.423424,2003154297,36.00716306927193,-96.0,-3.8336470696005023,38.637072335731155,32.12184675834973,104.85692334615386,104.29572916455064,-67.87815324165027
2022-10-04,101.040001,102.720001,101.040001,102.410004,102.410004,22580900,2642321572.688543,2025735197,35.02577100392532,-56.0,-3.394283430993653,45.96067777325274,62.67195481335954,104.5150003076923,104.15604581902838,-37.32804518664045
2022-10-05,100.690002,102.739998,99.739998,102.220001,102.220001,18475500,2654392269.6395426,2007259697,34.52983621892383,-56.0,-3.026528301817393,45.60258713982769,77.37502499999991,104.20269280769232,104.01263509169294,-22.62497500000009
2022-10-06,101.5,103.730003,101.5,102.239998,102.239998,17156200,2648622201.1268992,2024415897,33.540478914338145,-56.0,-2.702315510561718,45.6505815335734,77.72215963007746,103.90769257692308,103.88132864045642,-22.27784036992254
2022-10-07,100.650002,101.419998,99.209999,99.57,99.57,24249900,2632272746.5568743,2000165997,33.33494960748592,-56.0,-2.630498315013128,40.51112348603569,45.97401507843363,103.53923096153845,103.56197096338556,-54.02598492156637
2022-10-10,99.849998,99.989998,97.870003,98.709999,98.709999,16529900,2628841981.111814,1983636097,33.50807038087872,-56.0,-2.6128581610646506,38.988541444128494,34.805176724583454,103.0838461923077,103.2025656327644,-65.19482327541654
2022-10-11,98.25,100.120003,97.25,98.050003,98.050003,21617700,2619275993.150512,1962018397,33.83092086967245,-56.0,-2.6219106198108335,37.81395351814456,26.23380455386779,102.67500015384614,102.8208943266337,-73.76619544613222
2022-10-12,98.269997,99.648003,97.669998,98.300003,98.300003,17343400,2612980521.459086,1979361797,34.13071060926662,-56.0,-2.57918065877368,38.56890696962864,29.480556113996855,102.32192323076924,102.48601348762381,-70.51944388600316
2022-10-13,95.93,100.529999,95.269997,99.709999,99.709999,32812200,2635562305.5771146,2012173997,35.01499902063781,-92.0,-2.403832083502138,42.787618310917075,52.48225592274989,101.9076923076923,102.28038278483686,-47.51774407725011
2022-10-14,100.625,101.290001,97.029999,97.18,97.18,22624800,2614530811.2257037,1989549197,35.369402660355064,-92.0,-2.4408799053435075,37.774810906041154,22.576851600341712,101.43692315384615,101.90257665262672,-77.42314839965829
2022-10-17,99.519997,101.769997,99.510002,100.779999,100.779999,23311600,2617418970.132427,2012860797,35.40413537479326,-92.0,-2.1549102739617325,47.24563961389077,65.1300010898338,101.01384623076923,101.81942275243215,-34.8699989101662
2022-10-18,103.940002,104.220001,100.650002,101.389999,101.389999,21610500,2604767411.1116824,2034471297,34.084729339422175,-88.0,-1.8576416422641984,48.67122998249277,68.37988005368494,100.61076915384615,101.78761358558532,-31.620119946315057
2022-10-19,100.699997,101.658997,99.635002,100.290001,100.290001,21573700,2597156939.208886,2012897597,33.20671953709969,-80.0,-1.6913182910223696,46.24438443385378,56.089405099707264,100.41769234615384,101.6766793199864,-43.910594900292736
2022-10-20,100.82,103.0,99.970001,100.529999,100.529999,25125100,2581318974.7820663,2038022697,31.722878506115602,-80.0,-1.5225885509779573,46.866878983539095,58.770945800694655,100.2123075769231,101.59174003702445,-41.22905419930534
2022-10-21,98.459999,101.620003,98.230003,101.480003,101.480003,28988700,2607913327.8794117,2067011397,30.951561977481617,12.0,-1.2972576543508154,49.366379280386184,69.38551088915712,100.11923069230768,101.58346321946708,-30.61448911084288
2022-10-24,102.089996,103.099998,100.300003,102.970001,102.970001,24680800,2630302388.103019,2091692197,29.5306990542996,12.0,-0.9870725512457739,53.09343933753827,86.03352579507225,100.09384623076923,101.68616972172877,-13.96647420492774
2022-10-25,103.300003,105.099998,103.019997,104.93,104.93,29910200,2655323480.665475,2121602397,27.473262347769882,32.0,-0.5764481479441628,57.52277313751872,98.27062072526756,100.13538476923078,101.92645344604516,-1.7293792747324503
2022-10-26,96.760002,98.540001,94.57,94.82,94.82,71504300,2592824757.7421556,2050098097,27.801809808684446,-4.0,-1.05466038868569,37.73104720577213,2.3741694917700826,99.8657693076923,101.40004948707885,-97.62583050822991
2022-10-27,94.309998,95.169998,91.900002,92.599998,92.599998,54036500,2561923046.808564,1996061597,28.59088259260007,-8.0,-1.5944033534981799,34.89209674096777,5.303001606970175,99.58076915384616,100.74819382136931,-94.69699839302983
2022-10-28,92.529999,96.860001,92.322998,96.580002,96.580002,35696900,2593213912.11866,2031758497,28.69215627288217,-8.0,-1.681615860362669,43.15057215498497,35.45455619835031,99.42730769230768,100.43943887163825,-64.54544380164968
2022-10-31,95.779999,96.349998,94.379997,94.660004,94.660004,29868700,2571836014.997339,2001889797,28.786196118858406,-8.0,-1.883943267617056,40.482858035776964,20.909112396700728,99.25384638461539,100.01133258485024,-79.09088760329928
2022-11-01,95.589996,96.165001,90.43,90.5,90.5,43220600,2529670494.8482404,1958669197,29.609331431315287,-20.0,-2.3528446235272895,35.379232607134256,0.47716434589829676,98.93423107692307,99.3067894304169,-99.52283565410171
2022-11-02,90.910004,91.300003,87.010002,87.07,87.07,43553600,2487335136.472333,1915115597,30.888174113668736,-24.0,-2.967022670197366,31.8175190076999,0.3316639760450644,98.51038507692307,98.40036058371935,-99.66833602395494
2022-11-03,86.345001,86.550003,83.449997,83.489998,83.489998,48510400,2440076646.636636,1866605197,32.5224007969812,-28.0,-3.699988277472258,28.583116949043273,0.18476211617728666,97.84692353846154,97.29588928122162,-99.81523788382272
2022-11-04,85.510002,86.730003,83.879997,86.699997,86.699997,40173300,2479404025.582575,1906778497,33.96909324145141,-28.0,-3.9760156760212766,34.966770710720326,15.011546650736873,97.40884665384615,96.5110083715015,-84.98845334926312
2022-11-07,87.339996,88.940002,86.959999,88.650002,88.650002,26899900,2498424168.8347316,1933678397,34.45535827198219,-28.0,-3.9914097839896243,38.55961090309192,24.018497735866173,97.12038511538461,95.92871160324212,-75.98150226413382
2022-11-08,89.160004,90.404999,87.650002,88.910004,88.910004,30172000,2495850587.521939,1963850397,34.37301463917871,-28.0,-3.937243643121647,39.04317115298887,25.219430705799986,96.72076976923077,95.4088073363353,-74.78056929420002
2022-11-09,88.544998,89.489998,87.360001,87.400002,87.400002,26743900,2470111179.7760596,1937106497,34.34987115933982,-27.999999999999993,-3.970392910041369,37.21145246932312,18.24482594712122,96.143462,94.81556249660676,-81.75517405287877
2022-11-10,92.339996,94.550003,91.650002,94.169998,94.169998,42371200,2501378060.9458246,1979477697,32.664676041604814,-28.0,-3.411061254094804,48.80762225465821,49.51501387921418,95.83384649999999,94.76774290426552,-50.48498612078582
2022-11-11,94.709999,97.360001,94.160004,96.730003,96.730003,30569100,2519910604.747928,2010046797,30.355140102015785,-28.0,-2.729749030728172,52.38845079616876,61.33951679725095,95.6219236153846,94.91309550394955,-38.660483202749056
2022-11-14,95.5,97.18,95.112999,96.029999,96.029999,24170100,2517186049.960533,1985876697,28.210571015254544,-28.0,-2.220689926600727,51.331137951196354,83.36645901485515,95.48576973076923,94.9958290962496,-16.63354098514486
2022-11-15,98.669998,100.419998,97.019997,98.720001,98.720001,31831000,2517186115.4949255,2017707697,26.973126600483685,-28.0,-1.5819603843173837,55.082749635872034,89.9823400128261,95.48615442307693,95.27169368171258,-10.017659987173893
2022-11-16,98.019997,99.849998,97.902,98.989998,98.989998,24660200,2520072399.9159565,2042367897,25.824071072482173,-28.0,-1.0419649949578655,55.453914835475864,91.5733652579042,95.52230807692308,95.54712363121534,-8.426634742095807
2022-11-17,97.18,99.480003,97.099998,98.5,98.5,21818700,2523922741.483012,2020549197,24.510775997611375,-28.0,-0.6461055987934827,54.572564643666134,88.68592877513674,95.53000026923077,95.76585521408828,-11.314071224863248
2022-11-18,99.010002,99.160004,96.739998,97.800003,97.800003,24969900,2520827348.2813425,1995579297,23.17762924121124,-28.000000000000004,-0.3844365379946879,53.27004023125737,84.56102035586208,95.45653888461538,95.91653282785951,-15.43897964413792
2022-11-21,97.559998,98.720001,95.669998,95.830002,95.830002,18696900,2504092137.3600745,1976882397,21.597513373606795,-28.0,-0.3321951993290213,49.67653906452276,72.95229387434915,95.40461588461538,95.91012313690695,-27.04770612565085
2022-11-22,96.160004,97.547997,94.410004,97.330002,97.330002,18868900,2520339408.9144406,1995751297,20.371226126078607,-28.0,-0.16782155565275048,52.31428268387608,81.79142122619785,95.2719236923077,96.01529934898791,-18.208578773802145
2022-11-23,97.339996,99.069,97.339996,98.82,98.82,17568900,2532847989.678626,2013320197,19.091425256119624,-28.0,0.08173394928624589,54.84612257982813,90.32649393431105,95.17307757692308,96.22305495276657,-9.67350606568895
2022-11-25,98.464996,98.940002,97.529999,97.599998,97.599998,8567800,2525130879.26184,2004752397,17.903038734014853,-28.0,0.1790011061554111,52.39320786045521,79.04903261879882,95.06961592307692,96.32505073404313,-20.95096738120118
2022-11-28,97.199997,97.830002,95.889999,96.25,96.25,19974500,2512569604.8852024,1984777897,17.006241644150474,-28.0,0.1454755212961345,49.74215503327279,68.07045208356476,94.90500057692307,96.31949142041032,-31.92954791643523
2022-11-29,96.0,96.389999,94.389999,95.440002,95.440002,20220000,2513580665.5452023,1964557897,16.64523209815103,-28.0,0.05293597166227926,48.16733294705775,61.86832202181979,94.67269284615385,96.25434405593548,-38.13167797818021
2022-11-30,95.120003,101.449997,94.669998,101.449997,101.449997,39888100,2553468765.5452023,2004445997,16.219617001016918,-28.000000000000004,0.4592600171438903,58.63240111152683,100.0,94.61423115384615,96.63920723697728,-0.0
2022-12-01,101.400002,102.589996,100.669998,101.279999,101.279999,21771500,2545531276.5926094,1982674497,16.122766195576556,76.0,0.758810240616441,58.274001335433475,84.46028181284163,94.47384649999998,96.98296958979378,-15.539718187158373
2022-12-02,99.370003,101.150002,99.169998,100.830002,100.830002,18821500,2558269071.711205,1963852997,15.522897910109334,76.0,0.9489559799112897,57.27595008819699,78.53665068414041,94.70500042307692,97.26793495351275,-21.46334931585959
2022-12-05,99.815002,101.75,99.355003,99.870003,99.870003,19955500,2546895697.283805,1943897497,15.137742120400684,76.0,1.0105351320093945,55.10757145040137,66.8293415229298,94.98461599999999,97.46068073473403,-33.17065847707022
2022-12-06,99.669998,100.209999,96.760002,97.309998,97.309998,20877600,2532674680.7472687,1923019897,14.18477744554158,76.0,0.843047913487851,49.7036860341933,35.609756930398774,95.01269276923077,97.44951905067965,-64.39024306960123
2022-12-07,96.769997,97.309998,95.025002,95.150002,95.150002,26647900,2508942311.0151553,1896371997,13.807290726979028,76.0,0.5299109768856454,45.637274091616916,9.268332659146068,95.03153884615384,97.279184454333,-90.73166734085393
2022-12-08,95.690002,95.870003,93.800003,93.949997,93.949997,25593200,2487058122.069068,1870778797,13.796014533037184,76.0,0.18281000402768655,43.507648868878135,1.7064177411744526,95.16423103846154,97.03257797623425,-98.29358225882554
2022-12-09,93.900002,94.489998,93.019997,93.07,93.07,21885300,2466661706.302344,1848893497,13.99843365883919,76.0,-0.16141769839981635,41.96127335635176,0.5224974422671267,95.39500026923078,96.73905368169838,-99.47750255773286
2022-12-12,93.089996,93.875,91.900002,93.559998,93.559998,27380900,2485308381.4962425,1876274397,14.488125933361733,72.0,-0.3901840897786286,43.17244615964725,15.528502635268016,95.78230796153846,96.50356807564665,-84.47149736473199
2022-12-13,98.07,99.800003,95.379997,95.849998,95.849998,34788500,2457918346.470498,1911062897,13.89737780819748,68.0,-0.3822924124853415,48.57375384190665,36.950404275250285,96.13423107692307,96.4551554774506,-63.049595724749715
2022-12-14,95.540001,97.220001,93.940002,95.309998,95.309998,26452900,2453563238.078605,1884609997,12.928644147669004,60.0,-0.4148297888226864,47.42896197359496,31.898951486782806,96.39038476923078,96.37032899763945,-68.1010485132172
2022-12-15,93.540001,94.029999,90.43,91.199997,91.199997,28298800,2437369992.05437,1856311197,12.890886031876269,60.0,-0.7634579578753318,39.75011357908526,6.332214254017764,96.47846142307692,95.98734144225875,-93.66778574598223
2022-12-16,91.199997,91.75,90.010002,90.860001,90.860001,48485500,2436255381.577806,1807825697,12.95651933014227,-43.99999999999999,-1.0550214982114596,39.18493182563335,6.756752030247367,96.61153830769231,95.60753844653588,-93.24324796975264
2022-12-19,90.879997,91.199997,88.925003,89.150002,89.150002,23020500,2417788378.843733,1784805197,13.281283026766124,-48.0,-1.4078416110307899,36.383015377581835,1.6465357867362018,96.41846153846154,95.12920241345915,-98.3534642132638
2022-12-20,88.730003,89.779999,88.040001,89.629997,89.629997,21976800,2435976020.5187235,1806781997,13.796614084880442,-52.0,-1.6299336468746475,37.72902235046331,10.927811315399076,96.14538438461538,94.72185386431403,-89.07218868460092
2022-12-21,89.730003,90.915001,88.910004,90.25,90.25,20336400,2442822399.0010853,1827118397,13.86448131057445,-52.0,-1.7359037074716923,39.50936714279614,16.11961459661665,95.92307673076924,94.3906054299204,-83.88038540338334
2022-12-22,88.93,89.18,86.940002,88.260002,88.260002,23656100,2447046727.4657536,1803462297,14.426119628597641,-60.0,-1.9578925844924981,35.9560502135608,8.912897895057068,95.52076907692307,93.9364866573337,-91.08710210494294
2022-12-23,87.620003,90.099998,87.620003,89.809998,89.809998,17815000,2460695307.775391,1821277297,14.603746596790968,-60.0,-1.9858569230758292,40.44855738663198,21.627706471975756,95.16769215384616,93.63082083086454,-78.37229352802423
2022-12-27,89.309998,89.5,87.535004,87.93,87.93,15470900,2451444210.376923,1805806397,14.79194948122476,-60.0,-2.135106807457916,37.05346933992092,7.698273118330241,94.76115369230769,93.20853780635605,-92.30172688166977
2022-12-28,87.5,88.519997,86.370003,86.459999,86.459999,17879600,2435061444.769577,1787926797,15.290034799066143,-72.0,-2.3449738130853888,34.60743608894998,0.6701116902457129,94.3249996923077,92.70864604292227,-99.3298883097543
2022-12-29,87.029999,89.364998,86.989998,88.949997,88.949997,18280700,2446953505.7963557,1806207497,15.396188342116334,-72.0,-2.2840438623594963,41.63568195504424,19.21067758749068,94.06038411538461,92.43022759529839,-80.78932241250932
2022-12-30,87.364998,88.830002,87.029999,88.730003,88.730003,19190300,2464011575.1170735,1787017197,15.494759489234367,-72.0,-2.227827110510333,41.21421634065547,17.572598659717038,93.72961492307692,92.15613688453554,-82.42740134028296
2023-01-03,89.830002,91.550003,89.019997,89.699997,89.699997,20738500,2454421017.058713,1807755697,14.47971322046517,-72.0,-2.0810158649246944,43.91023551843738,24.795189873417705,93.37884557692308,91.97420059679217,-75.2048101265823
2023-01-04,91.010002,91.239998,87.800003,88.709999,88.709999,27046500,2441683960.4236016,1780709197,13.961802468794984,-72.0,-2.02125172818468,41.80302314213284,21.566787385582924,93.03692253846154,91.73240788591869,-78.43321261441707
2023-01-05,88.07,88.209999,86.559998,86.769997,86.769997,23136100,2424437017.901567,1757573097,13.890678686324959,-72.0,-2.1061517609019234,37.95880826788576,5.221856512718888,92.67230703846154,91.36482189436916,-94.7781434872811
2023-01-06,87.360001,88.470001,85.57,88.160004,88.160004,26612600,2445360084.5791993,1784185697,14.138496419132508,-96.0,-2.0377834017954655,42.06942774674266,41.909449838187776,92.39230711538463,91.12742797626774,-58.090550161812224
2023-01-09,89.195,90.830002,88.580002,88.800003,88.800003,22996700,2426860537.465155,1807182397,13.406771284283776,-96.0,-1.9099417939280556,43.912080361240974,54.013400996621655,91.90576888461538,90.95502612617383,-45.986599003378345
2023-01-10,86.720001,89.474998,86.699997,89.239998,89.239998,22855600,2445845100.3015647,1830037997,13.342474511896654,-88.0,-1.7529159553546947,45.202553879067196,61.371173225163936,91.44269192307692,90.82798700571651,-38.628826774836064
2023-01-11,90.059998,92.449997,89.739998,92.260002,92.260002,25998800,2468198406.7010136,1856036797,12.560767173878272,-88.0,-1.3690017632490168,53.16732326761817,97.23844356327486,91.11307653846153,90.93406219047826,-2.761556436725133
2023-01-12,92.400002,92.620003,90.57,91.910004,91.910004,22754200,2475191206.112039,1833282597,11.891275827106044,-84.0,-1.080533199482474,52.2200122578659,89.92909648407249,90.80692273076923,91.00635417636876,-10.070903515927524
2023-01-13,91.528,92.980003,90.93,92.800003,92.800003,18630700,2490550178.2170067,1851913297,11.394828013284512,-64.0,-0.7712142255972054,54.442875441223855,97.5708511858903,90.63346138461537,91.1392170521933,-2.429148814109691
2023-01-17,92.779999,92.970001,90.839996,92.160004,92.160004,22935800,2496041954.1958423,1828977497,10.897471839770708,-64.0,-0.5711355853669033,52.54961358258371,88.9338911198822,90.51846146153845,91.21483090017898,-11.066108880117799
2023-01-18,92.940002,93.587997,91.400002,91.779999,91.779999,19641600,2483222809.526133,1809335897,10.672068897337263,-64.0,-0.4381839374899812,51.406518073050385,77.45075235124189,90.435,91.25669520386943,-22.54924764875811
2023-01-19,91.389999,94.400002,91.379997,93.910004,93.910004,28707700,2502614819.2642956,1838043597,10.770637227269281,-64.0,-0.15911106308509204,57.04661286821643,94.45076003380295,90.46730784615384,91.4532365961754,-5.5492399661970575
2023-01-20,95.949997,99.419998,95.910004,99.279999,99.279999,53704800,2552035498.952295,1891748397,12.352562274198766,-64.0,0.48972467683994125,67.33899442236861,98.98917674933959,90.68730788461538,92.03299677423648,-1.0108232506604184
2023-01-23,99.129997,101.400002,98.75,101.209999,101.209999,31791800,2579268406.260591,1923540197,14.260158515823553,40.0,1.1464509724867185,70.11102253397658,98.7997285155112,90.89346176923078,92.71277471688563,-1.2002714844887845
2023-01-24,99.550003,101.089996,98.699997,99.209999,99.209999,27391400,2563567110.5516806,1896148797,16.006828478182094,39.99999999999999,1.4883709936061393,64.04491503514505,86.16549132463784,91.04346180769231,93.19405058970892,-13.834508675362159
2023-01-25,97.199997,97.720001,95.262001,96.730003,96.730003,31000900,2569595814.4587593,1865147897,16.089668872142678,40.0,1.5414611184876605,57.411620594025806,70.49906247642924,91.25615434615383,93.45597299047122,-29.500937523570762
2023-01-26,98.279999,99.209999,96.82,99.160004,99.160004,24542100,2593111150.6069756,1889689997,16.56654829717843,40.0,1.759335670819496,61.60757117628463,85.84966698045902,91.57538523076923,93.87849380599187,-14.150333019540989
2023-01-27,99.050003,101.580002,98.970001,100.709999,100.709999,29020400,2602784557.9727197,1918710397,17.581870529906947,56.0,2.0336320218393666,64.04119280056523,94.15320760980929,92.0200005,94.38453122777025,-5.84679239019071
2023-01-30,98.745003,99.408997,97.519997,97.949997,97.949997,24365100,2589512092.1707077,1894345297,17.926813448212204,56.0,2.0051901769479343,57.100381168219805,75.60481330483425,92.3400005,94.64863980349098,-24.395186695165744
2023-01-31,97.860001,99.910004,97.790001,99.870003,99.870003,22306800,2610977106.2800274,1916652097,18.376028523245942,56.0,2.1132183819253356,60.32202975078227,85.55744575761969,92.71000061538462,95.03540744767683,-14.4425542423803
2023-02-01,99.739998,102.190002,98.419998,101.43,101.43,26392600,2626728641.2916613,1943044697,19.347093170528517,68.0,2.298217808822997,62.76850627896729,93.45953640971835,93.216539,95.50908097007114,-6.540463590281647
2023-02-02,106.790001,108.82,106.540001,108.800003,108.800003,46622600,2672533423.273145,1989667297,21.428069242131787,72.0,3.0048903306508237,71.65914774680321,99.88878200472041,93.9469238076923,96.49359371302883,-0.11121799527958609
2023-02-03,103.510002,108.019997,103.300003,105.220001,105.220001,36823400,2665668050.488095,1952843897,22.159234764371984,72.0,3.238723168770619,63.70169753343254,79.97776307502491,94.61192384615384,97.13999425280447,-20.02223692497509
2023-02-06,102.684998,104.699997,102.209999,103.470001,103.470001,25573000,2665976220.791043,1927270897,22.46748828093166,72.0,3.2454158690779167,60.1835078440944,69.32340550629493,95.26615469230768,97.60888364148562,-30.676594493705075
2023-02-07,103.629997,108.669998,103.547997,108.040001,108.040001,33738800,2691415396.178084,1961009697,23.45694049098495,72.0,3.5782330460243372,65.53643443629927,95.52752943907183,96.00038561538462,98.38155900137556,-4.472470560928171
2023-02-08,102.690002,103.580002,98.455002,100.0,100.0,73546000,2662212195.361694,1887463697,22.855644147401,72.0,3.1568420587769594,52.23216808132696,34.946152452142854,96.43384703846154,98.50144351979219,-65.05384754785715
2023-02-09,100.540001,100.610001,93.860001,95.459999,95.459999,97798600,2610777318.147709,1789665097,21.23111680270255,72.0,2.4285516948791326,46.49263208295265,10.695174511709524,96.65538557692307,98.27615133314092,-89.30482548829048
2023-02-10,95.739998,97.019997,94.529999,94.860001,94.860001,49325300,2574526283.790171,1740339797,19.722627125482557,72.0,1.7824149403166842,45.77671635212182,6.684492425433987,96.89192411538463,98.02310316031566,-93.31550757456601
2023-02-13,95.010002,95.349998,94.050003,95.0,95.0,43116600,2594426296.392835,1783456397,18.433941182561274,72.0,1.2670380307271074,45.98571631403831,7.620314680502341,97.20846269230768,97.79916959288487,-92.37968531949765
2023-02-14,94.660004,95.175003,92.650002,94.949997,94.949997,42513100,2629362605.271881,1740943297,17.56745875012427,64.0,0.8448246795589114,45.917640042295055,14.223842204556838,97.46961626923077,97.58811977118968,-85.77615779544317
2023-02-15,94.739998,97.339996,94.360001,97.099998,97.099998,36964500,2660373131.475952,1777907797,16.41373088568656,64.0,0.6759131630646351,49.38709576853581,27.520077615346647,97.78884684615385,97.55196260295341,-72.47992238465336
2023-02-16,95.540001,97.879997,94.970001,95.779999,95.779999,35642100,2644573003.571996,1742265697,15.477122172559167,60.0,0.43057330070513444,47.37754984119424,19.35681748383645,98.04038534615385,97.42070603977167,-80.64318251616355
2023-02-17,95.07,95.75,93.449997,94.589996,94.589996,31095100,2644302544.152813,1711170597,14.54024799186269,56.00000000000001,0.13851962733851053,45.57706312102267,11.997490661408861,98.1300005,97.2110238146034,-88.00250933859114
2023-02-21,93.239998,93.415001,92.0,92.050003,92.050003,28367200,2617940212.1375,1682803397,14.042071147972592,48.0,-0.29449644868761027,41.91554188496787,0.29728299643284073,98.13538507692307,96.82872597648462,-99.70271700356716
2023-02-22,91.933998,92.360001,90.870003,91.800003,91.800003,29891100,2625362884.3707514,1652912297,13.862213382235735,48.0,-0.6503409931675037,41.56162610745766,5.181059361736979,98.09692353846154,96.45622797822651,-94.81894063826302
2023-02-23,92.129997,92.129997,90.010002,91.07,91.07,32423700,2625362899.664985,1620488597,13.909490119091595,-56.0,-0.9799591406298873,40.48663266344631,5.680590713952954,98.05500030769232,96.0572481279875,-94.31940928604705
2023-02-24,89.629997,90.129997,88.860001,89.349998,89.349998,31295600,2618216588.5024304,1589192997,14.237635993471027,-60.0,-1.3642474881787052,37.993143404184906,2.473483463929864,97.96153873076922,95.56041478517362,-97.52651653607013
2023-02-27,90.089996,90.449997,89.610001,90.099998,90.099998,22724300,2622003935.7652745,1611917297,14.425876295976282,-60.0,-1.589952062603814,39.73603564675539,6.2594507207648835,97.81500003846153,95.15593946775336,-93.74054927923511
2023-02-28,89.540001,91.449997,89.519997,90.300003,90.300003,30546900,2616147984.243409,1642464197,14.231216830137631,-60.0,-1.7327122042462264,40.21860654512827,9.782621618028472,97.46961557692308,94.796240470142,-90.21737838197153
2023-03-01,90.160004,91.199997,89.849998,90.510002,90.510002,26323900,2615563183.747335,1668788097,14.050461611858884,-60.0,-1.8080632530629828,40.755040053005565,14.042561702127687,97.05807723076924,94.47874132420556,-85.95743829787232
2023-03-02,89.860001,92.480003,89.769997,92.309998,92.309998,23328600,2635964868.7198405,1692116697,13.390749104289336,-60.0,-1.7029048411323657,45.286935685595445,38.24832073096256,96.79269257692307,94.3180936705607,-61.75167926903743
2023-03-03,92.739998,94.110001,92.660004,94.019997,94.019997,30242500,2662452952.717601,1722359197,12.67399121124484,-60.0,-1.4646992723419174,49.257984306970286,57.20618944842108,96.68846157692307,94.29601243570436,-42.79381055157892
2023-03-06,94.360001,96.300003,94.300003,95.580002,95.580002,28288200,2670373620.4294004,1750647397,12.708124976232071,-60.0,-1.1369344048013232,52.63538794889173,74.50115277212974,96.55076919230768,94.39112277380032,-25.498847227870257
2023-03-07,95.419998,96.089996,93.844002,94.169998,94.169998,24101500,2653268570.6371927,1726545897,12.56020600284374,-60.0,-0.9796610025424712,49.43274157962474,58.86917244752665,96.29923069230769,94.37474316092623,-41.13082755247335
2023-03-08,94.404999,96.239998,94.404999,94.650002,94.650002,25395200,2634654736.932869,1751941097,12.472712028958364,-60.0,-0.8069859551596892,50.53613006053415,64.19072691384785,96.1723078076923,94.39513270456132,-35.809273086152146
2023-03-09,94.489998,95.919998,92.355003,92.660004,92.660004,24438900,2614397547.672379,1727502197,11.592120245678837,-60.0,-0.8212490951855926,46.04991266452932,51.075295409866825,95.89500015384615,94.2666046523716,-48.924704590133175
2023-03-10,92.5,93.18,90.800003,91.010002,91.010002,32850100,2587344503.8450546,1694652097,11.328522278906803,-60.0,-0.9546890471125948,42.667749290924945,28.897855134985196,95.494231,94.02537482627,-71.10214486501481
2023-03-13,90.565002,93.080002,89.940002,91.660004,91.660004,31508600,2590354919.779577,1726160697,11.374672090865321,-48.00000000000001,-0.9965043593390277,44.40017299443726,37.63443880794657,94.83500026923076,93.85016217247221,-62.36556119205343
2023-03-14,93.07,94.830002,92.779999,94.25,94.25,32303900,2604379503.497796,1758464597,10.710893632974685,-48.0,-0.8113001012903567,50.78204089980089,72.44620364349362,94.41307715384616,93.87977978932612,-27.553796356506382
2023-03-15,93.540001,97.25,93.040001,96.550003,96.550003,38367300,2629988133.0572095,1796831897,10.644947067048761,-48.0,-0.4734754421207015,55.650354191250344,91.65676896981756,94.14692338461539,94.07757410122788,-8.343231030182434
2023-03-16,96.57,101.970001,95.870003,101.07,101.07,54499500,2668405790.2436543,1851331397,11.8485388266835,-44.0,0.15716729018738818,63.3273548998039,92.77107862776587,93.87884642307692,94.595531575211,-7.228921372234127
2023-03-17,100.839996,103.489998,100.75,102.459999,102.459999,76140300,2687301936.8831773,1927471697,13.2962373791928,60.0,0.7603526298568113,65.31571567551727,92.6270656673539,93.97346176923078,95.17808471778797,-7.372934332646103
2023-03-20,101.059998,102.580002,100.790001,101.93,101.93,26033900,2694428487.5936522,1901437797,14.640528892237148,60.0,1.181989626693479,63.8932135333576,88.62975301532417,94.22230796153846,95.67822659054441,-11.370246984675829
2023-03-21,101.980003,105.959999,101.860001,105.839996,105.839996,33122800,2725612342.565679,1934560597,16.5732896424523,68.0,1.8107705486972066,69.21921076843611,99.25878329107064,94.64461546153846,96.43095025050408,-0.7412167089293566
2023-03-22,105.139999,107.510002,104.209999,104.220001,104.220001,32336900,2693471462.7958426,1902223697,18.63939549927731,72.0,2.1535392420198036,64.94477902046462,81.27489470688671,94.99923088461539,97.00791697268897,-18.72510529311329
2023-03-23,105.889999,107.100998,105.410004,106.260002,106.260002,31385800,2693638544.980404,1933609497,20.557922366329105,72.0,2.5602835773349994,67.65359298820364,92.88560045532157,95.43423107692307,97.69325660434166,-7.114399544678432
2023-03-24,105.739998,106.160004,104.739998,106.059998,106.059998,25236200,2715320152.36995,1908373297,22.01060035097645,72.0,2.833826158253359,67.10609638151402,91.74727376209444,95.77884646153846,98.31301522624227,-8.252726237905563
2023-03-27,105.32,105.400002,102.629997,103.059998,103.059998,25393400,2697810627.9538565,1882979897,22.38428544092318,72.0,2.776529591642344,59.34786192899388,74.6727148548662,96.05884642307691,98.66464357985396,-25.3272851451338
2023-03-28,103.0,103.0,100.279999,101.360001,101.360001,24913500,2692681407.317724,1858066397,21.784914491421997,72.0,2.5643854600622973,55.436665675960995,64.99714854866245,96.31923123076923,98.86429968504996,-35.00285145133754
2023-03-29,102.720001,102.82,101.029999,101.900002,101.900002,26148300,2691951081.324331,1884214697,21.22835575259947,72.0,2.412028907285219,56.41916258792903,68.0705748434832,96.69807734615384,99.0891665231944,-31.929425156516803
2023-03-30,101.440002,101.610001,100.290001,101.32,101.32,25009800,2705971688.8852396,1859204897,20.413267420888843,72.0,2.2189057630036046,55.016144474168094,64.7694820717131,97.06423107692308,99.25441344740221,-35.2305179282869
2023-03-31,101.709999,104.190002,101.440002,104.0,104.0,28108000,2730195633.4554214,1887312897,20.43529597619345,72.0,2.256100954657569,59.96968414504244,76.17107070514514,97.56153876923076,99.60593837722428,-23.82892929485487
2023-04-03,102.669998,104.949997,102.379997,104.910004,104.910004,20719900,2750270668.8945656,1908032797,20.66493982748954,64.0,2.3321248460712667,61.519200782909714,82.03180497361403,98.16000053846155,99.99883212705952,-17.96819502638597
2023-04-04,104.839996,106.099998,104.599998,105.120003,105.120003,20377200,2744021796.7425656,1928409997,21.187834192192923,64.0,2.3818628596168168,61.885851097527215,79.46736077898287,98.73769303846153,100.37817811764769,-20.532639221017135
2023-04-05,106.120003,106.540001,104.101997,104.949997,104.949997,21864200,2737367450.0487947,1906545797,21.43755069433569,56.0,2.3801259202622873,61.37600592969424,64.59192340584084,99.30115434615385,100.7168313681923,-35.40807659415916
2023-04-06,105.769997,109.629997,104.815002,108.900002,108.900002,34684200,2761534799.0119815,1941229997,22.460416454672007,100.0,2.6667412421895023,67.97722295034733,92.19256517488023,100.00846203846153,101.3229921557336,-7.807434825119775
2023-04-10,107.389999,107.970001,105.599998,106.949997,106.949997,19741500,2764283570.339486,1921488497,23.410220374984302,72.0,2.7053512380904294,62.31505706209593,71.33689226457581,100.57153892307693,101.73980732938297,-28.66310773542419
2023-04-11,106.919998,107.220001,105.279999,106.120003,106.120003,18721300,2761774590.6208053,1902767197,24.123912597766246,72.0,2.638560673761063,60.02332860544282,62.45994918929388,101.03692376923078,102.06426626794719,-37.54005081070612
2023-04-12,107.389999,107.586998,104.970001,105.220001,105.220001,22761600,2743361791.9377346,1880005597,24.886440337510777,72.0,2.48436778519806,57.5517092263826,52.834257290750145,101.40769296153846,102.29802439624738,-47.165742709249855
2023-04-13,106.470001,108.264999,106.440002,108.190002,108.190002,21650700,2763233050.603968,1901656297,25.78112725009711,72.0,2.572172664127919,62.9705520896213,84.5989806628836,101.94692388461539,102.73446718171054,-15.401019337116395
2023-04-14,107.690002,109.580002,107.589996,109.459999,109.459999,20758700,2781488133.7544713,1922414997,26.957195659872855,72.0,2.7129634534418585,65.02651843202729,98.18183918328104,102.51653915384615,103.23265472380606,-1.8181608167189636
2023-04-17,105.43,106.709999,105.32,106.419998,106.419998,29043400,2798412654.4698105,1893371597,26.773565835425014,72.0,2.5498454626941935,56.884723986473574,65.66845254940165,103.04576969230769,103.46875422574635,-34.33154745059835
2023-04-18,107.0,107.050003,104.779999,105.120003,105.120003,17641400,2786055955.788046,1875730197,26.326177471003422,72.0,2.2892850942999416,53.78351217467057,51.71310565871756,103.58846203846154,103.59106894976514,-48.28689434128244
2023-04-19,104.214996,105.724998,103.800003,105.019997,105.019997,16732000,2790532259.8179264,1858998197,25.41658004801317,68.0,2.0510759498964717,53.54168956463779,50.64237714876966,104.10230792307692,103.69691547200476,-49.35762285123034
2023-04-20,104.650002,106.888,104.639999,105.900002,105.900002,22515300,2793256579.8589315,1881513497,24.993839853412204,64.0,1.9112705980145819,55.440291219962184,54.45668770249549,104.55038492307693,103.86010706667108,-45.54331229750451
2023-04-21,106.089996,106.639999,105.485001,105.910004,105.910004,22379000,2787347118.5715528,1903892497,24.60129538699702,60.0,1.7807535092408528,55.462569517245186,48.6897517241379,104.91038496153845,104.0119512839547,-51.3102482758621
2023-04-24,106.050003,107.32,105.360001,106.779999,106.779999,21410900,2796960147.8472314,1925303397,24.49151179659032,28.000000000000004,1.7276043541133959,57.455085861012314,51.11490680779432,105.13000030769231,104.21699185551361,-48.88509319220568
2023-04-25,106.610001,107.440002,104.559998,104.610001,104.610001,31408100,2766642670.793797,1893895297,23.92243256956081,28.0,1.4931702256902923,51.291297978834095,13.893633509742775,105.21269269230768,104.24610364399409,-86.10636649025723
2023-04-26,105.559998,107.019997,103.269997,104.449997,104.449997,37068200,2752902724.6604633,1856827097,22.69080477321118,28.0,1.2797167264905482,50.85805142888312,18.55345911949674,105.30961565384617,104.26120685555009,-81.44654088050326
2023-04-27,105.230003,109.150002,104.419998,108.370003,108.370003,38235200,2778527610.6882973,1895062297,22.4177655935649,28.0,1.4106044439096763,59.81391884731577,80.82411979071335,105.40692361538461,104.56556212550933,-19.175880209286653
2023-04-28,107.800003,108.290001,106.040001,108.220001,108.220001,23957900,2800994796.910519,1871104397,22.164229212464786,28.0,1.4851105650339491,59.36805413835752,78.44691089785192,105.56076976923076,104.83626130139753,-21.553089102148082
2023-05-01,107.720001,108.68,107.5,107.709999,107.709999,20926300,2787516805.5100102,1850178097,22.08519355417883,28.0,1.4858760495041423,57.7907385374202,70.3644767317934,105.61653888461538,105.04913076055327,-29.6355232682066
2023-05-02,107.660004,107.730003,104.5,105.980003,105.980003,20343100,2785816319.172784,1829834997,20.58346159024287,28.0,1.3315373487385642,52.678006635788094,42.947763115877045,105.61346215384616,105.11808425977155,-57.052236884122955
2023-05-03,106.220001,108.129997,105.620003,106.120003,106.120003,17116300,2775519278.5016904,1846951297,19.221973080269418,28.000000000000004,1.206610590603276,53.04007434663466,45.16646183323148,105.73115465384616,105.19230046275143,-54.83353816676852
2023-05-04,106.160004,106.300003,104.699997,105.209999,105.209999,19780600,2768348813.1651855,1827170697,18.172061610400775,20.0,1.0223900411741766,50.34374915270543,32.99320323707197,105.87923149999999,105.19361146551059,-67.00679676292803
2023-05-05,105.32,106.440002,104.738998,106.214996,106.214996,20705300,2783576387.3846464,1847875997,17.124986674023543,20.0,0.9465772341721816,53.17483850779802,50.08497441753871,106.0451928076923,105.26926957917647,-49.91502558246129
2023-05-08,105.794998,108.419998,105.790001,108.239998,108.239998,17266000,2798478977.8446355,1865141997,16.599579170506185,16.0,1.0379311519435674,58.330066029896656,84.52375465667119,106.31134657692307,105.48932353627451,-15.47624534332881
2023-05-09,108.779999,110.595001,107.724998,107.940002,107.940002,24782400,2777409685.55191,1840359597,16.961095278471383,100.0,1.0737451541639729,57.32319548397646,63.75429965635524,106.46288511538461,105.67085527432825,-36.24570034364476
2023-05-10,108.550003,113.510002,108.480003,112.279999,112.279999,47533500,2801696124.230228,1887893097,18.19106559092159,40.0,1.4357787324943274,66.3678904716702,87.9882578182335,106.74634646153847,106.16042147622986,-12.011742181766483
2023-05-11,115.860001,118.440002,114.93,116.900002,116.900002,57115100,2808693159.340236,1945008197,20.39313157999033,43.99999999999999,2.071608370986823,72.94197930780047,89.84838831628595,107.19942334615385,106.95594595947209,-10.151611683714052
2023-05-12,117.0,118.260002,116.550003,117.919998,117.919998,31272500,2827529657.810411,1976280697,22.437907141268454,44.0,2.6275246248372355,74.14366084831082,96.57215670001426,107.69826953846153,107.76809796247416,-3.4278432999857285
2023-05-15,116.489998,118.794998,116.480003,116.959999,116.959999,22107900,2814589556.072092,1954172797,24.437101315514006,52.0,2.9565471299925434,70.94990171920483,88.18036146986393,108.00826942307692,108.4489795208094,-11.81963853013607
2023-05-16,116.830002,121.199997,116.830002,120.089996,120.089996,32370100,2830515315.3485446,1986542897,26.710749813860073,56.0,3.430321820584396,74.76640076834768,93.384975767877,108.513654,109.31127703778648,-6.6150242321230035
2023-05-17,120.18,122.279999,119.459999,121.480003,121.480003,26659600,2842048976.794218,2013202497,28.99040732255876,60.0,3.873304580215219,76.25813072525531,95.50058467382362,109.10442323076921,110.21266414609859,-4.49941532617638
2023-05-18,121.559998,123.900002,121.489998,123.519997,123.519997,27014500,2860544283.4049125,2040216997,31.343995318685632,64.0,4.338965185849474,78.28688619994622,98.04121154214316,109.80826923076924,111.19839250564684,-1.9587884578568446
2023-05-19,124.199997,126.478996,122.720001,123.25,123.25,30251300,2838823539.4438004,2009965697,33.85777083681851,68.0,4.632813874755499,77.3448642788602,85.30871928817861,110.38749992307693,112.09110417189522,-14.691280711821394
2023-05-22,123.510002,127.050003,123.449997,125.870003,125.870003,29760200,2849074307.5150757,2039725897,36.25889070380673,72.0,5.019244695126261,79.87547405569958,94.72035935918763,111.01865392307693,113.11176334434744,-5.279640640812385
2023-05-23,124.93,125.419998,123.050003,123.290001,123.290001,24477900,2829553926.028153,2015247997,38.241144055994404,72.0,5.058992389774275,71.41576297559789,83.17672934852904,111.66750019230768,113.86570687439578,-16.82327065147096
2023-05-24,121.879997,122.75,120.75,121.639999,121.639999,23087900,2827014233.940253,1992160097,38.752014935942675,72.0,4.900857319885688,66.5605519738385,75.75185878000566,112.30288465384615,114.44158036518128,-24.248141219994345
2023-05-25,125.209999,125.980003,122.900002,124.349998,124.349998,33812700,2825038068.895404,2025972797,39.79788853139405,72.0,4.9372943526523585,70.15000027841589,87.30007174975805,113.04634623076923,115.1755372270197,-12.699928250241953
2023-05-26,124.065002,126.0,123.290001,125.43,125.43,25154700,2839611083.0719037,2051127497,40.772305705743385,72.0,4.995730428436474,71.46459752348466,91.61706297100572,113.7975,115.93512706205527,-8.382937028994283
2023-05-30,126.290001,126.379997,122.889999,124.639999,124.639999,27230700,2839689123.6499786,2023896797,41.45145238052046,72.0,4.921562255008794,69.06843769165877,87.02205708131395,114.51788442307692,116.57993239079191,-12.977942918686052
2023-05-31,123.699997,124.900002,123.099998,123.370003,123.370003,41548800,2810605166.7769938,1982347997,42.08208857852774,72.0,4.706056885457102,65.27914061161388,69.63697121197076,115.1559615,117.08290058406658,-30.36302878802924
2023-06-01,123.5,125.040001,123.300003,124.370003,124.370003,25017700,2816356397.5458794,2007365697,42.697115418377855,72.0,4.5633554490794666,66.8226288490659,74.64522232734149,115.91596157692308,117.62268594820979,-25.354777672658514
2023-06-02,124.489998,126.745003,124.349998,125.230003,125.230003,19362400,2811222785.220227,2026728097,43.613540332301284,68.0,4.468152267312618,68.13457412451434,82.78145695364232,116.71519257692307,118.18619091500906,-17.218543046357674
2023-06-05,124.610001,127.989998,124.379997,126.629997,126.629997,22672500,2816812396.5049605,2049400597,44.6919034253011,92.0,4.45432419877946,70.20041279770786,87.81360674322826,117.41750003846154,118.8116580324158,-12.186393256771742
2023-06-06,126.599998,128.880005,125.970001,127.910004,127.910004,19450100,2823295767.627543,2068850697,45.8472830098027,96.0,4.494837533133506,71.98848142575036,89.70275602796846,118.17480784615385,119.48560958557019,-10.297243972031536
2023-06-07,127.574997,129.550003,122.629997,122.940002,122.940002,34179300,2792178821.5898085,2034671397,44.91736447917051,100.0,4.0788881337455365,57.54929176609528,24.886377879643973,118.7605771923077,119.74149050515759,-75.11362212035604
2023-06-08,122.584999,123.730003,122.010002,122.669998,122.669998,24815000,2786407764.8665857,2009856397,43.73441633505012,92.0,3.6849800158917674,56.88179157675352,21.818151652902912,119.40250007692308,119.95841698625702,-78.18184834709709
2023-06-09,122.559998,124.285004,122.419998,122.870003,122.870003,20304500,2775901760.4451523,2030160897,42.79684812169938,92.0,3.3503232851984563,57.277092247709334,24.0909349689994,120.04673084615385,120.17409002431205,-75.90906503100061
2023-06-12,123.394997,124.75,122.349998,124.349998,124.349998,22255700,2790738862.867817,2052416597,42.06296888136756,88.0,3.168009797786908,60.185855100987055,40.90905423554967,120.78288465384617,120.48341654102968,-59.09094576445033
2023-06-13,125.650002,125.860001,123.845001,124.43,124.43,19287700,2782650453.4011173,2071704297,41.700655475724304,84.0,2.995450845566637,60.34303329126288,41.81816756198839,121.48346173076924,120.77575605650895,-58.18183243801161
2023-06-14,123.800003,124.790001,122.160004,124.379997,124.379997,24659600,2799621425.133937,2047044697,40.408470506112806,80.0,2.8221300500029685,60.18311084503151,31.432290260969484,122.10423092307693,121.04273686713792,-68.56770973903052
2023-06-15,123.879997,126.160004,123.139999,125.790001,125.790001,24517100,2818130985.0462217,2071561797,39.63847489178084,76.0,2.7666553292621785,63.14890908304868,50.13260608320876,122.79076934615385,121.39438606216473,-49.86739391679124
2023-06-16,126.699997,126.699997,123.790001,124.059998,124.059998,56686800,2771963282.625462,2014874997,39.086139859044366,72.0,2.5536574559836254,57.49065164564432,27.18827225619721,123.24384623076922,121.59183879830067,-72.81172774380279
2023-06-20,123.535004,125.175003,122.830002,123.849998,123.849998,22698000,2769011004.8729153,1992176997,38.02357562360891,64.0,2.34092513411602,56.82505089086152,24.403126736985822,123.51115376923077,121.75910985027839,-75.59687326301417
2023-06-21,123.235001,123.410004,120.860001,121.260002,121.260002,22612000,2753492975.0462837,1969564997,36.02365566792146,64.0,1.9409679345431954,49.25148533448222,4.603002392864845,123.63961546153847,121.72213889840592,-95.39699760713516
2023-06-22,120.660004,123.934998,119.599998,123.870003,123.870003,20781900,2773651705.685038,1990346897,33.59345573919449,60.0,1.813697069526981,55.66419293563563,42.91460155045144,123.90538484615385,121.88123994296843,-57.08539844954856
2023-06-23,122.040001,123.440002,121.860001,123.019997,123.019997,29542900,2787488076.746765,1960803997,31.3368415196623,56.00000000000001,1.6255077699327671,53.301936239571575,34.37183197395381,124.01807719230769,121.96559231756336,-65.6281680260462
2023-06-26,121.466003,122.720001,118.989998,119.089996,119.089996,23185000,2765546214.422526,1937618997,30.132463519111724,-48.0,1.146037352644612,44.00378582910731,0.9469503092091276,123.92615384615387,121.75258518292904,-99.05304969079087
2023-06-27,117.839996,119.894997,116.910004,119.010002,119.010002,27221700,2776626457.2120733,1910397297,29.698053590765404,-52.0,0.7509423493260243,43.8361620830655,16.61390954223967,123.7526925,121.54943087308244,-83.38609045776033
2023-06-28,117.959999,121.269997,117.599998,121.080002,121.080002,19753100,2794334330.3689594,1930150397,28.640566890509167,-52.0,0.5979654396111727,49.22609860148147,42.594494194224595,123.66923103846153,121.51465836396522,-57.405505805775405
2023-06-29,120.089996,120.910004,119.209999,120.010002,120.010002,18517500,2793245079.7594023,1911632897,27.658614954556946,-52.0,0.38594118909826136,46.72967789643073,31.66496646116091,123.44384638461537,121.40320233700484,-68.3350335388391
2023-06-30,121.099998,122.029999,120.879997,120.970001,120.970001,23865800,2773114955.8072696,1935498697,26.211807952948863,-52.0,0.29200824993175445,49.217984972866375,41.470887670706176,123.35461561538462,121.37111334907856,-58.529112329293824
2023-07-03,120.32,121.019997,119.705002,120.559998,120.559998,13888300,2777286710.7075543,1921610397,25.322067670849425,-52.0,0.18237954545735136,48.18281478432458,37.28290714814601,123.31307711538463,121.31103073062829,-62.717092851853984
2023-07-05,120.059998,123.370003,120.059998,122.629997,122.629997,17830300,2787144497.686094,1939440697,23.57682830875458,-52.0,0.25953783630552607,53.50029529216447,58.42693656675755,123.24692323076923,121.40873193576694,-41.573063433242446
2023-07-06,120.639999,121.150002,119.25,120.93,120.93,17732500,2800770490.9929433,1921708197,22.1579399041652,-52.0,0.18141949624292408,49.04863780584717,41.062296980191995,123.0738463076923,121.37327031089531,-58.937703019808005
2023-07-07,120.889999,121.75,120.089996,120.139999,120.139999,20982400,2781052163.786985,1900725797,20.580352611737474,-52.0,0.05512818711989098,47.08781534069469,32.992822364632985,122.90076938461539,121.28191688045862,-67.00717763536701
2023-07-10,119.07,119.07,116.639999,116.870003,116.870003,32960100,2754331530.2237477,1867765697,20.38995501024069,-84.0,-0.30530061845649925,39.96578339312182,2.6948317774659962,122.65076938461539,120.9551084448691,-97.30516822253401
2023-07-11,116.760002,118.224998,115.830002,117.709999,117.709999,18286600,2764753749.0611906,1886052297,20.466430850106097,-88.0,-0.5172004220453346,42.37683850694208,23.195532730676277,122.39461538461539,120.71472996747138,-76.80446726932372
2023-07-12,119.300003,120.959999,119.0,119.620003,119.620003,22059600,2756650297.18045,1908111897,19.359683311676843,-88.0,-0.5249597733238289,47.53634945991057,46.761293898232694,122.17884615384615,120.63363908099203,-53.238706101767306
2023-07-13,121.540001,125.334999,121.059998,124.830002,124.830002,31535900,2780735656.283594,1939647797,19.042840712439645,-88.0,-0.10944413374630813,58.46195577687965,94.68703672394633,122.10961557692306,120.94448077869632,-5.312963276053668
2023-07-14,125.129997,127.089996,124.900002,125.699997,125.699997,20482800,2775217406.4933205,1960130597,19.208540052226088,-88.0,0.286750844654847,59.96139803372062,87.6554197098151,122.02461530769232,121.29674123953363,-12.3445802901849
2023-07-17,126.059998,127.279999,124.5,125.059998,125.059998,20675300,2762871697.0071297,1939455297,19.204305382195553,16.0,0.5428381485913008,58.29431539049394,80.61133989816759,122.10615361538461,121.57550099956818,-19.388660101832414
2023-07-18,124.904999,124.989998,123.300003,124.080002,124.080002,21071200,2761250868.077813,1918384097,18.726815797871172,16.0,0.6591138408652739,55.738832719529796,72.0524206250883,122.16038453846153,121.76101959219275,-27.947579374911694
2023-07-19,124.790001,125.470001,122.470001,122.779999,122.779999,22313800,2743548556.9927464,1896070297,17.96357596016278,16.0,0.6389978181070859,52.45388025569488,60.69867965904274,122.15692284615385,121.83649954832663,-39.30132034095726
2023-07-20,122.120003,124.699997,118.684998,119.529999,119.529999,27541700,2723745100.6871176,1868528597,17.367784550592717,16.0,0.3566961157397799,45.27076631110572,32.314392746129165,121.97153826923076,121.66564765585798,-67.68560725387083
2023-07-21,120.870003,121.300003,119.07,120.309998,120.309998,56498100,2730078782.5311775,1925026697,16.81454967027766,16.0,0.19367679775125168,47.14163883742995,39.12661287160159,121.81307665384617,121.56522916283147,-60.87338712839841
2023-07-24,121.926003,123.349998,121.379997,121.879997,121.879997,22276100,2719110341.765868,1947302797,15.655427258981595,16.0,0.18899005234428046,50.788204624252685,52.838398123597806,121.71692280769231,121.58854529891802,-47.1616018764022
2023-07-25,121.879997,123.690002,121.529999,122.790001,122.790001,31820800,2724413815.7984505,1979123597,14.69528817046878,16.0,0.2557572797052643,52.81989655906384,60.78603339372058,121.6015381923077,121.67754201751669,-39.21396660627942
2023-07-26,130.360001,131.369995,128.710007,129.660004,129.660004,46216900,2711209031.905215,2025340497,15.792324833908136,43.99999999999999,0.8531875999487113,64.67630357274359,88.9961919545266,121.81692303846154,122.26883549770062,-11.003808045473397
2023-07-27,131.800003,133.600006,129.179993,129.869995,129.869995,35931600,2686495894.775437,2061272097,17.219436964463775,48.0,1.3282882713650963,64.9661119844149,79.00950950827014,122.04846138461538,122.8318843497228,-20.99049049172986
2023-07-28,130.970001,134.070007,130.919998,133.009995,133.009995,26971000,2695314830.0340347,2088243097,18.628187462507388,52.0,1.9358652843395845,69.05453234873315,94.18853229481023,122.50038419230768,123.58581847196557,-5.811467705189773
2023-07-31,133.009995,133.830002,132.130005,133.110001,133.110001,18381900,2698126130.342506,2106624997,19.93631292497646,52.0,2.3978037043698635,69.17790261042268,93.76012064731329,122.85576873076921,124.2913134740422,-6.23987935268671
2023-08-01,130.854996,132.919998,130.75,131.889999,131.889999,22154300,2699249160.409815,2084470697,20.579653410371314,52.0,2.635073774714158,65.73496584369471,85.83031053150496,123.19692265384614,124.85417906855758,-14.169689468495037
2023-08-02,129.839996,130.419998,127.849998,128.639999,128.639999,22705800,2690502585.8617992,2061764897,20.101702084450313,52.0,2.5316805389472563,57.52194839092026,64.70585100080207,123.56423046153844,125.13461017459036,-35.29414899919793
2023-08-03,128.369995,129.770004,127.775002,128.770004,128.770004,15018100,2690464961.6068864,2076782997,19.63152432487446,52.0,2.4321941515065646,57.749353928699904,65.55086188119877,123.93961515384613,125.40389860610219,-34.44913811880123
2023-08-04,129.600006,131.929993,128.315002,128.539993,128.539993,20509500,2672508415.633328,2056273497,19.75918970061677,52.0,2.3081832080529523,57.1662454561131,64.05582863162452,124.2265378846154,125.63620189453907,-35.94417136837548
2023-08-07,129.509995,132.059998,129.429993,131.940002,131.940002,17621000,2688521472.290254,2073894497,19.910773586398744,52.0,2.455945344001833,63.09782465930087,86.15532171609382,124.68538403846154,126.10315005049912,-13.84467828390617
2023-08-08,130.979996,131.940002,130.130005,131.839996,131.839996,16836000,2703497026.09504,2057058497,20.05153005176772,52.0,2.5357477314944816,62.822256904214825,85.50529934691629,125.10346076923078,126.52810160231401,-14.494700653083719
2023-08-09,132.190002,132.470001,129.505005,130.149994,130.149994,17745200,2693472213.4431505,2039313297,19.905607548203715,52.0,2.434558585154022,58.19675735041389,73.86659219559026,125.47230676923076,126.79638992806854,-26.13340780440975
2023-08-10,131.970001,132.647003,130.035004,130.210007,130.210007,17855700,2678009164.487121,2057168997,19.826318474982525,52.0,2.332322443888401,58.314132660646976,69.58237227551426,125.76384561538461,127.04925045191531,-30.417627724485744
2023-08-11,129.201996,130.440002,128.75,130.169998,130.169998,15191500,2688346509.5618606,2041977497,19.16040159447214,52.0,2.222452128721457,58.196815095015964,68.8994696016142,126.11923015384615,127.28041693695862,-31.1005303983858
2023-08-14,129.850006,131.910004,129.589996,131.830002,131.830002,17526200,2704663980.0640316,2059503697,19.04823900856891,52.00000000000001,2.2434662791892777,61.6446851940891,64.41615217144394,126.56884565384615,127.61742323792464,-35.58384782855606
2023-08-15,131.589996,131.990005,129.819,130.270004,130.270004,14769200,2696031079.4063177,2044734497,18.971279775643065,52.0,2.1099195050066157,56.89550073076717,39.63463094945911,127.08423030769231,127.81391070178208,-60.36536905054089
2023-08-16,129.279999,130.897995,128.460007,129.110001,129.110001,17548400,2687839866.324055,2027186097,18.24320918905982,24.0,1.888708322897628,53.58935721851147,21.207274656652533,127.52269192307692,127.90991739053896,-78.79272534334747
2023-08-17,130.449997,132.490997,129.850006,130.460007,130.460007,23665600,2675106556.2603707,2050851697,18.150678661429144,24.0,1.8015637634345012,56.73994858353524,44.343600330305314,127.93961515384616,128.0988129171657,-55.656399669694686
2023-08-18,129.059998,129.830002,127.0,128.110001,128.110001,23619400,2670015452.4378295,2027232297,16.872906689179814,24.0,1.525292604157869,50.33438668856677,18.75002322635941,128.06576896153848,128.0996416640423,-81.2499767736406
2023-08-21,127.849998,129.259995,127.160004,128.929993,128.929993,21851100,2684998992.8128595,2049083397,15.686404143519722,24.0,1.3568710565290587,52.35557023926046,34.17729723182353,128.18999957692307,128.16114917040954,-65.82270276817647
2023-08-22,129.130005,130.949997,128.925003,129.690002,129.690002,15569400,2681193158.9573517,2064652797,15.205401715942974,24.0,1.2700814330987669,54.21535879369866,47.6359229842801,128.36807665384615,128.27439752815698,-52.3640770157199
2023-08-23,130.850006,134.070007,130.509995,133.210007,133.210007,26497000,2694888280.7614355,2091149797,15.763458589408602,24.000000000000004,1.4684081220567862,61.67679583230058,87.8359384934129,128.7192306923077,128.639998229775,-12.164061506587096
2023-08-24,134.727005,134.970001,130.300003,130.419998,130.419998,18680400,2677167861.728451,2072469397,16.5334609166285,100.0,1.384493463866562,54.14485551773911,42.9108854566015,129.0130768076923,128.77185006460647,-57.0891145433985
2023-08-25,130.139999,131.399994,128.039993,130.690002,130.690002,20678100,2689107103.8678727,2093147497,16.25243928899006,96.0,1.3245094386307414,54.72113069987355,46.298639109330026,129.44230769230768,128.91393539315413,-53.701360890669974
2023-08-28,132.080002,133.240005,130.850006,131.789993,131.789993,16715500,2685540021.669303,2109862997,16.541519345443508,92.0,1.3501678526068588,57.087225091846776,60.10028104137016,129.88384596153844,129.12697669736494,-39.89971895862984
2023-08-29,132.998001,137.294998,132.979996,135.490005,135.490005,30803300,2690572885.9305015,2140666297,17.794467190697347,100.0,1.6500417227863693,63.91741554844351,82.46728168378472,130.4073078076923,129.59831212718976,-17.532718316215288
2023-08-30,135.570007,137.25,135.020996,136.929993,136.929993,21773400,2706094488.792587,2162439697,18.957918761290195,28.0,1.9810525814992275,66.17393030726971,96.45454035056639,130.95115365384615,130.14139959924978,-3.5454596494336057
2023-08-31,137.050003,138.399994,136.820007,137.350006,137.350006,28147900,2696830742.715499,2190587597,20.291668567601327,36.0,2.251320786114775,66.82560682515805,90.78957409977598,131.24692296153847,130.67537044374978,-9.210425900224031
2023-09-01,138.429993,138.580002,135.940002,136.800003,136.800003,16665700,2691023011.401635,2173921897,21.112654030151504,40.0,2.3935384189489923,65.05806902263117,84.62868141128125,131.51346173076925,131.12904692939796,-15.371318588718745
2023-09-05,136.440002,137.369995,135.559998,136.710007,136.710007,17730200,2695823113.464898,2156191697,21.69269200294874,39.99999999999999,2.4705065310675423,64.75624743059879,83.85151401528242,131.65576988461538,131.5424513790722,-16.148485984717585
2023-09-06,137.014999,137.479996,134.690002,135.369995,135.369995,15814300,2687717513.4118514,2140377397,21.810608132125555,40.0,2.3957597182707957,60.272525317120824,72.27973708467394,131.74269273076922,131.82597312877053,-27.720262915326064
2023-09-07,134.600006,136.580002,133.960007,136.199997,136.199997,16976000,2699769103.342366,2157353397,21.571631322183368,40.0,2.376106281256,62.02638209567665,79.44728334243803,131.9084618846154,132.14997489700974,-20.552716657561973
2023-09-08,135.869995,137.514999,135.869995,137.199997,137.199997,17810700,2710758657.4711103,2175164097,21.651024050030163,40.0,2.4134022348055737,64.08369505064826,87.91589105357102,132.23769257692308,132.52405060834235,-12.084108946428978
2023-09-11,137.380005,138.264008,136.550003,137.740005,137.740005,17180800,2717434481.415148,2192344897,21.96069963226083,40.0,2.458197113115858,65.18073602425451,92.03039579947217,132.58269261538462,132.910417600317,-7.9696042005278285
2023-09-12,137.130005,137.639999,135.929993,136.070007,136.070007,15212900,2704712822.9436574,2177131997,21.918084342899565,40.0,2.3320599595057843,59.162387548276065,76.18602602711246,132.87230853846154,133.14446125955277,-23.81397397288754
2023-09-13,135.899994,137.699997,134.929993,137.5,137.5,16394900,2718740267.289947,2193526897,21.35916212483292,40.0,2.3207318880505454,62.366687486089674,89.75331045732496,133.08615461538463,133.46709375884515,-10.246689542675037
2023-09-14,138.389999,139.550003,137.059998,138.990005,138.990005,19064600,2729229673.368007,2212591497,21.49447756335091,72.0,2.4042703290693623,65.41203157112216,95.13468711147944,133.36115496153846,133.876198295227,-4.86531288852058
2023-09-15,138.800003,139.360001,137.179993,138.300003,138.300003,48947600,2730577119.5109572,2163643897,21.62012761340333,72.0,2.3872786879408636,62.87464422168101,85.63217895362492,133.67461684615384,134.20388753261759,-14.367821046375079
2023-09-18,137.630005,139.929993,137.630005,138.960007,138.960007,16233600,2733118157.002283,2179877497,21.93800911269335,80.0,2.3994105851998313,64.30112070529964,86.04336088202619,134.0111553076923,134.55619267834962,-13.956639117973811
2023-09-19,138.25,139.175003,137.5,138.830002,138.830002,15479100,2742220784.865696,2164398397,22.152725667482198,80.0,2.3712011533064583,63.78126205842715,81.57464690871993,134.3442323846154,134.87277114662,-18.425353091280073
2023-09-20,138.830002,138.839996,134.520004,134.589996,134.589996,21473500,2721443107.085737,2142924897,20.7393888776256,80.0,1.9838434143209724,49.67541090440596,10.552604310965263,134.450386,134.85182483946298,-89.44739568903474
2023-09-21,132.389999,133.190002,131.089996,131.360001,131.360001,22042700,2705068618.7132277,2120882197,20.427087305725628,80.0,1.4000866853229752,42.04659578080628,3.0543562401661237,134.49230896153847,134.593171221725,-96.94564375983387
2023-09-22,131.679993,133.009995,130.509995,131.25,131.25,17348700,2697990418.5080276,2103533497,20.32975038058351,80.0,0.9179970123436476,41.8110980849248,7.855681073392978,134.57461661538463,134.34552890900463,-92.14431892660703
2023-09-25,130.770004,132.220001,130.029999,132.169998,132.169998,14650000,2711971429.210301,2118183497,20.400889448591556,80.0,0.6032200775325975,44.6055522640372,21.616164615857247,134.64038549999998,134.18437847130056,-78.38383538414276
2023-09-26,130.914001,131.404999,128.190002,129.449997,129.449997,20378800,2707566010.2778416,2097804697,21.048092243050224,76.0,0.1327455322813762,38.68967947282659,10.732503968699833,134.69192380769232,133.83368354750053,-89.26749603130018
2023-09-27,129.440002,131.720001,129.380005,131.460007,131.460007,18764200,2722160477.1545367,2116568897,21.47605610166193,60.0,-0.07702997220067687,44.54297329450885,27.85355627615044,134.78923203846153,133.65785565509307,-72.14644372384956
2023-09-28,130.690002,134.179993,130.690002,133.130005,133.130005,18201400,2729409842.27353,2134770297,20.639749575952568,60.0,-0.10728695181256853,48.90739957461154,42.07842237698493,134.92153984615385,133.61875560656767,-57.92157762301507
2023-09-29,134.080002,134.889999,131.320007,131.850006,131.850006,23224200,2713081345.5556664,2111546097,19.545284376048794,60.0,-0.23187810163028644,45.92414688542149,31.175526454833005,134.86923211538462,133.4877371171923,-68.824473545167
2023-10-02,132.154999,135.360001,132.065002,135.169998,135.169998,19210400,2730076246.472844,2130756497,18.317667955692624,60.0,-0.0620070981925096,53.7964669866791,59.45486670304941,135.05192442307694,133.6123490344373,-40.54513329695059
2023-10-03,134.929993,135.240005,132.815002,133.300003,133.300003,19628700,2718299032.9482837,2111127797,17.17773842250475,-23.999999999999993,-0.07738403740006561,49.43140503682001,43.52644733714029,135.15230907692307,133.58921229114566,-56.47355266285971
2023-10-04,133.660004,136.570007,133.429993,136.270004,136.270004,22848000,2736781148.8827987,2133975797,16.399448653345452,-24.0,0.14837352917407998,55.59419339599995,68.82460131357857,135.3246171923077,133.7877894547645,-31.17539868642144
2023-10-05,136.130005,136.5,134.455002,135.990005,135.990005,15922900,2744762134.6261587,2118052897,15.676751010554677,-24.0,0.30122214652789125,54.91472424819291,66.43959948521257,135.34384796153847,133.95091653218935,-33.56040051478743
2023-10-06,134.940002,139.186005,134.940002,138.729996,138.729996,20819300,2761109563.940387,2138872197,16.110705768942196,-24.0,0.6361173863745933,60.05912950739007,95.8529567516488,135.41307884615387,134.30492241869385,-4.147043248351192
2023-10-09,137.990005,139.970001,136.699997,139.5,139.5,16599100,2772937052.8970366,2155471297,16.78936879255786,36.0,0.9526753163242745,61.392351064029114,96.01017792955673,135.49577092307692,134.6897429802721,-3.9898220704432674
2023-10-10,139.509995,140.740005,138.429993,139.199997,139.199997,19554900,2766418752.8970366,2135916397,17.683037805601693,40.0,1.1659022264977068,60.544389811769776,87.72902285362004,135.58807838461536,135.0238358706223,-12.270977146379963
2023-10-11,139.850006,142.220001,139.839996,141.699997,141.699997,20146300,2777761578.462991,2156062697,18.982962433544166,43.99999999999999,1.5191039113743443,64.89570989861738,96.2936276759535,135.78000107692307,135.51836632465026,-3.706372324046495
2023-10-12,142.160004,142.380005,139.449997,140.289993,140.289993,18173100,2770008471.382874,2137889597,19.940236106693128,48.0,1.666038201105323,60.82157900837231,85.2712363767647,135.96923176923076,135.87182015245395,-14.728763623235308
2023-10-13,140.649994,141.339996,137.970001,138.580002,138.580002,19438700,2757606948.849725,2118450897,19.929189203681194,48.0,1.625761930084252,56.21254020489946,73.22056239170632,136.06077042307692,136.07242621523514,-26.779437608293662
2023-10-16,139.729996,140.904999,139.320007,140.490005,140.490005,17345600,2765869449.4695387,2135796497,19.918931365170113,48.0,1.7280441572890197,59.87051854589907,85.46153846153835,136.1873091923077,136.39965427336585,-14.538461538461652
2023-10-17,140.029999,141.25,138.529007,140.990005,140.990005,17424000,2779963670.3190594,2153220497,19.43278363011287,48.0,1.8283730343606805,60.79386782852008,88.10949834657859,136.31230919230768,136.73968025311652,-11.890501653421412
2023-10-18,140.75,141.990005,138.705002,139.279999,139.279999,18304900,2768066839.1003056,2134915597,19.311163220952633,48.0,1.7497313849511613,56.04437927911622,71.97100758969391,136.43577042307692,136.92785201214494,-28.028992410306092
2023-10-19,139.800003,141.005005,138.600006,138.979996,138.979996,21831200,2753134301.1687717,2113084397,19.1304975700996,48.0,1.6442457350154882,55.22917162969016,67.03821608195358,136.49269334615386,137.079862677912,-32.961783918046414
2023-10-20,138.589996,139.039993,136.244995,136.740005,136.740005,24953900,2737019355.643158,2088130497,17.923903896571332,48.0,1.3641736989118556,49.44592101592388,41.035042017237174,136.40615488461538,137.0546880351037,-58.964957982762826
2023-10-23,136.229996,139.020004,135.110001,137.899994,137.899994,20780700,2745894902.72793,2108911197,17.347772538610645,48.0,1.221732637019727,52.2352714421614,49.94407828726921,136.39076992307693,137.11730329176268,-50.05592171273079
2023-10-24,139.160004,140.710007,138.75,140.119995,140.119995,26535200,2756454561.3932304,2135446397,16.276293960638593,48.0,1.2733047322663822,57.112383849506145,71.48253445456082,136.43538484615385,137.33972489978026,-28.51746554543918
2023-10-25,129.770004,130.100006,126.089996,126.669998,126.669998,58796100,2714666825.757509,2076650297,18.40136824012092,-36.0,0.22626539113750255,34.276885123819525,3.560476854248558,135.9676923846154,136.5493747590558,-96.43952314575145
2023-10-26,124.470001,125.459999,122.32,123.440002,123.440002,33907400,2704948195.126417,2042742897,20.882091835054414,-40.0,-0.8543065985348335,31.06462431352108,5.58325882770225,135.53884646153844,135.57831011023686,-94.41674117229775
2023-10-27,124.029999,124.440002,121.459999,123.400002,123.400002,37367700,2716233768.3634577,2005375197,23.290481887917775,-43.99999999999999,-1.6943637802036449,31.025847172197743,9.273434242800901,135.23269265384616,134.67621321318228,-90.7265657571991
2023-10-30,124.459999,126.550003,123.879997,125.75,125.75,24165600,2725918088.173975,2029540797,24.682777570861557,-44.0,-2.145755021907661,36.07450532951824,20.50669105926643,135.0211541923077,134.01501223442804,-79.49330894073357
2023-10-31,126.269997,126.559998,123.925003,125.300003,125.300003,21123400,2726840024.123379,2008417397,25.97164835928556,-44.0,-2.510853276554286,35.538078680995355,18.355654391303734,134.7569236153846,133.36945599484076,-81.64434560869627
2023-11-01,125.339996,127.739998,124.925003,127.57,127.57,26536600,2750171525.0544286,2034953997,26.68709884984387,-44.0,-2.58720282333951,40.35617826036484,29.761321063422958,134.68461603846154,132.9398666618896,-70.23867893657705
2023-11-02,129.559998,130.089996,128.110001,128.580002,128.580002,24091700,2737517352.0094967,2059045697,26.45826176945702,-44.0,-2.536967091352551,42.418411585922684,34.68095917750833,134.5738466153846,132.61691372397186,-65.31904082249166
2023-11-03,129.089996,130.729996,129.009995,130.369995,130.369995,19517900,2748864950.343509,2078563597,26.014143403977783,-44.0,-2.325905841603742,45.98305535243111,43.399870414066086,134.46769238461536,132.45047529997393,-56.60012958593391
2023-11-06,130.220001,131.559998,129.929993,131.449997,131.449997,15360400,2762152155.0338016,2093923997,25.29788893785647,-44.0,-2.047884408420458,48.07183848384063,48.66047287078241,134.45230742307692,132.37636579627215,-51.33952712921759
2023-11-07,131.979996,133.279999,131.139999,132.399994,132.399994,19223800,2765565637.165577,2113147797,24.026535194915258,-44.0,-1.7309403977108389,49.906789845864324,55.97335196520272,134.3457688076923,132.37811603358534,-44.02664803479729
2023-11-08,132.360001,133.539993,132.160004,133.259995,133.259995,15093600,2774534292.9626884,2128241397,22.75560002536437,-44.0,-1.3942925557279295,51.57500699963815,61.29865504471485,134.34423003846152,132.4434404014679,-38.70134495528516
2023-11-09,133.360001,133.960007,131.509995,131.690002,131.690002,17976500,2759199327.6453757,2110264897,21.781207849658156,-44.0,-1.2398893569581162,48.405772893935435,53.1428506419322,134.16807611538462,132.38763014950732,-46.8571493580678
2023-11-10,131.529999,134.270004,130.869995,134.059998,134.059998,20872900,2777493743.7428923,2131137797,21.081218426491898,-44.0,-0.9157288866175577,53.09173699507151,65.45451305786479,134.09384507692306,132.5115092495438,-34.54548694213522
2023-11-13,133.360001,134.110001,132.770004,133.639999,133.639999,16409900,2782392146.5980473,2114727897,20.431228247837513,-44.00000000000001,-0.684825545050245,52.18715734336253,95.08193010072978,133.89807596153844,132.5951010829109,-4.918069899270227
2023-11-14,135.649994,137.240005,135.100006,135.429993,135.429993,22317300,2766957484.276943,2137045197,19.33007392140563,-44.0,-0.35332254473340186,55.654949321650044,88.52971285308763,133.7415372307692,132.80509307676934,-11.470287146912368
2023-11-15,136.639999,136.839996,135.330002,136.380005,136.380005,15840900,2773147125.487968,2152886097,18.30757347543317,-44.0,-0.013787071040894716,57.42007473123404,94.5500654435747,133.63307600000002,133.069901367379,-5.449934556425297
2023-11-16,136.960007,138.880005,136.080002,138.699997,138.699997,17615100,2788497328.6855,2170501197,18.056383402343865,-44.0,0.4374584547414315,61.455042433405914,98.79994730669468,133.51769138461538,133.4869454883139,-1.20005269330533
2023-11-17,137.820007,138.0,135.479996,136.940002,136.940002,25565300,2792555387.530803,2144935897,17.564281147050185,-28.0,0.6456146535197149,57.039156067332605,87.02773159107556,133.38884557692307,133.74272745214247,-12.972268408924435
2023-11-20,135.5,138.425003,135.490005,137.919998,137.919998,19569400,2805390442.330568,2164505297,17.256542766157327,-28.0,0.8795188815822144,58.81379378764232,93.12069607729174,133.3634608076923,134.05215490013194,-6.879303922708274
2023-11-21,137.940002,138.964996,137.705002,138.619995,138.619995,17648100,2813374032.581949,2182153397,17.16393832500458,-28.0,1.108594389248509,60.08220481403422,96.82173045680791,133.29153734615383,134.3905134260481,-3.178269543192094
2023-11-22,139.100006,141.100006,139.0,140.020004,140.020004,17306400,2812879581.9055223,2199459797,17.781368424716984,-28.000000000000004,1.3871175774286542,62.56534579311586,91.06698910364922,133.25422961538462,134.8075127278223,-8.933010896350773
2023-11-24,139.539993,139.677002,137.470001,138.220001,138.220001,8828600,2810051386.980101,2190631197,17.60942645275543,72.0,1.4459361598783005,57.60384158858508,74.21663699048507,133.21346046153846,135.0602896368725,-25.783363009514925
2023-11-27,137.570007,139.630005,137.539993,138.050003,138.050003,17886400,2800894355.867935,2172744797,17.4497660502197,72.0,1.4619800958730025,57.142951415094146,70.18573098308498,133.17769149999998,135.28174988599307,-29.814269016915016
2023-11-28,137.630005,138.660004,137.039993,138.619995,138.619995,17046900,2817099249.9530373,2189791697,17.050366757389845,72.0,1.5033588366566448,58.34634784557036,75.75749429790433,133.2499988076923,135.52902730184542,-24.24250570209567
2023-11-29,138.985001,139.669998,136.294998,136.399994,136.399994,21014700,2797392081.473748,2168776997,17.07092348832702,72.0,1.3415516867104031,52.19862074950511,54.056628091602185,133.1923065,135.59354335356056,-45.943371908397815
2023-11-30,136.399994,136.960007,132.789993,133.919998,133.919998,29913500,2783690711.4893785,2138863497,16.19338723552291,72.0,1.0016569260777715,46.32628507666182,29.814269016915016,132.95384507692307,135.46957703107458,-70.18573098308498
2023-12-01,133.320007,133.5,132.151993,133.320007,133.320007,24258400,2801470892.6207824,2114605097,15.620939722128446,72.0,0.6760801885327794,45.00708351970558,13.053333740127545,133.20961465384613,135.31034962136536,-86.94666625987246
2023-12-04,131.294006,131.449997,129.399994,130.630005,130.630005,24117100,2806294529.086144,2090487997,16.02104223743351,72.0,0.19870702733905432,39.566958309285965,10.512903747449295,133.48615323076922,134.96365742719016,-89.48709625255071
2023-12-05,130.369995,133.539993,129.729996,132.389999,132.389999,19235100,2813917940.3685937,2109723097,15.491311638769023,68.0,-0.037169369919155315,44.309915137878015,25.55557207975507,133.83192234615382,134.77301606221312,-74.44442792024493
2023-12-06,132.899994,133.309998,131.309998,131.429993,131.429993,16360600,2799520530.5655937,2093362497,14.999418940009145,64.0,-0.29813090771500583,42.357154816812105,17.350401008135726,134.05038361538462,134.52538472427142,-82.64959899186427
2023-12-07,136.600006,140.0,136.229996,138.449997,138.449997,38419400,2806348353.867956,2131781897,15.47549195808605,60.0,0.060809869313516174,57.20819123941435,77.35037365773636,134.55615261538463,134.81609674469576,-22.649626342263648
2023-12-08,135.660004,137.990005,135.570007,136.639999,136.639999,22990900,2803688114.531973,2108790997,15.667634359098203,56.00000000000001,0.19695098101033182,53.388859216127585,61.880321148388454,134.90499873076922,134.95120061545904,-38.119678851611546
2023-12-11,133.820007,134.789993,132.889999,134.699997,134.699997,24502900,2825869783.003452,2084288097,14.903134540279243,52.0,0.14661179523423584,49.56899376032281,45.29912447953042,135.14038315384616,134.93259294023986,-54.70087552046958
2023-12-12,133.270004,134.539993,132.830002,133.639999,133.639999,26584000,2824470664.3835287,2057704097,14.1731029310595,-28.0,0.020943227515260787,47.566433620960204,36.239321805823714,135.26615253846154,134.83684524096282,-63.760678194176286
2023-12-13,134.544998,134.779999,132.949997,133.970001,133.970001,25414500,2827387162.555115,2083118597,13.573099944944042,-28.0,-0.05142877542715496,48.26714332914878,43.11324918117972,135.36307576923076,134.77263455644706,-56.88675081882028
2023-12-14,134.770004,135.035004,131.059998,133.199997,133.199997,29619100,2829659760.0171566,2053499497,12.85936218403201,-28.0,-0.16896922473614495,46.6989592831692,35.84906461373702,135.39384511538464,134.65614288559914,-64.15093538626297
2023-12-15,132.919998,134.830002,132.630005,133.839996,133.839996,58569400,2835516308.6665416,2112068897,12.19660569175655,-28.0,-0.2080796938558649,48.20522766930659,41.886787611252466,135.41615284615384,134.59568756073995,-58.113212388747534
2023-12-18,133.860001,138.380005,133.770004,137.190002,137.190002,25699800,2847948068.5514092,2137768697,12.26471655462247,-28.0,0.030886425139868834,55.322399986239716,73.49059991098113,135.62769130769232,134.78785900068513,-26.509400089018868
2023-12-19,138.0,138.770004,137.449997,138.100006,138.100006,20661000,2847635196.9310317,2158429697,12.44428929878338,-28.000000000000004,0.2903515220722568,57.048944550732244,82.07553844780851,135.78307623076924,135.0332032228566,-17.924461552191488
2023-12-20,140.330002,143.078003,139.410004,139.660004,139.660004,33507300,2818695414.5339537,2191936997,13.721246739975646,48.0,0.6147715778218696,59.909158698297986,75.01099026912463,136.01461488461538,135.3759292063487,-24.989009730875363
2023-12-21,140.770004,142.029999,140.473007,141.800003,141.800003,18101500,2831449073.8334236,2210038497,14.906992935368464,48.0,1.0326530622089365,63.49996669046333,90.65653488018621,136.25961526923078,135.85178652439694,-9.343465119813793
2023-12-22,142.130005,143.25,142.054993,142.720001,142.720001,18494700,2833538560.2986073,2228533197,16.289326050466148,56.0,1.4216751133702132,64.95325794954809,96.0798902130502,136.50346126923077,136.36054315221938,-3.9201097869497943
2023-12-26,142.979996,143.945007,142.5,142.820007,142.820007,11170100,2827315855.281054,2239703297,17.730279028325793,60.0,1.7182407305094216,65.11585450720004,91.26892344429095,136.66192319230768,136.83902195575868,-8.731076555709043
2023-12-27,142.830002,143.320007,141.050995,141.440002,141.440002,17288400,2815955417.423872,2222414897,18.386234450982993,60.0,1.8209257498577074,60.91599897327548,80.55876406450308,136.83500011538462,137.17983529236915,-19.441235935496916
2023-12-28,141.850006,142.270004,140.828003,141.279999,141.279999,12192500,2811406408.9748487,2210222397,18.89141057626451,60.0,1.8678619131663936,60.429336807179276,79.31698767148707,136.96423092307694,137.48355112256402,-20.683012328512934
2023-12-29,140.679993,141.434998,139.899994,140.929993,140.929993,14872700,2816493091.6569786,2195349697,18.922575391262882,60.0,1.8554283782867174,59.3130431224384,76.60060617730257,137.053077,137.7388431134852,-23.399393822697437
2024-01-02,139.600006,140.615005,137.740005,139.559998,139.559998,20071900,2821833864.6981616,2175277797,18.021386094015515,60.0,1.7152551714346487,55.0281158155148,65.96813397646834,137.03538446153846,137.87374347544926,-34.03186602353167
2024-01-03,138.600006,141.089996,138.429993,140.360001,140.360001,18974300,2830393782.362127,2194252097,17.353164923207867,60.0,1.649703694027096,56.98243886179765,72.1769228100656,137.11769215384615,138.05791069949007,-27.823077189934395
2024-01-04,139.850006,140.634995,138.009995,138.039993,138.039993,18253300,2812557672.8332887,2175998797,16.550835709600328,60.0,1.3944737935621845,50.17304742476779,54.17144062530344,137.11730715384616,138.0565834624908,-45.82855937469656
2024-01-05,138.352005,138.809998,136.850006,137.389999,137.389999,15433200,2805628405.46934,2160565597,15.425223201473425,60.0,1.1267645348667372,48.426987015629535,42.06799079664308,137.0699996153846,138.00720683563964,-57.93200920335692
2024-01-08,138.0,140.639999,137.880005,140.529999,140.529999,17645300,2821867192.9914145,2178210897,14.98421435267697,60.0,1.15466452267097,56.33283972347907,66.43727770891076,137.22884596153847,138.19408032929596,-33.562722291089244
2024-01-09,140.059998,142.800003,139.789993,142.559998,142.559998,19579700,2838324494.129949,2197790597,15.303425287501215,60.0,1.3253021595811845,60.543897997688696,80.4790866132366,137.56115365384613,138.517481638237,-19.520913386763404
2024-01-10,142.520004,144.524994,142.460007,143.800003,143.800003,16641900,2843280869.9858265,2214432497,16.10706192432592,100.0,1.5428072351138837,62.89759553245231,90.55384842295531,137.96423042307694,138.9087795168861,-9.446151577044681
2024-01-11,144.895004,146.660004,142.214996,143.669998,143.669998,17471100,2837247538.1258163,2196961397,17.40494830634927,100.0,1.68526457651285,62.4767947696615,69.52082966785518,138.46576861538463,139.26146236748716,-30.47917033214482
2024-01-12,144.339996,144.740005,143.360001,144.240005,144.240005,13995200,2841101318.245874,2210956597,18.61012851822809,72.0,1.8231418032327156,63.62584805406589,75.33129976173292,138.9215380769231,139.63024330322884,-24.668700238267075
2024-01-16,143.429993,145.839996,143.056,144.080002,144.080002,19198900,2836025794.8583403,2191757697,20.006752720731104,72.0,1.8976249546145425,63.042262343298454,73.70028006121933,139.40807688461538,139.95985505854523,-26.299719938780665
2024-01-17,142.910004,143.410004,140.509995,142.889999,142.889999,17884500,2847496501.368389,2173873197,20.036141544088952,72.0,1.8394263301460114,58.72786729082362,61.569767904132036,139.57884619230768,140.17690275791225,-38.430232095867964
2024-01-18,143.440002,145.585007,143.350006,144.990005,144.990005,18876800,2856322537.405778,2192749997,20.66411314699784,72.0,1.9403888399766913,63.47794280918158,82.97656125923784,139.90000026923076,140.53342884991875,-17.023438740762167
2024-01-19,146.304993,148.039993,145.800003,147.970001,147.970001,27170900,2881795442.6533012,2219920897,21.82590266330198,92.0,2.2350983067673837,68.94073420972354,99.37451223133671,140.41038503846156,141.08428604622105,-0.6254877686633001
2024-01-22,148.710007,150.014999,147.580002,147.710007,147.710007,21829200,2862297173.776419,2198091697,23.30910483524831,96.0,2.4197845692755777,67.98528710502845,82.49150607220224,140.9515391923077,141.5750801909454,-17.508493927797772
2024-01-23,147.720001,148.860001,147.190002,148.679993,148.679993,14113600,2873368184.039778,2212205297,24.495580863763013,96.0,2.614283691533842,69.67391484110208,89.85942491575958,141.51730811538462,142.10137002865315,-10.140575084240416
2024-01-24,150.289993,151.570007,149.839996,150.350006,150.350006,19245000,2865470097.383104,2231450297,26.12490219523401,100.0,2.870097047245764,72.37549512877987,91.71195029130774,142.17692384615384,142.71238010060478,-8.288049708692252
2024-01-25,151.740005,154.759995,151.220001,153.639999,153.639999,21495100,2873363803.6973515,2252945397,28.145338034170102,100.0,3.300262541923246,76.76660250206777,93.74652882254694,142.93846242307694,143.52183335241182,-6.253471177453068
2024-01-26,152.869995,154.110001,152.800003,153.789993,153.789993,19494500,2883334020.5213466,2272439897,30.021457027467903,52.0,3.6116422936856623,76.94652256530028,94.25353924972708,143.5769236153846,144.2824377707517,-5.746460750272922
2024-01-29,153.639999,155.199997,152.919998,154.839996,154.839996,20909300,2897640362.441716,2293349197,31.92873689420549,60.0,3.8982033949959884,78.21815852800337,97.66384875695047,144.22076938461538,145.0644791210664,-2.336151243049535
2024-01-30,154.009995,155.039993,152.774994,153.050003,153.050003,26578900,2877515714.041916,2266770297,33.61902206780725,60.0,3.9355016436579717,71.02554977558138,85.36423616552268,144.73576934615383,145.65599940839482,-14.63576383447731
2024-01-31,145.389999,145.589996,141.550003,141.800003,141.800003,43908600,2839041356.130949,2222861697,31.420609600384562,60.0,3.0224389992346516,43.77826352577932,8.781537265958173,144.73576934615386,145.37037004481002,-91.21846273404182
2024-02-01,143.690002,144.619995,142.259995,142.710007,142.710007,25526900,2823249550.472305,2248388597,29.37922659492064,60.0,2.3452256909345124,45.596340336767376,14.976253917460241,144.73538496153844,145.17330611556483,-85.02374608253976
2024-02-02,140.889999,143.880005,138.169998,143.539993,143.539993,42116900,2860350606.742936,2290505497,28.43418402471604,60.0,1.8541289543354367,47.271161074484425,31.532562039492873,144.76307673076923,145.05231995885632,-68.46743796050713
2024-02-05,144.039993,146.669998,143.910004,144.929993,144.929993,29254400,2852718837.9527144,2319759897,26.79819791543518,60.0,1.5591200700559682,50.04479824405958,39.69462945946152,144.89730715384616,145.04325870264475,-60.305370540538476
2024-02-06,145.960007,146.740005,144.520004,145.410004,145.410004,21517700,2848454060.811758,2341277597,25.26049248339402,60.0,1.3485114790101704,51.00329227439826,42.513249707178446,145.0561535,145.07042502096735,-57.486750292821554
2024-02-07,146.119995,147.0,145.210007,146.679993,146.679993,21436100,2862225659.2715845,2362713697,23.75923649264993,60.0,1.269446759769039,53.5430530600552,49.97061362129265,145.27730734615386,145.18965227867346,-50.02938637870735
2024-02-08,146.970001,147.610001,146.419998,147.220001,147.220001,18241300,2868510507.0609593,2380954997,22.186017103354484,60.0,1.2361123984289009,54.62019626302345,53.141535710013855,145.57192284615385,145.34004848025322,-46.858464289986145
2024-02-09,147.949997,150.695007,147.429993,150.220001,150.220001,21877700,2884022513.825831,2402832697,21.319539675620536,60.0,1.4352252218982642,60.14829097220671,70.75750855886722,145.9511536153846,145.7015264446789,-29.242491441132785
2024-02-12,149.539993,150.589996,148.559998,148.729996,148.729996,17236100,2869673217.189972,2385596597,20.514953492724725,60.0,1.4560086565606127,56.46892063619084,62.00821268398198,146.3623075769231,145.92585752285083,-37.99178731601802
2024-02-13,146.070007,148.039993,145.110001,146.369995,146.369995,18138500,2867135033.6201873,2367458097,19.35850786634734,56.00000000000001,1.2674370950389573,51.13354214514462,48.15030817089299,146.70769203846154,145.95875659523227,-51.84969182910701
2024-02-14,147.369995,147.830002,145.554993,147.139999,147.139999,16651800,2873685957.5749493,2384109897,18.28466549899692,-16.0,1.1666769360685691,52.70371776113241,52.67176469006249,146.9619228076923,146.04625603262247,-47.32823530993751
2024-02-15,144.460007,144.759995,141.880005,143.940002,143.940002,26724300,2885192330.4780493,2357385597,18.237339914078508,-16.0,0.8191679119628077,46.07747537913693,33.881411267258436,147.0149998846154,145.89023721539115,-66.11858873274157
2024-02-16,144.210007,144.479996,141.520004,141.759995,141.759995,21849700,2866885701.778715,2335535897,18.278422412175843,-16.0,0.3636640678689389,42.186220446103924,21.280367895781875,146.93653803846152,145.5842933475844,-78.71963210421812
2024-02-20,140.940002,143.328995,140.800003,142.199997,142.199997,18625600,2868881541.661799,2354161497,18.491612402165266,-16.000000000000007,0.037743391523406444,43.22833175900322,32.17561759835861,146.87999953846153,145.33360472924483,-67.82438240164139
2024-02-21,142.639999,143.979996,141.910004,143.839996,143.839996,16499600,2883149303.0846453,2370661097,18.44226865642786,-16.0,-0.08721155879317166,47.05878585014054,45.26941258086134,146.86461457692306,145.22296704559707,-54.73058741913866
2024-02-22,146.119995,146.199997,144.009995,145.320007,145.320007,23024700,2887670361.76103,2393685797,17.597894337201822,-16.0,-0.06605331691818606,50.316667948017056,57.08585917982179,146.9123070769231,145.23015519036764,-42.91414082017821
2024-02-23,144.970001,145.955002,144.789993,145.289993,145.289993,14519400,2885613869.7728996,2379166397,16.813832469349073,-15.999999999999996,-0.051117881638163,50.249135315845805,45.37633334963792,147.00461453846154,145.23458762071078,-54.62366665036208
2024-02-26,143.449997,143.839996,138.740005,138.75,138.75,33513000,2852232227.8223553,2345653397,17.624809332458504,-16.0,-0.5605426331237311,38.213759454863805,0.08360517212798059,146.76461434615385,144.75424779695442,-99.91639482787203
2024-02-27,139.410004,140.490005,138.5,140.100006,140.100006,22364000,2865830483.378497,2368017397,18.427944590921804,-16.0,-0.8455838528560378,41.3372253204879,13.120172870749538,146.46192223076923,144.40948914532817,-86.87982712925047
2024-02-28,139.100006,139.279999,136.639999,137.429993,137.429993,30628700,2853532457.0359216,2337388697,19.556461542184426,-84.0,-1.272262952613744,37.31897439176759,5.620729636013059,146.06653707692305,143.8924894308594,-94.37927036398695
2024-02-29,138.350006,139.949997,137.570007,139.779999,139.779999,35485000,2883948209.660933,2372873697,20.33214468087499,-84.0,-1.4045921053856034,42.60701546370395,22.340791268137387,145.72422961538462,143.587860510055,-77.6592087318626
2024-03-01,139.610001,140.0,137.975006,138.080002,138.080002,28522000,2858383942.7821174,2344351697,21.031212083869743,-84.0,-1.6278743406867875,39.97941671388502,10.322604370452668,145.25230638461537,143.17987099079167,-89.67739562954733
2024-03-04,136.539993,136.630005,132.860001,134.199997,134.199997,43571500,2845786221.9685583,2300780197,22.681273920552467,-96.0,-2.093775358763935,34.71696106407782,8.8273827812293,144.504614,142.51469513962192,-91.17261721877071
2024-03-05,132.740005,134.020004,131.550003,133.779999,133.779999,28447600,2868705430.4917936,2272332597,24.422614185843514,-100.0,-2.468440950035074,34.192298696938735,13.697764969150178,143.73499884615384,141.86768061076106,-86.30223503084981
2024-03-06,134.240005,134.740005,131.949997,132.559998,132.559998,23175200,2855664176.46987,2249157397,25.723527909122943,-96.0,-2.8311740035946684,32.6488108051949,6.894166646075105,142.87807584615385,141.17822263959357,-93.1058333539249
2024-03-07,133.889999,135.820007,132.660004,135.240005,135.240005,24107300,2870921939.1658864,2273264697,26.45929639143438,-64.0,-2.8693127435220447,39.147337915582334,25.18773727825414,142.19307592307695,140.73835466629035,-74.81226272174587
2024-03-08,135.035004,138.985001,134.800003,136.289993,136.289993,26472400,2863299541.615589,2299737097,25.902632025937518,-64.0,-2.7827350754478175,41.5277521951669,32.35489379722618,141.98115246153844,140.4088463947133,-67.64510620277382
2024-03-11,137.070007,139.979996,137.070007,138.940002,138.940002,22536400,2869727481.561891,2322273497,25.03469292501301,-64.0,-2.47179475914524,47.147141754763155,50.44369984042309,141.83615226923078,140.300043106216,-49.55630015957691
2024-03-12,138.25,140.279999,138.210007,139.619995,139.619995,19019700,2876618556.834066,2341293197,24.120936472871147,-64.0,-2.1457674941316043,48.51445015669741,55.085292185102524,141.6853831153846,140.24966917242224,-44.914707814897476
2024-03-13,140.059998,142.190002,140.009995,140.770004,140.770004,19637000,2870673528.2203965,2360930197,22.603878016575756,-64.0,-1.774141226737612,50.831148807416696,64.00556501253484,141.52538353846154,140.28821249298355,-35.994434987465155
2024-03-14,142.300003,144.729996,141.485001,144.339996,144.339996,36117900,2898109762.455118,2397048097,21.567454538354344,-64.0,-1.1779772254832324,57.26046352836246,97.04096959687317,141.4842293846154,140.5883446046144,-2.9590304031268184
2024-03-15,143.410004,144.339996,141.130005,142.169998,142.169998,41025900,2883667518.807238,2356022197,20.4830395402376,-64.0,-0.8705781791958032,52.745666958693434,80.57663611809197,141.31076803846153,140.70550411538372,-19.423363881908042
2024-03-18,149.369995,152.929993,148.139999,148.479996,148.479996,47676700,2842759067.356151,2403698897,21.426601583488114,36.0,-0.11645568789714389,62.102838320876344,79.18615958192684,141.3592293846154,141.28139240313308,-20.813840418073152
2024-03-19,148.979996,149.619995,147.009995,147.919998,147.919998,17748400,2837386987.084274,2385950497,21.92379912299676,36.0,0.4310359470279934,60.94934801975428,76.56689736524665,141.27076773076925,141.77314096586397,-23.43310263475336
2024-03-20,148.789993,149.759995,147.664993,149.679993,149.679993,17730000,2853762873.37937,2403680497,22.41242407842906,35.99999999999999,0.995468755621431,63.259082894984864,84.79887034558949,141.30730607692308,142.3588337091333,-15.201129654410508
2024-03-21,150.320007,151.304993,148.009995,148.740005,148.740005,19843900,2842711843.9298224,2383836597,23.16588759864197,36.0,1.3513590215493707,61.177836419441036,80.40229204971564,141.39846030769232,142.83151306401234,-19.59770795028436
2024-03-22,150.240005,152.559998,150.089996,151.770004,151.770004,19226300,2849639642.4369493,2403062897,24.100201838216122,36.0,1.8564996456063056,65.15724038047169,94.57441748101849,141.57653742307693,143.49362350371516,-5.425582518981517
2024-03-25,150.949997,151.455994,148.800003,151.149994,151.149994,15114700,2861271575.9667315,2387948197,24.467010696259962,36.0,2.181648913507246,63.717974121403344,91.51573241482028,141.8538448076923,144.06076205899552,-8.48426758517973
2024-03-26,151.240005,153.199997,151.029999,151.699997,151.699997,19312700,2853884666.10534,2407260897,25.15990626557354,60.0,2.4554082782329942,64.46778509096347,92.69717375268823,142.23615257692308,144.62663131388473,-7.302826247311765
2024-03-27,152.145004,152.690002,150.130005,151.940002,151.940002,16622000,2860767201.566905,2423882897,25.4459523961911,60.0,2.6610559482804206,64.809548072378,93.15219885397786,142.61076815384615,145.1683624758192,-6.847801146022134
2024-03-28,152.0,152.669998,151.330002,152.259995,152.259995,21105600,2868957301.3463078,2444988497,25.711566660335972,60.0,2.817377000901274,65.28892341885367,94.1723336468281,142.93461426923076,145.6936685887215,-5.827666353171906
2024-04-01,151.830002,157.0,151.649994,156.5,156.5,24469800,2888853312.0832677,2469458297,26.829638686574405,72.0,3.2459779167620297,70.93810303892181,97.3390091204398,143.364614,146.49413758214953,-2.6609908795601984
2024-04-02,154.75,155.990005,153.460007,155.869995,155.869995,17585200,2904770210.4861913,2451873097,27.867848425224377,72.0,3.49452834466706,69.13759979098191,93.34900136874586,143.77153715384614,147.18864553902733,-6.650998631254149
